Sìkuapa icha itö̀ièke̠ se' dör	Sìkuapa icha itö̀ièke̠ se' dör	NOCHANGE
Aìnu̠ wö̀wa ë̀	Aìnu̠ wö̀wa ë̀	NOCHANGE
Ie' tö i batörèke	Ie' tö i batörèke	NOCHANGE
Ie' shkö̀	Ie' shkö̀	NOCHANGE
Kë̀ sö e' ichà e' ta̠ se' bua'nai̠a̠	Kë̀ sö e' ichà e' ta̠ se' bua'nai̠a̠	NOCHANGE
Ie'r i tkine̠	Ie'r i tkine̠	NOCHANGE
Shu̠shò̠	Shu̠shò̠	NOCHANGE
Pedro dör kòke ajkuö́ale e̠' apàbako	Pedro dör kòke ajkuö́ale e̠' apàbako	NOCHANGE
E' ku̠é̠ki̠ be' kë̀ i tsiríwe̠ bua'ie	E' ku̠é̠ki̠ be' kë̀ i tsiríwe̠ bua'ie	NOCHANGE
Kö̀chi ètöm	Kö̀chi ètöm	NOCHANGE
A̠la̠' jchèke̠ sö a̠wì̠	A̠la̠' jchèke̠ sö a̠wì̠	NOCHANGE
Dià e̠ ká̠ kiè chase e̠'	Dià e̠ ká̠ kiè chase e̠'	NOCHANGE
I tsö́	I tsö́	NOCHANGE
Siempre sa' wák é̠n a̠ i̠à̠ne̠ wè̠s irir	Siempre sa' wák é̠n a̠ i̠à̠ne̠ wè̠s irir	NOCHANGE
Ie' tsë̀rke	Ie' tsë̀rke	NOCHANGE
E' ká̠ mí̠tkene̠ báne̠t	E' ká̠ mí̠tkene̠ báne̠t	NOCHANGE
Ie' dawè tsikírke̠ ma̠ se' kö̀wö a̠ se' kö̀wö á̠rke̠wa se' kö̀wö dalë́rke̠wa̠ bö̀ ë̀	Ie' dawè tsikírke̠ ma̠ se' kö̀wö a̠ se' kö̀wö á̠rke̠wa se' kö̀wö dalë́rke̠wa̠ bö̀ ë̀	NOCHANGE
Ie' kalö̀tö̀ke	Ie' kalö̀tö̀ke	NOCHANGE
I dawè shkè̠na̠ se' ò̠mi̠k e'r dawè wé̠se shkè̠na̠ se' mi̠k	I dawè shkè̠na̠ se' ò̠mi̠k e'r dawè wé̠se shkè̠na̠ se' mi̠k	NOCHANGE
Kë̀ i ta̠' ma̠ se' e̠' tkö́wa̠ i kukö́k	Kë̀ i ta̠' ma̠ se' e̠' tkö́wa̠ i kukö́k	NOCHANGE
Se' yàmi̠pa tso' shkà̠ta̠ne̠	Se' yàmi̠pa tso' shkà̠ta̠ne̠	NOCHANGE
Dawás èk	Dawás èk	NOCHANGE
Ya kutà dör ni̠mà̠ ajkuö̀ppé na̠ñé̠we	Ya kutà dör ni̠mà̠ ajkuö̀ppé na̠ñé̠we	NOCHANGE
Ká̠ i'	Ká̠ i'	NOCHANGE
Dù tèröl	Dù tèröl	NOCHANGE
Ñe̠' dalì mí̠ke̠ ikuö̀wö	Ñe̠' dalì mí̠ke̠ ikuö̀wö	NOCHANGE
Be' tö i ichàkè	Be' tö i ichàkè	NOCHANGE
Tke̠'k tsá̠ wö̀ni̠rke̠	Tke̠'k tsá̠ wö̀ni̠rke̠	NOCHANGE
I yö́ sö	I yö́ sö	NOCHANGE
I wámbalö́	I wámbalö́	NOCHANGE
Mesa kalö̀	Mesa kalö̀	NOCHANGE
Í̠ma̠ be' kiè	Í̠ma̠ be' kiè	NOCHANGE
Së́ ö i' e' i' dör së́	Së́ ö i' e' i' dör së́	NOCHANGE
Suléyibi tsikìne̠	Suléyibi tsikìne̠	NOCHANGE
E' daléwa se' à̠ta̠ e' sa̠ú̠k wé̠shke̠	E' daléwa se' à̠ta̠ e' sa̠ú̠k wé̠shke̠	NOCHANGE
Ye' tö i kàchè	Ye' tö i kàchè	NOCHANGE
Ie' tö i yulèke	Ie' tö i yulèke	NOCHANGE
E' ichà sö e'ta̠ kë̀ wake' se' bua'ne̠	E' ichà sö e'ta̠ kë̀ wake' se' bua'ne̠	NOCHANGE
E' a̠ ie' wa̠ e' wákpa tso' tsë'ka	E' a̠ ie' wa̠ e' wákpa tso' tsë'ka	NOCHANGE
Ye' tö i yèke	Ye' tö i yèke	NOCHANGE
E'ta̠ kë̀ íyi ta̠wè̠ ta̠	E'ta̠ kë̀ íyi ta̠wè̠ ta̠	NOCHANGE
Ie' i sa̠wé̠	Ie' i sa̠wé̠	NOCHANGE
Ye' tö i chè	Ye' tö i chè	NOCHANGE
Tkë́tökicha	Tkë́tökicha	NOCHANGE
Sa' i ajkà mé̠ka̠ kë'köldi	Sa' i ajkà mé̠ka̠ kë'köldi	NOCHANGE
Ye' i sa̠wè̠ ye' yàmi̠pa ie'	Ye' i sa̠wè̠ ye' yàmi̠pa ie'	NOCHANGE
Sùla èt	Sùla èt	NOCHANGE
Ie' ttö̀ke	Ie' ttö̀ke	NOCHANGE
Sa̠ ù̠	Sa̠ ù̠	NOCHANGE
Ye'r i bulâ̠'	Ye'r i bulâ̠'	NOCHANGE
E' rö ñà̠no̠ ta̠ dúla tso'	E' rö ñà̠no̠ ta̠ dúla tso'	NOCHANGE
Ajá! ö̀kö téka̠ne̠ i̠a̠ ta̠	Ajá! ö̀kö téka̠ne̠ i̠a̠ ta̠	NOCHANGE
E' ièke̠ka̠ sö e̠' dikì̠ a̠	E' ièke̠ka̠ sö e̠' dikì̠ a̠	NOCHANGE
Ie' tö i tkèke	Ie' tö i tkèke	NOCHANGE
Úriki̠	Úriki̠	NOCHANGE
Kë̀ sa' bö' wö̀btsö i̠a̠ ákbö wa	Kë̀ sa' bö' wö̀btsö i̠a̠ ákbö wa	NOCHANGE
E̠' érë balë' i tkèwa̠tke̠	E̠' érë balë' i tkèwa̠tke̠	NOCHANGE
Ie' kapö̀kewa̠	Ie' kapö̀kewa̠	NOCHANGE
Dakarò alà tskìna̠ bö̀tk	Dakarò alà tskìna̠ bö̀tk	NOCHANGE
Na̠mù̠ jkuö̀	Na̠mù̠ jkuö̀	NOCHANGE
Ye' bikéits	Ye' bikéits	NOCHANGE
I̠à̠na̠ ta̠ e' e' tsikìna̠ ta̠ í̠e̠ í̠e̠ awá irir óköm e' rö i ka̠nè̠u̠k i kapèbalök	I̠à̠na̠ ta̠ e' e' tsikìna̠ ta̠ í̠e̠ í̠e̠ awá irir óköm e' rö i ka̠nè̠u̠k i kapèbalök	NOCHANGE
Ie' ùshikalö̀ke	Ie' ùshikalö̀ke	NOCHANGE
Ma̠ñè̠k	Ma̠ñè̠k	NOCHANGE
Balo'ri sharila buáala i yö́ söla	Balo'ri sharila buáala i yö́ söla	NOCHANGE
Ichàkök e̠na̠ kó̠pàkök	Ichàkök e̠na̠ kó̠pàkök	NOCHANGE
Wé̠ balë'këkëpa e' se' wö̀ikèke̠ ta̠ se' bua'na̠	Wé̠ balë'këkëpa e' se' wö̀ikèke̠ ta̠ se' bua'na̠	NOCHANGE
Ie' i̠nù̠	Ie' i̠nù̠	NOCHANGE
Chìchi ètöm	Chìchi ètöm	NOCHANGE
I ò̠rsö́	I ò̠rsö́	NOCHANGE
E' e' pàkö a̠ñì̠es	E' e' pàkö a̠ñì̠es	NOCHANGE
Be' tù̠r	Be' tù̠r	NOCHANGE
Ie'pa bák ká̠ shù̠ a̠ ñe̠' e's	Ie'pa bák ká̠ shù̠ a̠ ñe̠' e's	NOCHANGE
Be' tö i shtèke	Be' tö i shtèke	NOCHANGE
Ye' kalö̀tö̀ke	Ye' kalö̀tö̀ke	NOCHANGE
Ye' tö i tsè	Ye' tö i tsè	NOCHANGE
Be' tö i ttèke	Be' tö i ttèke	NOCHANGE
I batörö́	I batörö́	NOCHANGE
Ye' tö i ppè	Ye' tö i ppè	NOCHANGE
Í̠ski̠	Í̠ski̠	NOCHANGE
I yö́ söla i yö́ sö	I yö́ söla i yö́ sö	NOCHANGE
Ye'r talók yulö̀ke̠ ká̠ñi̠k a̠	Ye'r talók yulö̀ke̠ ká̠ñi̠k a̠	NOCHANGE
Tsirìu̠k	Tsirìu̠k	NOCHANGE
Escuela a̠ sa ulìta̠ne̠ alâr tso' e̠' wö́ulâu̠k	Escuela a̠ sa ulìta̠ne̠ alâr tso' e̠' wö́ulâu̠k	NOCHANGE
Ká̠pakö sa' wös	Ká̠pakö sa' wös	NOCHANGE
Ka̠nè̠balök	Ka̠nè̠balök	NOCHANGE
Be' tö i sa̠wè̠	Be' tö i sa̠wè̠	NOCHANGE
Dö̀ne̠ wé̠shke̠	Dö̀ne̠ wé̠shke̠	NOCHANGE
Kë̀ yìr ì ta̠wè̠ku̠	Kë̀ yìr ì ta̠wè̠ku̠	NOCHANGE
Yì mí̠ke̠ ye' mú̠köl	Yì mí̠ke̠ ye' mú̠köl	NOCHANGE
Ie' tö i tsèke	Ie' tö i tsèke	NOCHANGE
Be' i chè ö̀kö kë̀ ië̀ne̠ se' wa̠ i̠a̠ ta̠	Be' i chè ö̀kö kë̀ ië̀ne̠ se' wa̠ i̠a̠ ta̠	NOCHANGE
Ye' é̠rke	Ye' é̠rke	NOCHANGE
Kùkur ta̠ kàl mí̠shka	Kùkur ta̠ kàl mí̠shka	NOCHANGE
Ie'pa mi̠kalè ta̠ ikuö̀ i tö̀ tèke̠	Ie'pa mi̠kalè ta̠ ikuö̀ i tö̀ tèke̠	NOCHANGE
Be' tö i kínè̠ke	Be' tö i kínè̠ke	NOCHANGE
Ye' é̠rke	Ye' é̠rke	NOCHANGE
Ie' tsö̀ke	Ie' tsö̀ke	NOCHANGE
Ie' e̠' yawö̀	Ie' e̠' yawö̀	NOCHANGE
Akë́këpa awápa kéli tso'	Akë́këpa awápa kéli tso'	NOCHANGE
Be' tö i kuátkèke	Be' tö i kuátkèke	NOCHANGE
Ie' shkö̀keka̠	Ie' shkö̀keka̠	NOCHANGE
Sibö̀ r ie'pa a̠ e' pàka' kë̀ pàkane̠ se' tsítsir	Sibö̀ r ie'pa a̠ e' pàka' kë̀ pàkane̠ se' tsítsir	NOCHANGE
Kë̀ i̠nì̠ne̠	Kë̀ i̠nì̠ne̠	NOCHANGE
Ie' é̠rke	Ie' é̠rke	NOCHANGE
Ye' tö i mo̠wè̠ke	Ye' tö i mo̠wè̠ke	NOCHANGE
Ie' tö i alè	Ie' tö i alè	NOCHANGE
Bua' i yö̀na̠ e' ta̠ i̠nì̠na̠ se' a̠	Bua' i yö̀na̠ e' ta̠ i̠nì̠na̠ se' a̠	NOCHANGE
Ye' wa̠ ù ta̠'	Ye' wa̠ ù ta̠'	NOCHANGE
Bèk batà a̠ a̠wí̠ a̠	Bèk batà a̠ a̠wí̠ a̠	NOCHANGE
Buáala	Buáala	NOCHANGE
Be' ùshikalö̀	Be' ùshikalö̀	NOCHANGE
Kó̠pàkök	Kó̠pàkök	NOCHANGE
E' tso' balë'kë́këpa se' yàmi̠pa déwa̠ ése a̠ tkó ie	E' tso' balë'kë́këpa se' yàmi̠pa déwa̠ ése a̠ tkó ie	NOCHANGE
E' ta̠ e' ie'r se' tsé̠a̠t	E' ta̠ e' ie'r se' tsé̠a̠t	NOCHANGE
Tsó̠li tsó̠li̠	Tsó̠li tsó̠li̠	NOCHANGE
Dabòm pàryök	Dabòm pàryök	NOCHANGE
Alàr dakírkipa tsé irir e' ta̠ e' yì ta̠ i shkö̀ke̠ ë̀	Alàr dakírkipa tsé irir e' ta̠ e' yì ta̠ i shkö̀ke̠ ë̀	NOCHANGE
À̠s yì e̠' yawa'ku̠ e' ta̠ bité̠ a̠ e̠' yö́rke̠ e̠'rök	À̠s yì e̠' yawa'ku̠ e' ta̠ bité̠ a̠ e̠' yö́rke̠ e̠'rök	NOCHANGE
Be' ùshikalö̀ke	Be' ùshikalö̀ke	NOCHANGE
Mì̠ka̠ e' se' klö'we̠ kàl wö e' tsikìna̠ se' ki̠ e' ichö́kle e' kë̀ bua'ne̠i̠a̠	Mì̠ka̠ e' se' klö'we̠ kàl wö e' tsikìna̠ se' ki̠ e' ichö́kle e' kë̀ bua'ne̠i̠a̠	NOCHANGE
E' yë̀na̠ be' ñé̠jkë déka̠ be' mí̠ke̠ ña̠ i tö́k	E' yë̀na̠ be' ñé̠jkë déka̠ be' mí̠ke̠ ña̠ i tö́k	NOCHANGE
Tsítsi	Tsítsi	NOCHANGE
Alàralar sé̠	Alàralar sé̠	NOCHANGE
Pero kë̀ e' rë wè̠s	Pero kë̀ e' rë wè̠s	NOCHANGE
Awá kàl	Awá kàl	NOCHANGE
Mu̠lù̠tak	Mu̠lù̠tak	NOCHANGE
Ie' tö i yawèke	Ie' tö i yawèke	NOCHANGE
Be' tö i yawè	Be' tö i yawè	NOCHANGE
Be' tö i ttèke	Be' tö i ttèke	NOCHANGE
Ie' akuö̀	Ie' akuö̀	NOCHANGE
Tkö́tsa̠ ye' é̠n a̠ i á̠rke̠ dià e̠ dë̀u̠ntupa sé̠rke̠	Tkö́tsa̠ ye' é̠n a̠ i á̠rke̠ dià e̠ dë̀u̠ntupa sé̠rke̠	NOCHANGE
Ye' wa̠ i katáule	Ye' wa̠ i katáule	NOCHANGE
Ie' tö i pàlèke	Ie' tö i pàlèke	NOCHANGE
Kë̀ i bachàne̠	Kë̀ i bachàne̠	NOCHANGE
Ye' kapö̀kewa̠	Ye' kapö̀kewa̠	NOCHANGE
Bua'ë bua' i̠ à̠te̠	Bua'ë bua' i̠ à̠te̠	NOCHANGE
I'ta̠ ie'pa kë̀ dë'ne̠	I'ta̠ ie'pa kë̀ dë'ne̠	NOCHANGE
E' tso'ne̠ wé̠shke̠ne̠ ka̠nè̠balök	E' tso'ne̠ wé̠shke̠ne̠ ka̠nè̠balök	NOCHANGE
Ie' shkö̀keka̠	Ie' shkö̀keka̠	NOCHANGE
Ye' tsö̀	Ye' tsö̀	NOCHANGE
I à̠ritsö́	I à̠ritsö́	NOCHANGE
Ské̠l ése se' dör se' wö̀ni̠è̠ke̠ i ki̠	Ské̠l ése se' dör se' wö̀ni̠è̠ke̠ i ki̠	NOCHANGE
Ie' wa̠ se' mí̠ tsé̠r í̠e̠	Ie' wa̠ se' mí̠ tsé̠r í̠e̠	NOCHANGE
Sù̠ne̠	Sù̠ne̠	NOCHANGE
Ma̠ cha̠mù̠la tsú̠k	Ma̠ cha̠mù̠la tsú̠k	NOCHANGE
Kàl ma̠ñá̠lka	Kàl ma̠ñá̠lka	NOCHANGE
Ie'pa yàmi̠pa	Ie'pa yàmi̠pa	NOCHANGE
E' ò̠na̠ ukö̀ki̠	E' ò̠na̠ ukö̀ki̠	NOCHANGE
Ie' klö̀	Ie' klö̀	NOCHANGE
I̠nú̠köl bulu	I̠nú̠köl bulu	NOCHANGE
Tcho'dawe sulù pë'!	Tcho'dawe sulù pë'!	NOCHANGE
Ie' tö i kàchèke	Ie' tö i kàchèke	NOCHANGE
Inú̠köl ë̀ ku̠é̠ki̠	Inú̠köl ë̀ ku̠é̠ki̠	NOCHANGE
Se' ká̠	Se' ká̠	NOCHANGE
Èni̠a̠	Èni̠a̠	NOCHANGE
Bétk bétk ë á̠jà̠ e' yë̀na̠	Bétk bétk ë á̠jà̠ e' yë̀na̠	NOCHANGE
Ie' tö i yawè	Ie' tö i yawè	NOCHANGE
Ye' è̠rke	Ye' è̠rke	NOCHANGE
I̠à̠na̠ ta̠ i bátsena̠mu̠le̠ e'ta̠ i mí̠tkemu̠le̠ wé̠shke̠	I̠à̠na̠ ta̠ i bátsena̠mu̠le̠ e'ta̠ i mí̠tkemu̠le̠ wé̠shke̠	NOCHANGE
Ie' kapö̀kewa̠	Ie' kapö̀kewa̠	NOCHANGE
E' ta̠ se' démi̠ sulàyöm ta̠ sulàyöm ujté e'r i wö̀ e't ë̀	E' ta̠ se' démi̠ sulàyöm ta̠ sulàyöm ujté e'r i wö̀ e't ë̀	NOCHANGE
I akuö̀ú̠	I akuö̀ú̠	NOCHANGE
I katö́	I katö́	NOCHANGE
Ie' tö i sa̠wè̠ke	Ie' tö i sa̠wè̠ke	NOCHANGE
Be' kapö̀kewa̠	Be' kapö̀kewa̠	NOCHANGE
Söla i yö́ sö balo'rila buáala i yö́ söla	Söla i yö́ sö balo'rila buáala i yö́ söla	NOCHANGE
Ye'r i sú̠rule	Ye'r i sú̠rule	NOCHANGE
Ie' tö i ñè̠ke	Ie' tö i ñè̠ke	NOCHANGE
Tö be' ye' a̠ be' datsi' e'ta̠ be' ye' dalö̀ie ta̠ ye' be' a̠ i apéite	Tö be' ye' a̠ be' datsi' e'ta̠ be' ye' dalö̀ie ta̠ ye' be' a̠ i apéite	NOCHANGE
Juan dör kö̀chí mo̠'	Juan dör kö̀chí mo̠'	NOCHANGE
E' ku̠é̠ki̠ a̠lò̠chka kë̀ yawèi̠a̠	E' ku̠é̠ki̠ a̠lò̠chka kë̀ yawèi̠a̠	NOCHANGE
Kë̀ ie'r i wöma̠ú̠k	Kë̀ ie'r i wöma̠ú̠k	NOCHANGE
Ie' dawö' bité̠ a̠ ie' apàkök	Ie' dawö' bité̠ a̠ ie' apàkök	NOCHANGE
Ma̠ íkëne̠ apàkö́mi̠ne̠ tö ì ku̠é̠ki̠	Ma̠ íkëne̠ apàkö́mi̠ne̠ tö ì ku̠é̠ki̠	NOCHANGE
Akbalèsi e̠' ti̠é̠ wa̠ be' ù a̠	Akbalèsi e̠' ti̠é̠ wa̠ be' ù a̠	NOCHANGE
Wé̠ dör i ujtéwa̠ uka' e' ta̠ wè̠s	Wé̠ dör i ujtéwa̠ uka' e' ta̠ wè̠s	NOCHANGE
E' ku̠é̠ki̠ e's yö a' i̠a̠ i pàkeke̠	E' ku̠é̠ki̠ e's yö a' i̠a̠ i pàkeke̠	NOCHANGE
Ye' tö i ppèke	Ye' tö i ppèke	NOCHANGE
Ye'r be' kutà dalë́ne̠	Ye'r be' kutà dalë́ne̠	NOCHANGE
Ye' tö i ñè̠ke	Ye' tö i ñè̠ke	NOCHANGE
Ie' tö i kè	Ie' tö i kè	NOCHANGE
Kàl wö batsèke	Kàl wö batsèke	NOCHANGE
Ù wá̠wá̠n	Ù wá̠wá̠n	NOCHANGE
Ká̠ i'ël	Ká̠ i'ël	NOCHANGE
Alákölpa wá̠wá̠n	Alákölpa wá̠wá̠n	NOCHANGE
Lámpara ar akájtö mí̠k	Lámpara ar akájtö mí̠k	NOCHANGE
Pàköl éjkë ye' ma̠nè̠te̠ wö̀ i' a̠ ie' ta̠ í̠e̠ rö	Pàköl éjkë ye' ma̠nè̠te̠ wö̀ i' a̠ ie' ta̠ í̠e̠ rö	NOCHANGE
I à̠ritsö́	I à̠ritsö́	NOCHANGE
Ie' tö i i̠ù̠tèke	Ie' tö i i̠ù̠tèke	NOCHANGE
Be' tö i shtèke	Be' tö i shtèke	NOCHANGE
Kalö̀tök	Kalö̀tök	NOCHANGE
Kérwala diàla tö́kla se' mí̠ dé dur ki̠la se' mí̠ dé dá kë̀ se'la	Kérwala diàla tö́kla se' mí̠ dé dur ki̠la se' mí̠ dé dá kë̀ se'la	NOCHANGE
Ye' kutà tö wàtak ajkuöbuk	Ye' kutà tö wàtak ajkuöbuk	NOCHANGE
Na̠i̠' e' si̠a̠'wö tso' i shù̠a̠	Na̠i̠' e' si̠a̠'wö tso' i shù̠a̠	NOCHANGE
Be' tö i katè	Be' tö i katè	NOCHANGE
Kínu̠k	Kínu̠k	NOCHANGE
Ye' tù̠rke	Ye' tù̠rke	NOCHANGE
Be' tö i batörèke	Be' tö i batörèke	NOCHANGE
Ie' tö i i̠ù̠tè	Ie' tö i i̠ù̠tè	NOCHANGE
Ie' tö i síwè̠ke	Ie' tö i síwè̠ke	NOCHANGE
Su̠lì̠ ètöm	Su̠lì̠ ètöm	NOCHANGE
Ie' tö i wámbalèke	Ie' tö i wámbalèke	NOCHANGE
I yàmi̠	I yàmi̠	NOCHANGE
Ie' tö i mo̠wè̠ke	Ie' tö i mo̠wè̠ke	NOCHANGE
Yàmi̠pa dë'rö e'tökicha ye' ta̠	Yàmi̠pa dë'rö e'tökicha ye' ta̠	NOCHANGE
Sulàyöm ká̠ kiè e' dör sulàyibi dë́ka̠	Sulàyöm ká̠ kiè e' dör sulàyibi dë́ka̠	NOCHANGE
E'r ie' dawè	E'r ie' dawè	NOCHANGE
Dukúr èt	Dukúr èt	NOCHANGE
Aula a̠	Aula a̠	NOCHANGE
Be' shkö̀ka̠	Be' shkö̀ka̠	NOCHANGE
U̠jú̠! u̠jú̠!	U̠jú̠! u̠jú̠!	NOCHANGE
Ie' dé	Ie' dé	NOCHANGE
Be' tö i ka̠nè̠wè̠ke	Be' tö i ka̠nè̠wè̠ke	NOCHANGE
Ie' tö i wámbalèke	Ie' tö i wámbalèke	NOCHANGE
Ta̠ ie' i sa̠wé̠ tö ikuö̀wö të'r e't í̠ski̠	Ta̠ ie' i sa̠wé̠ tö ikuö̀wö të'r e't í̠ski̠	NOCHANGE
Be' tö i kínè̠ke	Be' tö i kínè̠ke	NOCHANGE
Ie' ate' i a̠míla̠ ta̠	Ie' ate' i a̠míla̠ ta̠	NOCHANGE
Awá kél	Awá kél	NOCHANGE
Ie' tö i tèke	Ie' tö i tèke	NOCHANGE
Be' tö i kièke	Be' tö i kièke	NOCHANGE
Dalóshdalosh	Dalóshdalosh	NOCHANGE
Balo' e' wa	Balo' e' wa	NOCHANGE
Ñá̠no̠ ie katàno̠ alátsitsi	Ñá̠no̠ ie katàno̠ alátsitsi	NOCHANGE
Ye' stsö̀ke̠	Ye' stsö̀ke̠	NOCHANGE
E' ppèke̠rak irir	E' ppèke̠rak irir	NOCHANGE
I̠nì̠ne̠	I̠nì̠ne̠	NOCHANGE
Tsiru' mí̠ wàta̠wè̠	Tsiru' mí̠ wàta̠wè̠	NOCHANGE
Ie' tö i mo̠wè̠ke	Ie' tö i mo̠wè̠ke	NOCHANGE
Ie' sé̠rke̠ ye' a̠mí̠la sâ̠	Ie' sé̠rke̠ ye' a̠mí̠la sâ̠	NOCHANGE
Kë̀ sa' ie' tsiríwe̠	Kë̀ sa' ie' tsiríwe̠	NOCHANGE
Si̠é̠lsi̠e̠l	Si̠é̠lsi̠e̠l	NOCHANGE
Mí̠k be' dë́bitu̠ ká̠ e' ki̠ ta̠ ujté tso'tke pàke	Mí̠k be' dë́bitu̠ ká̠ e' ki̠ ta̠ ujté tso'tke pàke	NOCHANGE
Ye' tö i katèke	Ye' tö i katèke	NOCHANGE
Ye' shkö̀keka̠	Ye' shkö̀keka̠	NOCHANGE
Pereira	Pereira	NOCHANGE
Ie' tö i à̠ritsèke	Ie' tö i à̠ritsèke	NOCHANGE
Akuö̀k	Akuö̀k	NOCHANGE
Balo' dawà ö̀köie	Balo' dawà ö̀köie	NOCHANGE
Ie'pa bité̠a̠ne̠	Ie'pa bité̠a̠ne̠	NOCHANGE
Ie'pa kímu̠k á̠jà̠!	Ie'pa kímu̠k á̠jà̠!	NOCHANGE
Ie' sè̠rke	Ie' sè̠rke	NOCHANGE
E̠' ie'rö ditséwö kuátkë	E̠' ie'rö ditséwö kuátkë	NOCHANGE
Ye' yë́ skó̠mó̠köl	Ye' yë́ skó̠mó̠köl	NOCHANGE
Balíbali	Balíbali	NOCHANGE
É̠ma̠ se' yàmi̠pa i ujtè e' ta̠ i bitséitsèke̠	É̠ma̠ se' yàmi̠pa i ujtè e' ta̠ i bitséitsèke̠	NOCHANGE
Ie' tù̠rke	Ie' tù̠rke	NOCHANGE
E' a̠ ie'par e' ka̠nè̠o̠ne̠	E' a̠ ie'par e' ka̠nè̠o̠ne̠	NOCHANGE
Si̠ni̠' wá̠wá̠n	Si̠ni̠' wá̠wá̠n	NOCHANGE
Ó ska se' ulà dé	Ó ska se' ulà dé	NOCHANGE
Àsh alí ta̠wé̠ ye'r bö̀k	Àsh alí ta̠wé̠ ye'r bö̀k	NOCHANGE
E' ta̠ i mò̠sopa ñe̠' tsó̠ieke ie' tö	E' ta̠ i mò̠sopa ñe̠' tsó̠ieke ie' tö	NOCHANGE
Tsá̠li̠ ta̠ é̠ma̠	Tsá̠li̠ ta̠ é̠ma̠	NOCHANGE
Ie' tö i à̠ritsè	Ie' tö i à̠ritsè	NOCHANGE
Yé ta̠ dià e̠ díjka e̠' të́rke rö	Yé ta̠ dià e̠ díjka e̠' të́rke rö	NOCHANGE
Ajkö́l kë̀ dör bua' bö' ie	Ajkö́l kë̀ dör bua' bö' ie	NOCHANGE
Ie' e̠' yawö̀ke	Ie' e̠' yawö̀ke	NOCHANGE
Be' e̠' yawö̀ke	Be' e̠' yawö̀ke	NOCHANGE
Ma̠ñà̠tökicha	Ma̠ñà̠tökicha	NOCHANGE
Ichàkök	Ichàkök	NOCHANGE
Bö́lka ye'r na̠i' ujtére ká̠ batà i' a̠	Bö́lka ye'r na̠i' ujtére ká̠ batà i' a̠	NOCHANGE
Ë́ e' bö yéi̠a̠	Ë́ e' bö yéi̠a̠	NOCHANGE
Su̠lì̠ ajkuö̀ tso' íyi síwo̠	Su̠lì̠ ajkuö̀ tso' íyi síwo̠	NOCHANGE
Ye' tö i dalió	Ye' tö i dalió	NOCHANGE
Ye' e̠' yawö̀ke	Ye' e̠' yawö̀ke	NOCHANGE
Ie' icha yö' ké̠we mu̠lù̠sik wa	Ie' icha yö' ké̠we mu̠lù̠sik wa	NOCHANGE
Ie' tö i tkèke	Ie' tö i tkèke	NOCHANGE
Kë̀ be'r be' apàio a̠mú̠kat ako̠' ki̠	Kë̀ be'r be' apàio a̠mú̠kat ako̠' ki̠	NOCHANGE
Kabèkirwak	Kabèkirwak	NOCHANGE
Sa' rö ma̠	Sa' rö ma̠	NOCHANGE
Wì̠ke e' kö́ a̠	Wì̠ke e' kö́ a̠	NOCHANGE
A̠ñú̠k	A̠ñú̠k	NOCHANGE
Se' ka̠ma̠' tkë́na̠tsa̠	Se' ka̠ma̠' tkë́na̠tsa̠	NOCHANGE
Be' tö i tsirìwè̠	Be' tö i tsirìwè̠	NOCHANGE
Ye' tso' i alök	Ye' tso' i alök	NOCHANGE
Ká wé̠ël	Ká wé̠ël	NOCHANGE
Ma̠'tkë	Ma̠'tkë	NOCHANGE
Ye' tö i yawè	Ye' tö i yawè	NOCHANGE
Be' tö i mo̠wè̠ke	Be' tö i mo̠wè̠ke	NOCHANGE
E' mi̠'ke̠ ie'pa wa	E' mi̠'ke̠ ie'pa wa	NOCHANGE
Sa' tö klö́m akëwe̠	Sa' tö klö́m akëwe̠	NOCHANGE
E's irir	E's irir	NOCHANGE
Á̠jà̠! é̠ma̠ é̠ma̠	Á̠jà̠! é̠ma̠ é̠ma̠	NOCHANGE
E' ta̠ kë̀ a' chö̀wa	E' ta̠ kë̀ a' chö̀wa	NOCHANGE
Tö́ bétk	Tö́ bétk	NOCHANGE
Ttö̀ chèke kö̀ko kö̀ko	Ttö̀ chèke kö̀ko kö̀ko	NOCHANGE
Ye' tö i alèke	Ye' tö i alèke	NOCHANGE
Ye' tö i wè̠	Ye' tö i wè̠	NOCHANGE
Kë̀ i ta̠'i̠a̠	Kë̀ i ta̠'i̠a̠	NOCHANGE
Ña̠ é̠n	Ña̠ é̠n	NOCHANGE
E' ta̠ ie' déwa̠ ù e' a̠ wé̠shke̠	E' ta̠ ie' déwa̠ ù e' a̠ wé̠shke̠	NOCHANGE
Ie' tsö̀	Ie' tsö̀	NOCHANGE
Tsipátsipa	Tsipátsipa	NOCHANGE
Ie' tö i shkè̠wè̠ke	Ie' tö i shkè̠wè̠ke	NOCHANGE
Tsiru'	Tsiru'	NOCHANGE
Kó̠tté aì	Kó̠tté aì	NOCHANGE
Bítkuak	Bítkuak	NOCHANGE
E' a̠ íyiwak tso'	E' a̠ íyiwak tso'	NOCHANGE
E' a̠ ye' yö̀ne̠	E' a̠ ye' yö̀ne̠	NOCHANGE
Ká̠ bö̀t e'ta̠ se' déka̠ e̠'rök	Ká̠ bö̀t e'ta̠ se' déka̠ e̠'rök	NOCHANGE
A̠là̠chkala buáala i yö́ söla i yö́ söla	A̠là̠chkala buáala i yö́ söla i yö́ söla	NOCHANGE
Ètökicha	Ètökicha	NOCHANGE
I̠nì̠r	I̠nì̠r	NOCHANGE
Ye' tsikìne̠ amù̠bali	Ye' tsikìne̠ amù̠bali	NOCHANGE
Kàlkö yulé yö i tâu̠köl ie	Kàlkö yulé yö i tâu̠köl ie	NOCHANGE
Ká̠ tèröl ta̠ sö shù̠baléka̠	Ká̠ tèröl ta̠ sö shù̠baléka̠	NOCHANGE
E' shù̠ a̠ ie'pa wa̠ kàl wö́löm mí̠	E' shù̠ a̠ ie'pa wa̠ kàl wö́löm mí̠	NOCHANGE
Ye' tö i shtèke	Ye' tö i shtèke	NOCHANGE
Be' ttö̀	Be' ttö̀	NOCHANGE
Ma̠ñè̠k	Ma̠ñè̠k	NOCHANGE
Sa' kalötö̀mi̠	Sa' kalötö̀mi̠	NOCHANGE
Ye'r i paa'	Ye'r i paa'	NOCHANGE
Pulë̀ èk	Pulë̀ èk	NOCHANGE
Ajá! e' ta̠ ujté ta̠'tke balë'këkëpa i̠â̠chki wa̠ ujté ujché̠r chè i̠â̠chki	Ajá! e' ta̠ ujté ta̠'tke balë'këkëpa i̠â̠chki wa̠ ujté ujché̠r chè i̠â̠chki	NOCHANGE
Su̠lì̠tökicha	Su̠lì̠tökicha	NOCHANGE
Ma̠ diö́ ala'r diö́ tsi̠nì̠kichawak	Ma̠ diö́ ala'r diö́ tsi̠nì̠kichawak	NOCHANGE
Be'r e' pàkö tö wè̠s e' wa ye' be' i̠ù̠te	Be'r e' pàkö tö wè̠s e' wa ye' be' i̠ù̠te	NOCHANGE
Sibö̀r e' a̠mé̠a̠t ajkö́no̠	Sibö̀r e' a̠mé̠a̠t ajkö́no̠	NOCHANGE
Bukë' i ajkö́nè̠ke̠ e't e'töm e't e'töm e's ie'pa a̠ñì̠ kí̠mù̠ke̠	Bukë' i ajkö́nè̠ke̠ e't e'töm e't e'töm e's ie'pa a̠ñì̠ kí̠mù̠ke̠	NOCHANGE
Pero e' ta̠ í̠ma̠ balë'këpa dör ichè tö e' ta̠ i wà kù̠na̠ ö kë̀ ñe̠' e's	Pero e' ta̠ í̠ma̠ balë'këpa dör ichè tö e' ta̠ i wà kù̠na̠ ö kë̀ ñe̠' e's	NOCHANGE
Kë̀ e's	Kë̀ e's	NOCHANGE
Be' tö i kèke	Be' tö i kèke	NOCHANGE
Awápa sku'	Awápa sku'	NOCHANGE
Be' tö i kímè̠	Be' tö i kímè̠	NOCHANGE
Be' tö i tsirìwè̠ke	Be' tö i tsirìwè̠ke	NOCHANGE
Dawás e'ka déka̠tke be' ki̠	Dawás e'ka déka̠tke be' ki̠	NOCHANGE
Ë̀ í̠e̠ ka̠nè̠o̠rmi̠ ta̠	Ë̀ í̠e̠ ka̠nè̠o̠rmi̠ ta̠	NOCHANGE
Ie' i skà i chéne̠	Ie' i skà i chéne̠	NOCHANGE
Ie' ka̠nè̠balö̀	Ie' ka̠nè̠balö̀	NOCHANGE
Pero ë́ e' be' wö́ulár i yawö́k	Pero ë́ e' be' wö́ulár i yawö́k	NOCHANGE
Awá dör dawè wö́ike iri e' icheketke ba ákbö iö ba dawè ki̠	Awá dör dawè wö́ike iri e' icheketke ba ákbö iö ba dawè ki̠	NOCHANGE
Kë̀r e'	Kë̀r e'	NOCHANGE
Sàl ku̠è̠ tso' i dómi̠ dù kö̀ie ku̠è̠ sö	Sàl ku̠è̠ tso' i dómi̠ dù kö̀ie ku̠è̠ sö	NOCHANGE
Ye'r i ale	Ye'r i ale	NOCHANGE
E' kë̀ bua'ne̠i̠a̠ne̠	E' kë̀ bua'ne̠i̠a̠ne̠	NOCHANGE
E' ku̠é̠ki̠ i' ta̠ sa' a̠ mì̠ka̠ sa' a̠ ma̠ ká̠ a̠mé̠ne̠	E' ku̠é̠ki̠ i' ta̠ sa' a̠ mì̠ka̠ sa' a̠ ma̠ ká̠ a̠mé̠ne̠	NOCHANGE
Ie'pa mí̠a̠ wé̠ alè skà	Ie'pa mí̠a̠ wé̠ alè skà	NOCHANGE
E' dör	E' dör	NOCHANGE
E' kapéyèke̠ balë'këkë dör	E' kapéyèke̠ balë'këkë dör	NOCHANGE
E's sa' i̠a̠ kë̀ na̠i̠'chka a̠mè̠ne̠a̠t katè	E's sa' i̠a̠ kë̀ na̠i̠'chka a̠mè̠ne̠a̠t katè	NOCHANGE
E' tsikìna̠ se' ki̠ e' ta̠ kë̀ e' wë́m e' bua'ne̠	E' tsikìna̠ se' ki̠ e' ta̠ kë̀ e' wë́m e' bua'ne̠	NOCHANGE
Ù i' shù̠ a̠ wë́pa tso'rak dabòm	Ù i' shù̠ a̠ wë́pa tso'rak dabòm	NOCHANGE
Ù̠ù̠ù̠	Ù̠ù̠ù̠	NOCHANGE
Ye' é̠na̠ shakáku̠ aíe̠	Ye' é̠na̠ shakáku̠ aíe̠	NOCHANGE
Ie' tö i alèke	Ie' tö i alèke	NOCHANGE
Dakaròla má̠ i wö́k	Dakaròla má̠ i wö́k	NOCHANGE
Sa'r kàl sé̠ wö̀të'	Sa'r kàl sé̠ wö̀të'	NOCHANGE
Be' tsö̀ke	Be' tsö̀ke	NOCHANGE
Kë̀r e's	Kë̀r e's	NOCHANGE
Ujtè wé̠alè tso' a̠mù̠bali	Ujtè wé̠alè tso' a̠mù̠bali	NOCHANGE
Ie' dawè tsikírke̠ se' ák a̠ shù̠ a̠	Ie' dawè tsikírke̠ se' ák a̠ shù̠ a̠	NOCHANGE
A' ka̠nè̠balö́!	A' ka̠nè̠balö́!	NOCHANGE
Ba ká̠	Ba ká̠	NOCHANGE
Ie' kë̀ i sawèi̠a̠ ie' rö ie' mò̠sopa tso' e' péite	Ie' kë̀ i sawèi̠a̠ ie' rö ie' mò̠sopa tso' e' péite	NOCHANGE
Wë́m i' ki̠ dawás dë́ka̠ bö̀k ë̀me̠	Wë́m i' ki̠ dawás dë́ka̠ bö̀k ë̀me̠	NOCHANGE
Pë' su̠lì̠tu	Pë' su̠lì̠tu	NOCHANGE
Débitu̠ e̠' tkése̠	Débitu̠ e̠' tkése̠	NOCHANGE
Ye' ká̠ka'	Ye' ká̠ka'	NOCHANGE
E'ta̠ pú̠ e' e'ta i̠â̠chki ta̠	E'ta̠ pú̠ e' e'ta i̠â̠chki ta̠	NOCHANGE
Be' tö i alè	Be' tö i alè	NOCHANGE
Shkè̠u̠k	Shkè̠u̠k	NOCHANGE
Ie' tö i kèke	Ie' tö i kèke	NOCHANGE
Be' tö i kuèke	Be' tö i kuèke	NOCHANGE
Tsu'ku ki̠ i tso' bua'ie e̠na̠ u̠lé̠	Tsu'ku ki̠ i tso' bua'ie e̠na̠ u̠lé̠	NOCHANGE
Alákölpa buàmbuáala	Alákölpa buàmbuáala	NOCHANGE
Ye'r be' a̠ datsi' ta̠wé̠	Ye'r be' a̠ datsi' ta̠wé̠	NOCHANGE
Barö́r ye' ye' ká̠cheka̠	Barö́r ye' ye' ká̠cheka̠	NOCHANGE
Sa' bribriwak i bikéitse̠ tö sibö̀ wák dör e' a̠me̠'a̠t e's	Sa' bribriwak i bikéitse̠ tö sibö̀ wák dör e' a̠me̠'a̠t e's	NOCHANGE
Ye' tö i ka̠nè̠wè̠ke	Ye' tö i ka̠nè̠wè̠ke	NOCHANGE
E'kalaë̀	E'kalaë̀	NOCHANGE
Casi dawás e'k	Casi dawás e'k	NOCHANGE
Ká̠ dör iku̠á̠ki̠ iku̠á̠ki̠	Ká̠ dör iku̠á̠ki̠ iku̠á̠ki̠	NOCHANGE
E' ë̀ ppèke̠ ie'pa ye' i kiè	E' ë̀ ppèke̠ ie'pa ye' i kiè	NOCHANGE
Ie'r ako̠' apasi̠'	Ie'r ako̠' apasi̠'	NOCHANGE
I ka̠nè̠wè̠ke̠ ie'pa rö e̠' ta̠ a̠wí̠ i yàmi̠pa dé tulúrka̠	I ka̠nè̠wè̠ke̠ ie'pa rö e̠' ta̠ a̠wí̠ i yàmi̠pa dé tulúrka̠	NOCHANGE
Ie' tö i síwè̠	Ie' tö i síwè̠	NOCHANGE
À̠! e' a̠ be' yö̀ne̠	À̠! e' a̠ be' yö̀ne̠	NOCHANGE
E'r a̠wí̠e̠ tsì̠ne̠t kúkúr	E'r a̠wí̠e̠ tsì̠ne̠t kúkúr	NOCHANGE
Ye' kapö̀kewa̠	Ye' kapö̀kewa̠	NOCHANGE
Be' tö i tsèke	Be' tö i tsèke	NOCHANGE
Ká̠ wé̠jkë se' é̠n i tka'ku̠	Ká̠ wé̠jkë se' é̠n i tka'ku̠	NOCHANGE
Kë̀ se' e̠' dalë̀ne̠ ta̠ dawás bìt ta̠ be' ichè se' mí̠tse̠n i wa̠	Kë̀ se' e̠' dalë̀ne̠ ta̠ dawás bìt ta̠ be' ichè se' mí̠tse̠n i wa̠	NOCHANGE
Kë̀ ye'r i tkìnu̠k	Kë̀ ye'r i tkìnu̠k	NOCHANGE
Ùña̠k i kalö̀ bua'ë!	Ùña̠k i kalö̀ bua'ë!	NOCHANGE
Aìbalo dör kapöli bua'ë	Aìbalo dör kapöli bua'ë	NOCHANGE
Mì̠k brö̀ e' wámbalë' kë̀ à̠ne̠ ye' tso'tke érë kë̀ ye' é̠n a̠ i̠ à̠ne̠	Mì̠k brö̀ e' wámbalë' kë̀ à̠ne̠ ye' tso'tke érë kë̀ ye' é̠n a̠ i̠ à̠ne̠	NOCHANGE
A se' wö̀ni̠rke̠	A se' wö̀ni̠rke̠	NOCHANGE
Kë̀ sú̠rule be' wa̠	Kë̀ sú̠rule be' wa̠	NOCHANGE
Ye' shkö̀keka̠	Ye' shkö̀keka̠	NOCHANGE
Ma̠ kàsir	Ma̠ kàsir	NOCHANGE
Y wé̠ ie' ishtirìne̠ ta̠ ie' se' mé̠ dé tkë'se̠ se' mé̠ dé	Y wé̠ ie' ishtirìne̠ ta̠ ie' se' mé̠ dé tkë'se̠ se' mé̠ dé	NOCHANGE
E̠' dör	E̠' dör	NOCHANGE
Ye' tö i wámbalèke	Ye' tö i wámbalèke	NOCHANGE
Na̠mù̠ ètöm	Na̠mù̠ ètöm	NOCHANGE
Kàsir se' tsiríwè̠ke̠ wa	Kàsir se' tsiríwè̠ke̠ wa	NOCHANGE
I tsirìú̠	I tsirìú̠	NOCHANGE
Ñé̠ ta̠ wè̠s balë'këkëpa i wé̠	Ñé̠ ta̠ wè̠s balë'këkëpa i wé̠	NOCHANGE
Be' tö i i̠ù̠tèke	Be' tö i i̠ù̠tèke	NOCHANGE
Ie' tö i yèke	Ie' tö i yèke	NOCHANGE
Pero e' tkèmi̠ sö shalít e'tökicha bö̀tökicha ma̠ñà̠tökicha ta̠ se' ulà dé iska	Pero e' tkèmi̠ sö shalít e'tökicha bö̀tökicha ma̠ñà̠tökicha ta̠ se' ulà dé iska	NOCHANGE
Yèri na̠i̠' sú̠rku̠	Yèri na̠i̠' sú̠rku̠	NOCHANGE
Ye' tsë̀rke	Ye' tsë̀rke	NOCHANGE
Be' chkö̀ke	Be' chkö̀ke	NOCHANGE
Ye' kapö̀wa̠	Ye' kapö̀wa̠	NOCHANGE
Ie' e̠' shkébitu̠ a̠wí̠ a̠	Ie' e̠' shkébitu̠ a̠wí̠ a̠	NOCHANGE
Ie' tö i kièke	Ie' tö i kièke	NOCHANGE
Campo ë̀ iríktsa̠ bák aì e̠ ie'pa e's	Campo ë̀ iríktsa̠ bák aì e̠ ie'pa e's	NOCHANGE
Uséköl èbale	Uséköl èbale	NOCHANGE
Be' shkö̀ke	Be' shkö̀ke	NOCHANGE
E' ukö̀ki̠ ie'pa rö wé̠ ië'ka̠mi̠ ajkö́ a̠	E' ukö̀ki̠ ie'pa rö wé̠ ië'ka̠mi̠ ajkö́ a̠	NOCHANGE
Ye' tö i ñè̠	Ye' tö i ñè̠	NOCHANGE
Kièrö e' ta̠ balë'kë́këpa té̠rke̠	Kièrö e' ta̠ balë'kë́këpa té̠rke̠	NOCHANGE
Ie' chkö̀ke	Ie' chkö̀ke	NOCHANGE
Tsó̠li̠	Tsó̠li̠	NOCHANGE
Ie' e̠' chö̀kea̠t	Ie' e̠' chö̀kea̠t	NOCHANGE
E' ajkö́ a̠ ie'pa rö	E' ajkö́ a̠ ie'pa rö	NOCHANGE
Sibö̀ r e' tulúa̠t	Sibö̀ r e' tulúa̠t	NOCHANGE
Kë̀ ie' ki̠ kiàna̠ i̠nú̠k	Kë̀ ie' ki̠ kiàna̠ i̠nú̠k	NOCHANGE
Ie' shkö̀ka̠	Ie' shkö̀ka̠	NOCHANGE
Wì̠ke ù̠ la	Wì̠ke ù̠ la	NOCHANGE
Darë́sdarës	Darë́sdarës	NOCHANGE
Be' é̠r	Be' é̠r	NOCHANGE
Ye' tö i pàlè	Ye' tö i pàlè	NOCHANGE
Ye' tö i ñè̠ke	Ye' tö i ñè̠ke	NOCHANGE
Kë̀ e̠' bátse̠ ye' ikiè alákölpa ò̠mi̠k	Kë̀ e̠' bátse̠ ye' ikiè alákölpa ò̠mi̠k	NOCHANGE
Kë̀ èrë wè̠s!	Kë̀ èrë wè̠s!	NOCHANGE
Ye' tö i ttèke	Ye' tö i ttèke	NOCHANGE
Be' tö i sa̠wè̠ke	Be' tö i sa̠wè̠ke	NOCHANGE
Lámpara âr akáttö mí̠k	Lámpara âr akáttö mí̠k	NOCHANGE
Se' kapówa̠ ie e' ta̠	Se' kapówa̠ ie e' ta̠	NOCHANGE
Ie' tö i ñè̠	Ie' tö i ñè̠	NOCHANGE
Ése ye' a̠ ta̠	Ése ye' a̠ ta̠	NOCHANGE
Be' kë̀ ie' na̠mé̠	Be' kë̀ ie' na̠mé̠	NOCHANGE
Ka̠nè̠balö̀ke̠ ñí̠ñì̠	Ka̠nè̠balö̀ke̠ ñí̠ñì̠	NOCHANGE
Ie' tö i akuö̀wè̠ke	Ie' tö i akuö̀wè̠ke	NOCHANGE
Ie' shkö̀keka̠	Ie' shkö̀keka̠	NOCHANGE
Élke dìwö ma̠ñà̠t ulàt ë̀ shkö́k	Élke dìwö ma̠ñà̠t ulàt ë̀ shkö́k	NOCHANGE
Dabòm ma̠ñà̠yök kí̠ bö̀k	Dabòm ma̠ñà̠yök kí̠ bö̀k	NOCHANGE
Ye' tö i chèke	Ye' tö i chèke	NOCHANGE
Kalö̀ ki̠ ie'pa ú̠rke̠ shtö' ma̠ ñe̠'	Kalö̀ ki̠ ie'pa ú̠rke̠ shtö' ma̠ ñe̠'	NOCHANGE
É balë'kë́këpa wé̠ tso'se̠r wé̠ rö awápa	É balë'kë́këpa wé̠ tso'se̠r wé̠ rö awápa	NOCHANGE
Ye' shkö̀ka̠	Ye' shkö̀ka̠	NOCHANGE
Talók ètöm	Talók ètöm	NOCHANGE
Wé̠shke̠	Wé̠shke̠	NOCHANGE
Ie'r ni̠mà̠ tké cháchá	Ie'r ni̠mà̠ tké cháchá	NOCHANGE
Ie' tù̠rke	Ie' tù̠rke	NOCHANGE
Ttö̀ pó̠li̠	Ttö̀ pó̠li̠	NOCHANGE
I wö̀klö́r se' a̠ e' ta̠ se' dö̀mi̠ bö̀k ma̠ñá̠k	I wö̀klö́r se' a̠ e' ta̠ se' dö̀mi̠ bö̀k ma̠ñá̠k	NOCHANGE
Bö'wö sa̠wé̠ wa̠ ì su̠ i cha	Bö'wö sa̠wé̠ wa̠ ì su̠ i cha	NOCHANGE
É! chkö̀ mí̠rule chkö̀ mí̠rule se' wa̠	É! chkö̀ mí̠rule chkö̀ mí̠rule se' wa̠	NOCHANGE
Kë̀ ù̠ wàiar di' wa!	Kë̀ ù̠ wàiar di' wa!	NOCHANGE
A̠wí̠ e̠' ie'pa chkö̀ alö̀ke̠ a̠wí̠ e̠'	A̠wí̠ e̠' ie'pa chkö̀ alö̀ke̠ a̠wí̠ e̠'	NOCHANGE
Kë̀ ì ta̠wè̠ ta̠	Kë̀ ì ta̠wè̠ ta̠	NOCHANGE
É báne̠t e' ta̠ cha̠mù̠la kuátkèmi̠ i kuátke e' a̠ ta̠ i tsikírmi̠ pà mi̠k	É báne̠t e' ta̠ cha̠mù̠la kuátkèmi̠ i kuátke e' a̠ ta̠ i tsikírmi̠ pà mi̠k	NOCHANGE
Dabòm bö̀yök	Dabòm bö̀yök	NOCHANGE
À! mì̠ka̠ ye' bák tsítsi ta̠	À! mì̠ka̠ ye' bák tsítsi ta̠	NOCHANGE
I tsakèke̠ é! i ma̠ shkö́wè̠ke̠	I tsakèke̠ é! i ma̠ shkö́wè̠ke̠	NOCHANGE
E̠' yawö́	E̠' yawö́	NOCHANGE
Cha̠mù̠ tkë́lyuwak	Cha̠mù̠ tkë́lyuwak	NOCHANGE
Ì se'la i yö́ söla i yö́	Ì se'la i yö́ söla i yö́	NOCHANGE
E' dör e's sibö̀ dör sa' a̠ ù ajkàyë' uka'ë	E' dör e's sibö̀ dör sa' a̠ ù ajkàyë' uka'ë	NOCHANGE
Àkna̠ma̠ tkë́r ie	Àkna̠ma̠ tkë́r ie	NOCHANGE
Ye' aka̠' ie ma̠ñà̠t ya ká̠ ki̠'	Ye' aka̠' ie ma̠ñà̠t ya ká̠ ki̠'	NOCHANGE
Ma̠ ie' dawè tsikírke̠ se' a̠ sa̠mé̠	Ma̠ ie' dawè tsikírke̠ se' a̠ sa̠mé̠	NOCHANGE
E' ku̠é̠ki̠ kë̀ i yawèi̠a̠	E' ku̠é̠ki̠ kë̀ i yawèi̠a̠	NOCHANGE
Ie'pa dör kàl ñá̠a o' wa	Ie'pa dör kàl ñá̠a o' wa	NOCHANGE
Ie' inù̠ke	Ie' inù̠ke	NOCHANGE
Kuátkök	Kuátkök	NOCHANGE
I à̠ritsö́	I à̠ritsö́	NOCHANGE
Yö tso'	Yö tso'	NOCHANGE
Ö ikuö̀wö iö́köl ie	Ö ikuö̀wö iö́köl ie	NOCHANGE
Ba chkö́	Ba chkö́	NOCHANGE
Na̠ú̠la	Na̠ú̠la	NOCHANGE
I ta̠wé̠ yö	I ta̠wé̠ yö	NOCHANGE
Be' datsi' kö́kka̠!	Be' datsi' kö́kka̠!	NOCHANGE
Ie' sè̠rke	Ie' sè̠rke	NOCHANGE
Ie'pa kiéne̠ i ulà tö́k	Ie'pa kiéne̠ i ulà tö́k	NOCHANGE
Dawás bák ye' wa̠ ye' yë̀ne̠ttsa̠	Dawás bák ye' wa̠ ye' yë̀ne̠ttsa̠	NOCHANGE
Ye'r i ali'	Ye'r i ali'	NOCHANGE
Ajkö́ e' shù̠ a̠ se' té̠rse̠ wé̠shke̠ ajkö̀ ma̠wé̠wa̠ bua' ie ie'pa rö	Ajkö́ e' shù̠ a̠ se' té̠rse̠ wé̠shke̠ ajkö̀ ma̠wé̠wa̠ bua' ie ie'pa rö	NOCHANGE
Sa' a̠lì̠ne̠ kàlyök a̠	Sa' a̠lì̠ne̠ kàlyök a̠	NOCHANGE
Ba ttö́	Ba ttö́	NOCHANGE
Ie' tù̠r	Ie' tù̠r	NOCHANGE
Se' kë̀ wa̠ e' bitséitse̠ ta̠ wè̠s wè̠s se' wé̠ne̠ irir	Se' kë̀ wa̠ e' bitséitse̠ ta̠ wè̠s wè̠s se' wé̠ne̠ irir	NOCHANGE
Ie' tö i kèke	Ie' tö i kèke	NOCHANGE
Ie' tu̠nó̠tke	Ie' tu̠nó̠tke	NOCHANGE
Alà r i kalö̀io charéo̠	Alà r i kalö̀io charéo̠	NOCHANGE
E's sibö̀ i sa̠wé̠ kàl déstsa̠	E's sibö̀ i sa̠wé̠ kàl déstsa̠	NOCHANGE
Bueno ye' ki̠ dawás tso' bö̀k	Bueno ye' ki̠ dawás tso' bö̀k	NOCHANGE
Na̠i̠' i' jkuö ki̠	Na̠i̠' i' jkuö ki̠	NOCHANGE
Pedro dör mesa abaú̠kna̠me̠	Pedro dör mesa abaú̠kna̠me̠	NOCHANGE
Mó̠köl bular stsë́rke̠wa̠tke	Mó̠köl bular stsë́rke̠wa̠tke	NOCHANGE
Ye'r i sú̠	Ye'r i sú̠	NOCHANGE
A' e̠' skö́ toro yö́k!	A' e̠' skö́ toro yö́k!	NOCHANGE
Í̠ma̠ i' dör yàli ma̠ wì̠m	Í̠ma̠ i' dör yàli ma̠ wì̠m	NOCHANGE
Be' tö i batörè	Be' tö i batörè	NOCHANGE
Ie' sibö̀ a̠ skà chéne̠	Ie' sibö̀ a̠ skà chéne̠	NOCHANGE
Ie' chkö̀ke	Ie' chkö̀ke	NOCHANGE
Ye' tö i kuèke	Ye' tö i kuèke	NOCHANGE
Ie' ùshikalö̀ke	Ie' ùshikalö̀ke	NOCHANGE
Éjkë pa se' dö́ktsa̠ dià e̠'	Éjkë pa se' dö́ktsa̠ dià e̠'	NOCHANGE
Alìrke̠ i e̠'	Alìrke̠ i e̠'	NOCHANGE
I kuátkö́	I kuátkö́	NOCHANGE
Ie' è̠rke	Ie' è̠rke	NOCHANGE
Entonces be'r i mé̠a̠t ma̠ e̠ma̠	Entonces be'r i mé̠a̠t ma̠ e̠ma̠	NOCHANGE
Ie' tö i yawèke	Ie' tö i yawèke	NOCHANGE
Ye'r i ti̠ó̠	Ye'r i ti̠ó̠	NOCHANGE
Ye' kalö̀tö̀	Ye' kalö̀tö̀	NOCHANGE
Mí̠ka̠ se' tsikìna̠ e'ta̠ se' wíköl dé se' se' e' réwa̠ se' a̠	Mí̠ka̠ se' tsikìna̠ e'ta̠ se' wíköl dé se' se' e' réwa̠ se' a̠	NOCHANGE
Ma̠ ká̠ kà̠jtö aì jtö̀ dör	Ma̠ ká̠ kà̠jtö aì jtö̀ dör	NOCHANGE
Be'r chìchi ma̠ú̠klur!	Be'r chìchi ma̠ú̠klur!	NOCHANGE
Ta̠ bua' i wö̀na̠	Ta̠ bua' i wö̀na̠	NOCHANGE
Ie' tö i yèke	Ie' tö i yèke	NOCHANGE
Se' ditséwö diö̀ya' irir e' ku̠é̠ki̠ ká̠ kiè sulàyöm	Se' ditséwö diö̀ya' irir e' ku̠é̠ki̠ ká̠ kiè sulàyöm	NOCHANGE
Cien pàryök	Cien pàryök	NOCHANGE
Dawë́ kë̀ sú̠rule ye' wa̠ táie ichö́k	Dawë́ kë̀ sú̠rule ye' wa̠ táie ichö́k	NOCHANGE
Ie' akë̀chaketáni̠a̠ bét	Ie' akë̀chaketáni̠a̠ bét	NOCHANGE
Su̠lì̠ ùru tso' kàl ajkuö̀jchök	Su̠lì̠ ùru tso' kàl ajkuö̀jchök	NOCHANGE
Ajá! ma̠ se' wö̀che kö̀chi ë ì ë dakarò ë ma̠ e' a̠ ma̠ i má̠ tsú̠k	Ajá! ma̠ se' wö̀che kö̀chi ë ì ë dakarò ë ma̠ e' a̠ ma̠ i má̠ tsú̠k	NOCHANGE
I déka̠ e' dikì̠ a̠ bö' diö́ ièke̠ ké̠kraë	I déka̠ e' dikì̠ a̠ bö' diö́ ièke̠ ké̠kraë	NOCHANGE
Be' tö i shtè	Be' tö i shtè	NOCHANGE
Ya yë́	Ya yë́	NOCHANGE
Alàr tso' e̠'rö	Alàr tso' e̠'rö	NOCHANGE
Ma̠ e's ie' ské ie' ské se' yë́wa e' ta̠	Ma̠ e's ie' ské ie' ské se' yë́wa e' ta̠	NOCHANGE
Sa' i kie su bulú e' rö sibö̀	Sa' i kie su bulú e' rö sibö̀	NOCHANGE
Kó̠pàkök	Kó̠pàkök	NOCHANGE
Uyë̀jkuö sa̠ú̠k	Uyë̀jkuö sa̠ú̠k	NOCHANGE
I sá̠u̠	I sá̠u̠	NOCHANGE
E'ta̠ ie'pa icha dör bùlikalök	E'ta̠ ie'pa icha dör bùlikalök	NOCHANGE
Sàl ètöm	Sàl ètöm	NOCHANGE
Ye' alà shkótke	Ye' alà shkótke	NOCHANGE
Ie' tö i ppèke	Ie' tö i ppèke	NOCHANGE
E's kipë ie'pa wa̠ íyi ulìta̠ne̠ bák	E's kipë ie'pa wa̠ íyi ulìta̠ne̠ bák	NOCHANGE
Ujarrás e̠ ká̠ dör ákshalë ie	Ujarrás e̠ ká̠ dör ákshalë ie	NOCHANGE
Ie' é̠rke	Ie' é̠rke	NOCHANGE
I stsö̀	I stsö̀	NOCHANGE
Ye' ka̠nè̠balö̀ke	Ye' ka̠nè̠balö̀ke	NOCHANGE
Ie' tö i katèke	Ie' tö i katèke	NOCHANGE
Kiàne̠ yì ki̠	Kiàne̠ yì ki̠	NOCHANGE
Be' tö i ppèke	Be' tö i ppèke	NOCHANGE
Pues éjkë ye' be' kí̠me̠ dé	Pues éjkë ye' be' kí̠me̠ dé	NOCHANGE
Yö i tsè̠bitu̠ sa̠wè̠ bö	Yö i tsè̠bitu̠ sa̠wè̠ bö	NOCHANGE
Dabòm éyök	Dabòm éyök	NOCHANGE
Ku̠è̠ke̠ne̠ érë ie' wa̠ i wö̀ áni̠k e' ta̠	Ku̠è̠ke̠ne̠ érë ie' wa̠ i wö̀ áni̠k e' ta̠	NOCHANGE
Na̠mù̠ ètöm	Na̠mù̠ ètöm	NOCHANGE
E̠' sa̠wé̠ ie' rö tö ikuö̀wö të'r e'töm íyök ki̠ ta̠ ie' tkë́rka̠ se' nú̠ batà ki̠	E̠' sa̠wé̠ ie' rö tö ikuö̀wö të'r e'töm íyök ki̠ ta̠ ie' tkë́rka̠ se' nú̠ batà ki̠	NOCHANGE
Be'r i sa̠ú̠!	Be'r i sa̠ú̠!	NOCHANGE
Ie' tö i ichàkèke	Ie' tö i ichàkèke	NOCHANGE
Ye' tö i tkèke	Ye' tö i tkèke	NOCHANGE
Ye' tö i sa̠wè̠ke	Ye' tö i sa̠wè̠ke	NOCHANGE
Aë̀ tso' sulìta̠ne̠ wa̠	Aë̀ tso' sulìta̠ne̠ wa̠	NOCHANGE
Bua' ë yö bua' yö i ka̠nè̠we̠ bité̠ e'ta yö	Bua' ë yö bua' yö i ka̠nè̠we̠ bité̠ e'ta yö	NOCHANGE
E' mi̠'ke̠ se' wa̠ ma̠ e' ta̠ i tso' ma̠	E' mi̠'ke̠ se' wa̠ ma̠ e' ta̠ i tso' ma̠	NOCHANGE
Ye'r i dalia'	Ye'r i dalia'	NOCHANGE
E' kë̀ ku̠ ù ie'pa wa̠ tulúrse̠ ë́ i̠à̠na̠ e's	E' kë̀ ku̠ ù ie'pa wa̠ tulúrse̠ ë́ i̠à̠na̠ e's	NOCHANGE
Skó̠mó̠köl pàktöm	Skó̠mó̠köl pàktöm	NOCHANGE
Ye' tö i kínè̠ke	Ye' tö i kínè̠ke	NOCHANGE
Ali' kuábale	Ali' kuábale	NOCHANGE
I na̠mù̠	I na̠mù̠	NOCHANGE
Ye' tsö̀ke	Ye' tsö̀ke	NOCHANGE
Ie' ka̠nè̠balö̀ke	Ie' ka̠nè̠balö̀ke	NOCHANGE
Pero í̠e̠ mì̠k sa' dë' ye' dë'tsa̠ í̠e̠	Pero í̠e̠ mì̠k sa' dë' ye' dë'tsa̠ í̠e̠	NOCHANGE
Be' tö i kuátkèke	Be' tö i kuátkèke	NOCHANGE
Ie' inù̠ke	Ie' inù̠ke	NOCHANGE
Ie' tö i pàlèke	Ie' tö i pàlèke	NOCHANGE
Ye' tö i ale	Ye' tö i ale	NOCHANGE
Ìs be' shkè̠na̠	Ìs be' shkè̠na̠	NOCHANGE
Shkö̀kka̠	Shkö̀kka̠	NOCHANGE
E'ta̠ i yö̀na̠tke bua' e'ta̠ yö i wàtu̠è̠ke̠	E'ta̠ i yö̀na̠tke bua' e'ta̠ yö i wàtu̠è̠ke̠	NOCHANGE
I̠â̠i̠â̠ ta̠ balë'këkëpa i' bák e' tso' sè̠no̠ ie	I̠â̠i̠â̠ ta̠ balë'këkëpa i' bák e' tso' sè̠no̠ ie	NOCHANGE
Be' yö̀ne̠ escuela aì a̠	Be' yö̀ne̠ escuela aì a̠	NOCHANGE
Entonces se' ë́ e' kéu̠mi̠ e' ta̠ kë̀ i dë́i̠a̠	Entonces se' ë́ e' kéu̠mi̠ e' ta̠ kë̀ i dë́i̠a̠	NOCHANGE
Di' ulà	Di' ulà	NOCHANGE
Ye' tö i i̠ù̠tèke	Ye' tö i i̠ù̠tèke	NOCHANGE
Ie' tö i shkè̠wè̠ke	Ie' tö i shkè̠wè̠ke	NOCHANGE
Ye' kutà dör i ajkönè̠mi̠	Ye' kutà dör i ajkönè̠mi̠	NOCHANGE
Ba kó̠pàkö́	Ba kó̠pàkö́	NOCHANGE
Be' shakö bétbet!	Be' shakö bétbet!	NOCHANGE
Ye' ki̠ dawás tso' dawás kùlyök	Ye' ki̠ dawás tso' dawás kùlyök	NOCHANGE
I yàmi̠pa	I yàmi̠pa	NOCHANGE
Ie' tö i ttèke	Ie' tö i ttèke	NOCHANGE
Ya yë́	Ya yë́	NOCHANGE
Ye' ttö̀ke	Ye' ttö̀ke	NOCHANGE
Kë̀ be' tú̠nu̠k!	Kë̀ be' tú̠nu̠k!	NOCHANGE
I' dör sa' ùsulë	I' dör sa' ùsulë	NOCHANGE
Ù̠ ki̠ ì ki̠ kapö̀râ i̠e̠'	Ù̠ ki̠ ì ki̠ kapö̀râ i̠e̠'	NOCHANGE
Di'batà a̠	Di'batà a̠	NOCHANGE
Ie' tö i síwè̠ke	Ie' tö i síwè̠ke	NOCHANGE
Kë̀ be'r i sa̠ú̠k!	Kë̀ be'r i sa̠ú̠k!	NOCHANGE
E̠' yawö́	E̠' yawö́	NOCHANGE
Kë̀ ye' wa̠ i yö̀ne̠	Kë̀ ye' wa̠ i yö̀ne̠	NOCHANGE
Be' tö i tè	Be' tö i tè	NOCHANGE
E's irir	E's irir	NOCHANGE
Be' kó̠pàkö̀	Be' kó̠pàkö̀	NOCHANGE
Ye' tö i akuö̀wè̠ke	Ye' tö i akuö̀wè̠ke	NOCHANGE
Bua' balèke̠wa̠ íyök a̠ ie'pa	Bua' balèke̠wa̠ íyök a̠ ie'pa	NOCHANGE
Ie' tö i kèke	Ie' tö i kèke	NOCHANGE
Ie' tö i kèke	Ie' tö i kèke	NOCHANGE
Amùbaliwak	Amùbaliwak	NOCHANGE
Se' akáwìña̠k dalë́rke̠ e' kapè yéke̠ kapö́li wa	Se' akáwìña̠k dalë́rke̠ e' kapè yéke̠ kapö́li wa	NOCHANGE
Ká̠ i̠â̠i̠â̠ ta̠ kë̀ ì ku̠	Ká̠ i̠â̠i̠â̠ ta̠ kë̀ ì ku̠	NOCHANGE
Ie' i̠ù̠	Ie' i̠ù̠	NOCHANGE
Diö́ tsu'ku ñá̠k ë̀ wö̀wó̠ sa'	Diö́ tsu'ku ñá̠k ë̀ wö̀wó̠ sa'	NOCHANGE
Be' tö i sa̠wè̠ke	Be' tö i sa̠wè̠ke	NOCHANGE
Wö́su̠k ta̠ icha e'ta̠ kë̀ e' wë́m sawàne̠ i yök i dawö'	Wö́su̠k ta̠ icha e'ta̠ kë̀ e' wë́m sawàne̠ i yök i dawö'	NOCHANGE
Skuë̀ ètöm	Skuë̀ ètöm	NOCHANGE
Ë́ ká̠ e̠'	Ë́ ká̠ e̠'	NOCHANGE
Ma̠ e̠' íyi ië̀rke̠ ka̠nò̠ a̠ ma̠ e' ku̠é̠ki̠	Ma̠ e̠' íyi ië̀rke̠ ka̠nò̠ a̠ ma̠ e' ku̠é̠ki̠	NOCHANGE
Be' mí̠ dé tké dià e' ta̠ kèrwa ñe̠' ki̠ wa wö́k ta̠ e' stsè stsèke̠ bö	Be' mí̠ dé tké dià e' ta̠ kèrwa ñe̠' ki̠ wa wö́k ta̠ e' stsè stsèke̠ bö	NOCHANGE
E' ia'wè̠ke̠	E' ia'wè̠ke̠	NOCHANGE
E'rö se' icha	E'rö se' icha	NOCHANGE
Be' é̠n a̠ i̠à̠na̠	Be' é̠n a̠ i̠à̠na̠	NOCHANGE
Dabòm tèryök	Dabòm tèryök	NOCHANGE
Ie' ajkö̀tto bùtsa̠na̠	Ie' ajkö̀tto bùtsa̠na̠	NOCHANGE
Ù ské̠l	Ù ské̠l	NOCHANGE
Wè̠s i' i' dör	Wè̠s i' i' dör	NOCHANGE
Tsíwö i' kë̀ yárwa!	Tsíwö i' kë̀ yárwa!	NOCHANGE
Ie' tö i yulèke	Ie' tö i yulèke	NOCHANGE
Ké̠we ta̠ sa' tö tsiru' wö̀ tèke̠	Ké̠we ta̠ sa' tö tsiru' wö̀ tèke̠	NOCHANGE
Na̠mù̠ tkë̀töm	Na̠mù̠ tkë̀töm	NOCHANGE
Ché ñe̠' éjkë	Ché ñe̠' éjkë	NOCHANGE
Ie' tö i ttè	Ie' tö i ttè	NOCHANGE
Ù yö'rak	Ù yö'rak	NOCHANGE
Bakò̠s sibö̀ tö sa' i pàke e' ujtè wa tö sa' tso'se̠n sè̠nu̠k	Bakò̠s sibö̀ tö sa' i pàke e' ujtè wa tö sa' tso'se̠n sè̠nu̠k	NOCHANGE
Ie' tö i chèke	Ie' tö i chèke	NOCHANGE
Ye' tö i kímè̠	Ye' tö i kímè̠	NOCHANGE
Aláköl ikuö̀	Aláköl ikuö̀	NOCHANGE
Ye' chkö̀ke	Ye' chkö̀ke	NOCHANGE
E' ë̀ yulèke̠ne̠	E' ë̀ yulèke̠ne̠	NOCHANGE
Be' ë́l sé̠rke̠ limón	Be' ë́l sé̠rke̠ limón	NOCHANGE
Ye'r i ali'	Ye'r i ali'	NOCHANGE
I' tkéka̠ma̠le̠ sö i̠a̠ ta̠ bua'ë	I' tkéka̠ma̠le̠ sö i̠a̠ ta̠ bua'ë	NOCHANGE
Ie' tö i batörè	Ie' tö i batörè	NOCHANGE
Pedro dör tabè akaù̠kna̠me̠ carnicería a̠	Pedro dör tabè akaù̠kna̠me̠ carnicería a̠	NOCHANGE
Ie' ttèke ma̠lí̠s uléka	Ie' ttèke ma̠lí̠s uléka	NOCHANGE
Ta̠ kë̀ ie' kú̠i̠a̠	Ta̠ kë̀ ie' kú̠i̠a̠	NOCHANGE
I yàmi̠pa	I yàmi̠pa	NOCHANGE
Wé̠ kë̀ wa̠ kë̀ i si̠wé̠ ujche̠n e' kë̀ a̠ se' bua'ne̠	Wé̠ kë̀ wa̠ kë̀ i si̠wé̠ ujche̠n e' kë̀ a̠ se' bua'ne̠	NOCHANGE
Ie' tö i tsirìwè̠ke	Ie' tö i tsirìwè̠ke	NOCHANGE
É! e' rö tsë'ka̠	É! e' rö tsë'ka̠	NOCHANGE
Sàlwak tkër mesa ki̠	Sàlwak tkër mesa ki̠	NOCHANGE
Wé̠ kë̀ wa̠ i ujche̠n dà a̠ e' ta̠ wake' se' ichè awá tsítsirpa ö	Wé̠ kë̀ wa̠ i ujche̠n dà a̠ e' ta̠ wake' se' ichè awá tsítsirpa ö	NOCHANGE
Be' kalö̀tö̀ke	Be' kalö̀tö̀ke	NOCHANGE
E'ta̠ e' e' mì̠k e' su̠lì̠tu ta̠ be'r i mé̠r síu̠k dìba a̠	E'ta̠ e' e' mì̠k e' su̠lì̠tu ta̠ be'r i mé̠r síu̠k dìba a̠	NOCHANGE
Ye'r i balë'	Ye'r i balë'	NOCHANGE
Ì wa se' wö̀batse ésela	Ì wa se' wö̀batse ésela	NOCHANGE
E' ta̠ ikuö̀ tsikìna̠ e' ta̠ átuwö mú̠ ta̠ ma̠ tsikìna̠	E' ta̠ ikuö̀ tsikìna̠ e' ta̠ átuwö mú̠ ta̠ ma̠ tsikìna̠	NOCHANGE
I' dör ùsulë ichö́kalene̠	I' dör ùsulë ichö́kalene̠	NOCHANGE
Ye' shkö̀ke	Ye' shkö̀ke	NOCHANGE
Ta̠ ma̠ bétk ma̠ tö̀ ma̠ tö̀	Ta̠ ma̠ bétk ma̠ tö̀ ma̠ tö̀	NOCHANGE
Ie' tö i i̠ù̠tèke	Ie' tö i i̠ù̠tèke	NOCHANGE
Kë̀ be'r i ichàkök!	Kë̀ be'r i ichàkök!	NOCHANGE
Tté tsó̠	Tté tsó̠	NOCHANGE
Kë̀ ye' wö́balar	Kë̀ ye' wö́balar	NOCHANGE
Aíjka ye' wö́kela sé̠rke̠	Aíjka ye' wö́kela sé̠rke̠	NOCHANGE
Ie' tsë̀rke	Ie' tsë̀rke	NOCHANGE
Ie' ù̠	Ie' ù̠	NOCHANGE
Ye' tö i kínè̠ke	Ye' tö i kínè̠ke	NOCHANGE
Bë̀kuö wë́r bua'ë ká̠kólttö a̠!	Bë̀kuö wë́r bua'ë ká̠kólttö a̠!	NOCHANGE
Ie' tö i yulè	Ie' tö i yulè	NOCHANGE
Be' tö i shkè̠wè̠ke	Be' tö i shkè̠wè̠ke	NOCHANGE
Ie' tö i wámbalè	Ie' tö i wámbalè	NOCHANGE
I ppö́	I ppö́	NOCHANGE
Ba e̠' chö́a̠t	Ba e̠' chö́a̠t	NOCHANGE
Sa' a̠ a̠mè̠ne̠ ië̀ka̠	Sa' a̠ a̠mè̠ne̠ ië̀ka̠	NOCHANGE
Ká̠ shá̠böts	Ká̠ shá̠böts	NOCHANGE
Ie' inù̠	Ie' inù̠	NOCHANGE
Io̠iò̠ta̠	Io̠iò̠ta̠	NOCHANGE
Katö̀k	Katö̀k	NOCHANGE
Pú̠ bák sa' katö́k i̠â̠chki	Pú̠ bák sa' katö́k i̠â̠chki	NOCHANGE
Be' tö i yèke	Be' tö i yèke	NOCHANGE
Datsi' ta̠wé̠ be' a̠ ye' dör	Datsi' ta̠wé̠ be' a̠ ye' dör	NOCHANGE
Ie' tö i ñè̠ke	Ie' tö i ñè̠ke	NOCHANGE
Tàyë bùsi a̠wì̠ kalö̀të' bókli ye' ta̠	Tàyë bùsi a̠wì̠ kalö̀të' bókli ye' ta̠	NOCHANGE
E' ku̠é̠ki̠ balë'këkëpa kë̀ i kukè kiö̀ ki̠	E' ku̠é̠ki̠ balë'këkëpa kë̀ i kukè kiö̀ ki̠	NOCHANGE
Ike e' ta̠	Ike e' ta̠	NOCHANGE
Àkbalö́kna̠me̠ dör aláköl ajkö̀mo̠' tsà̠mo̠ wa	Àkbalö́kna̠me̠ dör aláköl ajkö̀mo̠' tsà̠mo̠ wa	NOCHANGE
Térriki	Térriki	NOCHANGE
À̠s kë̀ ma̠	À̠s kë̀ ma̠	NOCHANGE
Be' tö i síwè̠ke	Be' tö i síwè̠ke	NOCHANGE
Ie' i yulö'	Ie' i yulö'	NOCHANGE
Ie' e̠' chö̀a̠t	Ie' e̠' chö̀a̠t	NOCHANGE
Se'r i kièmi̠	Se'r i kièmi̠	NOCHANGE
Kë̀ kapö̀ku̠ i tàyë ta̠ yë́s	Kë̀ kapö̀ku̠ i tàyë ta̠ yë́s	NOCHANGE
Kàl sé̠	Kàl sé̠	NOCHANGE
Trini a̠	Trini a̠	NOCHANGE
I dátsi̠ke cha	I dátsi̠ke cha	NOCHANGE
Be' wö́balar ajkö̀yö́nu̠k	Be' wö́balar ajkö̀yö́nu̠k	NOCHANGE
Kë̀ të̀na̠ne̠ ie'pa a̠ o' pá̠rlorne̠	Kë̀ të̀na̠ne̠ ie'pa a̠ o' pá̠rlorne̠	NOCHANGE
Ye' kiàna̠	Ye' kiàna̠	NOCHANGE
Ie' tsë̀r	Ie' tsë̀r	NOCHANGE
Wé̠ wa̠ i të́rule dö̀ka̠	Wé̠ wa̠ i të́rule dö̀ka̠	NOCHANGE
Ie' tö i tsirìwè̠	Ie' tö i tsirìwè̠	NOCHANGE
Ulà dé ulà dalë̀na̠ ma̠ ta̠ e'la ka̠nè̠u̠k	Ulà dé ulà dalë̀na̠ ma̠ ta̠ e'la ka̠nè̠u̠k	NOCHANGE
Ie' ajkàku̠'	Ie' ajkàku̠'	NOCHANGE
Ye' ë́l sé̠rke̠ aísh ká̠ batà	Ye' ë́l sé̠rke̠ aísh ká̠ batà	NOCHANGE
Bö́iki	Bö́iki	NOCHANGE
Ye' tö i kièke	Ye' tö i kièke	NOCHANGE
Ie' tö i sa̠wè̠	Ie' tö i sa̠wè̠	NOCHANGE
Aláala tso' e̠'abâu̠k	Aláala tso' e̠'abâu̠k	NOCHANGE
Be' tö i pàlè	Be' tö i pàlè	NOCHANGE
Be' sè̠rke	Be' sè̠rke	NOCHANGE
E' töla ìla aë̀ ijtsèmi̠la	E' töla ìla aë̀ ijtsèmi̠la	NOCHANGE
Bikli' sí arki̠	Bikli' sí arki̠	NOCHANGE
Ye' tsö̀ke	Ye' tsö̀ke	NOCHANGE
Ye' tö i alèke	Ye' tö i alèke	NOCHANGE
Ie' tsö̀	Ie' tsö̀	NOCHANGE
Sa' wö́su̠k pedro sé̠rke̠	Sa' wö́su̠k pedro sé̠rke̠	NOCHANGE
Ká̠ e'tk ë̀	Ká̠ e'tk ë̀	NOCHANGE
E' ta̠ wâke' kë̀ se' bák a̠ e' ëka̠	E' ta̠ wâke' kë̀ se' bák a̠ e' ëka̠	NOCHANGE
Ie' tö i shkè̠wè̠ke	Ie' tö i shkè̠wè̠ke	NOCHANGE
I bikö́kmi̠	I bikö́kmi̠	NOCHANGE
Ma̠ së́baliwak	Ma̠ së́baliwak	NOCHANGE
Be' chakö́!	Be' chakö́!	NOCHANGE
Dù ñe̠'	Dù ñe̠'	NOCHANGE
Be' è̠rke	Be' è̠rke	NOCHANGE
Mí̠shka kalö̀tök!	Mí̠shka kalö̀tök!	NOCHANGE
Ie' tö i kè	Ie' tö i kè	NOCHANGE
Ye' tö i shkè̠wè̠	Ye' tö i shkè̠wè̠	NOCHANGE
Ichàkök	Ichàkök	NOCHANGE
Ma̠ e's i yawèke̠	Ma̠ e's i yawèke̠	NOCHANGE
Ye' tö i mo̠wè̠ke	Ye' tö i mo̠wè̠ke	NOCHANGE
Tsá̠li̠ ta̠ se' bité̠yartkene̠ déne̠	Tsá̠li̠ ta̠ se' bité̠yartkene̠ déne̠	NOCHANGE
Ye' e̠' dalë̀na̠i̠a̠pa	Ye' e̠' dalë̀na̠i̠a̠pa	NOCHANGE
Sa̠mé̠ e' kë̀ bua'ne̠	Sa̠mé̠ e' kë̀ bua'ne̠	NOCHANGE
Yàno̠ wé̠shke̠	Yàno̠ wé̠shke̠	NOCHANGE
Yawö̀k	Yawö̀k	NOCHANGE
Ie' tù̠rke	Ie' tù̠rke	NOCHANGE
E'ta̠ ña̠ mí̠tke i wàta̠ú̠k	E'ta̠ ña̠ mí̠tke i wàta̠ú̠k	NOCHANGE
Kë̀ ie' kapé ta̠	Kë̀ ie' kapé ta̠	NOCHANGE
Be' tö i tsirìwè̠ke	Be' tö i tsirìwè̠ke	NOCHANGE
Na̠ñé̠we bakali' dör e'tk dakarò tsémi̠	Na̠ñé̠we bakali' dör e'tk dakarò tsémi̠	NOCHANGE
Be' ichè sö i ujtè dé ské̠l e' ta̠ e' ta̠	Be' ichè sö i ujtè dé ské̠l e' ta̠ e' ta̠	NOCHANGE
Ie' i̠é̠	Ie' i̠é̠	NOCHANGE
Ye'r datsi' ta̠wé̠ be' a̠	Ye'r datsi' ta̠wé̠ be' a̠	NOCHANGE
Wámbalök	Wámbalök	NOCHANGE
Ye'r i bík	Ye'r i bík	NOCHANGE
Ie' akuö̀ke	Ie' akuö̀ke	NOCHANGE
A̠wì̠ ák wé mé̠rka̠ e' kiè alòwe	A̠wì̠ ák wé mé̠rka̠ e' kiè alòwe	NOCHANGE
Ulàmu̠k	Ulàmu̠k	NOCHANGE
Dö̀mi̠ dabòm bö́yök ù wa ta̠	Dö̀mi̠ dabòm bö́yök ù wa ta̠	NOCHANGE
E' ta̠ wake' ie' se' yèwadà wake'	E' ta̠ wake' ie' se' yèwadà wake'	NOCHANGE
Be' tö i pàlèke	Be' tö i pàlèke	NOCHANGE
Ské̠iki	Ské̠iki	NOCHANGE
E̠' rö ma̠ ie' wa̠ ie' wa̠ chìchi dë́ka̠ tkër	E̠' rö ma̠ ie' wa̠ ie' wa̠ chìchi dë́ka̠ tkër	NOCHANGE
E' ukö̀ki̠ ùkö të́rke̠	E' ukö̀ki̠ ùkö të́rke̠	NOCHANGE
Mì̠ka̠ tsiru' dawówa̠ ta̠	Mì̠ka̠ tsiru' dawówa̠ ta̠	NOCHANGE
Iku̠á̠ki̠ iku̠á̠ki̠ sa' é̠n a̠ i̠à̠ne̠ bua'ë	Iku̠á̠ki̠ iku̠á̠ki̠ sa' é̠n a̠ i̠à̠ne̠ bua'ë	NOCHANGE
Mì̠k ie' ú̠ne̠ e' ku̠é̠ki̠ ta̠ se' nú̠ tsakìne̠wa̠	Mì̠k ie' ú̠ne̠ e' ku̠é̠ki̠ ta̠ se' nú̠ tsakìne̠wa̠	NOCHANGE
E' ta̠ sö i bitséitsèke̠ i̠a̠ ö kë̀ sö i bitséitsè i̠a̠	E' ta̠ sö i bitséitsèke̠ i̠a̠ ö kë̀ sö i bitséitsè i̠a̠	NOCHANGE
Ye' tö i kièke	Ye' tö i kièke	NOCHANGE
Ba shkö́ka̠	Ba shkö́ka̠	NOCHANGE
Cien tèryök	Cien tèryök	NOCHANGE
Dabòm ské̠yök	Dabòm ské̠yök	NOCHANGE
U̠jù̠ yë̀na̠ mò̠ki̠ ë	U̠jù̠ yë̀na̠ mò̠ki̠ ë	NOCHANGE
Ie' tö i akuö̀wè̠ke	Ie' tö i akuö̀wè̠ke	NOCHANGE
Ye' tö i ichàkè	Ye' tö i ichàkè	NOCHANGE
Ye' shkö̀	Ye' shkö̀	NOCHANGE
I mó̠u̠	I mó̠u̠	NOCHANGE
Be'a̠ ye'r datsi' ta̠wé̠	Be'a̠ ye'r datsi' ta̠wé̠	NOCHANGE
Ye' sè̠rke	Ye' sè̠rke	NOCHANGE
Ye' tö i à̠ritsèke	Ye' tö i à̠ritsèke	NOCHANGE
Ák wö̀chka	Ák wö̀chka	NOCHANGE
Ie' dör dalì apámu̠e̠ kabàiö ki̠	Ie' dör dalì apámu̠e̠ kabàiö ki̠	NOCHANGE
Ká̠ i' alákölpa	Ká̠ i' alákölpa	NOCHANGE
Ù wâ̠nwâ̠n	Ù wâ̠nwâ̠n	NOCHANGE
E' wa sö ùkö bakèke̠	E' wa sö ùkö bakèke̠	NOCHANGE
Be' tö i tkè	Be' tö i tkè	NOCHANGE
Kë̀ i̠a̠ wake' ì ku̠ e'r ák e' e'r ák e'	Kë̀ i̠a̠ wake' ì ku̠ e'r ák e' e'r ák e'	NOCHANGE
Ìsela í̠e̠la ye' dë́ka̠lala	Ìsela í̠e̠la ye' dë́ka̠lala	NOCHANGE
E's ie' e's ie' se' ujtèke̠wa̠	E's ie' e's ie' se' ujtèke̠wa̠	NOCHANGE
Cien tkë́yök	Cien tkë́yök	NOCHANGE
Ye' tö i rrát	Ye' tö i rrát	NOCHANGE
Ìriria ki̠ se' dakö̀ke̠	Ìriria ki̠ se' dakö̀ke̠	NOCHANGE
Tabèla i' kë̀ aká ta̠	Tabèla i' kë̀ aká ta̠	NOCHANGE
Chkö̀k	Chkö̀k	NOCHANGE
I̠à̠na̠ ta̠ à̠s se' se' sé̠ndak wè̠s ie' ki̠ i kiàna̠ e's	I̠à̠na̠ ta̠ à̠s se' se' sé̠ndak wè̠s ie' ki̠ i kiàna̠ e's	NOCHANGE
Ye' tö i wè	Ye' tö i wè	NOCHANGE
I nú̠lapa tulúr tö á̠jà̠	I nú̠lapa tulúr tö á̠jà̠	NOCHANGE
Ie' tö i ttè	Ie' tö i ttè	NOCHANGE
Bö́iki	Bö́iki	NOCHANGE
Pero kë̀ wake' se' bua'ne̠	Pero kë̀ wake' se' bua'ne̠	NOCHANGE
Ba kalö̀tö́	Ba kalö̀tö́	NOCHANGE
Ña̠lé̠ tétsa̠mi̠ bua'ë	Ña̠lé̠ tétsa̠mi̠ bua'ë	NOCHANGE
Be' tö i yawèke	Be' tö i yawèke	NOCHANGE
Si̠o̠' bö̀k	Si̠o̠' bö̀k	NOCHANGE
Saco e'k ti̠è̠ka̠mi̠ tsì̠ ki̠	Saco e'k ti̠è̠ka̠mi̠ tsì̠ ki̠	NOCHANGE
Ie' wa̠ i si̠wé̠ ujche̠n	Ie' wa̠ i si̠wé̠ ujche̠n	NOCHANGE
Kiè ichàkök	Kiè ichàkök	NOCHANGE
Ye' tö i kímè̠ke	Ye' tö i kímè̠ke	NOCHANGE
Awápa bö̀l tulur ù wö́su̠k	Awápa bö̀l tulur ù wö́su̠k	NOCHANGE
Apà wé̠ e̠' ia'wé̠ e' ta̠ e' ö wé̠ wé̠ wa̠ i kö̀tule ské̠l e' dör e' wö̀	Apà wé̠ e̠' ia'wé̠ e' ta̠ e' ö wé̠ wé̠ wa̠ i kö̀tule ské̠l e' dör e' wö̀	NOCHANGE
Ñe̠' ta̠ ye' ú̠n ta̠ a̠wì̠ëka̠ awí̠she̠t a̠wí̠	Ñe̠' ta̠ ye' ú̠n ta̠ a̠wì̠ëka̠ awí̠she̠t a̠wí̠	NOCHANGE
Kë̀ i kiàne̠ tkèi̠a̠ sulë̀ wa é̠ma̠ se' dö̀ràne̠ se' icha wa shka̠me̠'la wa	Kë̀ i kiàne̠ tkèi̠a̠ sulë̀ wa é̠ma̠ se' dö̀ràne̠ se' icha wa shka̠me̠'la wa	NOCHANGE
Wö̀shkiwè̠ke̠wa̠ kàlkicha wa	Wö̀shkiwè̠ke̠wa̠ kàlkicha wa	NOCHANGE
Shù̠ a̠	Shù̠ a̠	NOCHANGE
Ie' wa̠ i ujche̠n e' ta̠ ie' se' bua'wé̠ne̠	Ie' wa̠ i ujche̠n e' ta̠ ie' se' bua'wé̠ne̠	NOCHANGE
Pèstsa̠ a̠mè̠ke̠a̠t sö bua'ë	Pèstsa̠ a̠mè̠ke̠a̠t sö bua'ë	NOCHANGE
Ye' ka̠nè̠balö̀ke	Ye' ka̠nè̠balö̀ke	NOCHANGE
Ye' yë́ tso' i tabè akâu̠k	Ye' yë́ tso' i tabè akâu̠k	NOCHANGE
I kuö́	I kuö́	NOCHANGE
E' ukö̀ki̠ ta̠ ñe̠' sö i ti̠è̠ka̠ bitù̠	E' ukö̀ki̠ ta̠ ñe̠' sö i ti̠è̠ka̠ bitù̠	NOCHANGE
E' ku̠é̠ki̠ i' ta̠ i' kiè kë'köldi	E' ku̠é̠ki̠ i' ta̠ i' kiè kë'köldi	NOCHANGE
Ye' kàbalö̀ke̠ i sa̠ú̠k	Ye' kàbalö̀ke̠ i sa̠ú̠k	NOCHANGE
Ye' e̠' chö̀a̠t	Ye' e̠' chö̀a̠t	NOCHANGE
Bùsipa	Bùsipa	NOCHANGE
Entonces ie' dë'rö ye' tsú̠k ye' ma̠nè̠ta̠	Entonces ie' dë'rö ye' tsú̠k ye' ma̠nè̠ta̠	NOCHANGE
Ma̠ bula'me̠ ta̠ ká̠ñì̠na̠ ta̠ se' mí̠ dé tké dià e̠' kèrwa apàtök	Ma̠ bula'me̠ ta̠ ká̠ñì̠na̠ ta̠ se' mí̠ dé tké dià e̠' kèrwa apàtök	NOCHANGE
Kë̀ i̠nì̠ne̠ka̠	Kë̀ i̠nì̠ne̠ka̠	NOCHANGE
Dabòm pàryök kí̠ et	Dabòm pàryök kí̠ et	NOCHANGE
Ká̠m kalötèke̠	Ká̠m kalötèke̠	NOCHANGE
Ie' sibö̀ a̠ chéne̠ ma̠ñà̠tökicha ta̠ sibö̀ ie' a̠ i ché	Ie' sibö̀ a̠ chéne̠ ma̠ñà̠tökicha ta̠ sibö̀ ie' a̠ i ché	NOCHANGE
Dabòm kúlyök kí̠ su̠lì̠tu	Dabòm kúlyök kí̠ su̠lì̠tu	NOCHANGE
E' ta wè̠s e' bitséitsèke̠ ie' dör	E' ta wè̠s e' bitséitsèke̠ ie' dör	NOCHANGE
Kë̀ a' stsë́nu̠k apë' íyi ta̠!	Kë̀ a' stsë́nu̠k apë' íyi ta̠!	NOCHANGE
U̠jú̠!	U̠jú̠!	NOCHANGE
Ukö̀ki̠ ta̠ mì̠ka̠ ye' dé bùsi	Ukö̀ki̠ ta̠ mì̠ka̠ ye' dé bùsi	NOCHANGE
E' yawèke̠ balo'ie	E' yawèke̠ balo'ie	NOCHANGE
Se' ichala wàta̠wé̠lorma̠le̠	Se' ichala wàta̠wé̠lorma̠le̠	NOCHANGE
E'ta̠ yö i tâwe̠ bua'ë e'ta̠ yö i yawé bité̠tke ñé̠e̠	E'ta̠ yö i tâwe̠ bua'ë e'ta̠ yö i yawé bité̠tke ñé̠e̠	NOCHANGE
Kë̀ sìkua mì̠ne̠ tsu'ku sìkua bák ka̠nè̠balök e̠' ká̠ kièke̠ tsiö̀ ù batà	Kë̀ sìkua mì̠ne̠ tsu'ku sìkua bák ka̠nè̠balök e̠' ká̠ kièke̠ tsiö̀ ù batà	NOCHANGE
Ie' tö i wèke	Ie' tö i wèke	NOCHANGE
Namù̠ tú̠n kö̀tkkö̀tk	Namù̠ tú̠n kö̀tkkö̀tk	NOCHANGE
Ö í̠ma̠ bua' iö́köl ie	Ö í̠ma̠ bua' iö́köl ie	NOCHANGE
Ë́ yö ë́ yö	Ë́ yö ë́ yö	NOCHANGE
Ye' tö i wè̠ke	Ye' tö i wè̠ke	NOCHANGE
Ie' tö i batörèke	Ie' tö i batörèke	NOCHANGE
Wè̠s e' ye'r be' a̠ chèmi̠ tö	Wè̠s e' ye'r be' a̠ chèmi̠ tö	NOCHANGE
Bö'wö tso'	Bö'wö tso'	NOCHANGE
Ie' ttö̀ke	Ie' ttö̀ke	NOCHANGE
Kë̀ sa' ka̠nè̠balö e' ta̠ ì ñè̠ke̠ sa' tö e' ku̠é̠ki̠ ujú!	Kë̀ sa' ka̠nè̠balö e' ta̠ ì ñè̠ke̠ sa' tö e' ku̠é̠ki̠ ujú!	NOCHANGE
Ye' tö i akuö̀wè̠	Ye' tö i akuö̀wè̠	NOCHANGE
I ttö́	I ttö́	NOCHANGE
E' wà dör tö ie' dör se' a̠mì̠wöla	E' wà dör tö ie' dör se' a̠mì̠wöla	NOCHANGE
Ie' tö i i̠ù̠tèke	Ie' tö i i̠ù̠tèke	NOCHANGE
Ie' tö i ka̠nè̠wè̠ke	Ie' tö i ka̠nè̠wè̠ke	NOCHANGE
Ie' shkö̀ka̠	Ie' shkö̀ka̠	NOCHANGE
Ye' tö i ppèke	Ye' tö i ppèke	NOCHANGE
Be' tö i tsèke	Be' tö i tsèke	NOCHANGE
E' ku̠é̠ki̠ e' dalö̀ ta̠	E' ku̠é̠ki̠ e' dalö̀ ta̠	NOCHANGE
Ye' tö i shtè	Ye' tö i shtè	NOCHANGE
Dabòm ské̠yök kí̠ bö̀t	Dabòm ské̠yök kí̠ bö̀t	NOCHANGE
Ie'pa yë́ sku' wa	Ie'pa yë́ sku' wa	NOCHANGE
Balë'këkëpa i apàke tö	Balë'këkëpa i apàke tö	NOCHANGE
Wè̠s kirë̀rma̠pa icha wé ma̠	Wè̠s kirë̀rma̠pa icha wé ma̠	NOCHANGE
Ie' ùshikalö̀	Ie' ùshikalö̀	NOCHANGE
Ká̠ bakò̠s	Ká̠ bakò̠s	NOCHANGE
Átu kuátkök ñè̠ ye' alâr wös	Átu kuátkök ñè̠ ye' alâr wös	NOCHANGE
Be' ttö̀ke	Be' ttö̀ke	NOCHANGE
Ie' kapö̀kewa̠	Ie' kapö̀kewa̠	NOCHANGE
Cha̠mù̠ kuála tsikìna̠	Cha̠mù̠ kuála tsikìna̠	NOCHANGE
Be' e̠' yawö̀ke	Be' e̠' yawö̀ke	NOCHANGE
Ie' tö i batörèke	Ie' tö i batörèke	NOCHANGE
Kàsir ètöm	Kàsir ètöm	NOCHANGE
Ie' tö i kínè̠ke	Ie' tö i kínè̠ke	NOCHANGE
Be' tö i tèke	Be' tö i tèke	NOCHANGE
È̠nu̠k	È̠nu̠k	NOCHANGE
Be' akuö̀ke	Be' akuö̀ke	NOCHANGE
Ye' tö i pàlèke	Ye' tö i pàlèke	NOCHANGE
Tsiö̀ ù batà e'r wé̠rö	Tsiö̀ ù batà e'r wé̠rö	NOCHANGE
Ye'r ye' ë́l yulö̀ke̠	Ye'r ye' ë́l yulö̀ke̠	NOCHANGE
E'ta̠ kàlkö ñé̠ wa yö e' aléka̠ yö dìba a̠ e' wa yö e' a̠ yö í̠e̠ ié ié	E'ta̠ kàlkö ñé̠ wa yö e' aléka̠ yö dìba a̠ e' wa yö e' a̠ yö í̠e̠ ié ié	NOCHANGE
Kabë̀pa	Kabë̀pa	NOCHANGE
Ie' kalö̀tö̀ke	Ie' kalö̀tö̀ke	NOCHANGE
Ie' i̠né̠	Ie' i̠né̠	NOCHANGE
Pero e'r i̠â̠i̠â̠ ichö́kle	Pero e'r i̠â̠i̠â̠ ichö́kle	NOCHANGE
Be' ajkö̀jkuö dör buambuála	Be' ajkö̀jkuö dör buambuála	NOCHANGE
E' ajkö́ a̠ wé̠shke̠ ie se' té̠rse̠	E' ajkö́ a̠ wé̠shke̠ ie se' té̠rse̠	NOCHANGE
E'r se' se' mí̠k a̠ se' pë́ tkáwa ta̠	E'r se' se' mí̠k a̠ se' pë́ tkáwa ta̠	NOCHANGE
Ie' e̠' yë́ttsa̠ kanè̠ e' yök	Ie' e̠' yë́ttsa̠ kanè̠ e' yök	NOCHANGE
Ie' tö i mo̠wè̠ke	Ie' tö i mo̠wè̠ke	NOCHANGE
Ta̠ ma̠ bua'ë	Ta̠ ma̠ bua'ë	NOCHANGE
Balë'kë́këpa bùlikalö̀	Balë'kë́këpa bùlikalö̀	NOCHANGE
Sö ichö̀ i wö̀ wö̀ shlë́wöla	Sö ichö̀ i wö̀ wö̀ shlë́wöla	NOCHANGE
Wé̠ wa̠ i si̠wé̠ ujche̠n e' e'r se' bua'wè̠ne̠	Wé̠ wa̠ i si̠wé̠ ujche̠n e' e'r se' bua'wè̠ne̠	NOCHANGE
Alà ikalë' ikalö́ö!	Alà ikalë' ikalö́ö!	NOCHANGE
Ie' shkö̀ke	Ie' shkö̀ke	NOCHANGE
Wë́stëla!	Wë́stëla!	NOCHANGE
Ye' kë̀ ki̠ akáale kiar	Ye' kë̀ ki̠ akáale kiar	NOCHANGE
Ie' tö i wèke	Ie' tö i wèke	NOCHANGE
Ká̠ kàchok	Ká̠ kàchok	NOCHANGE
A̠là̠chka ki̠ ì ki̠	A̠là̠chka ki̠ ì ki̠	NOCHANGE
Kolóma̠wak	Kolóma̠wak	NOCHANGE
I wa ta̠' íla kiàna̠ se' kí̠mu̠k skéla	I wa ta̠' íla kiàna̠ se' kí̠mu̠k skéla	NOCHANGE
Be' chkö̀	Be' chkö̀	NOCHANGE
Dawáska e' ta̠ be' mi̠'ke̠ sulë̀ wa i wébalök	Dawáska e' ta̠ be' mi̠'ke̠ sulë̀ wa i wébalök	NOCHANGE
Ye' yë́	Ye' yë́	NOCHANGE
Apë' dalì tso'tke wé̠shke̠	Apë' dalì tso'tke wé̠shke̠	NOCHANGE
Ahora e' mì̠k ye'r i kiè mí̠k alí	Ahora e' mì̠k ye'r i kiè mí̠k alí	NOCHANGE
Kàl ö i' e' talárke̠ ie' jkö̀ mi̠k	Kàl ö i' e' talárke̠ ie' jkö̀ mi̠k	NOCHANGE
I klö̀u̠wa̠ ie' wa̠ ma̠lí̠s	I klö̀u̠wa̠ ie' wa̠ ma̠lí̠s	NOCHANGE
Ie' tö i pàlè	Ie' tö i pàlè	NOCHANGE
E'ta̠ wé̠s i batséi tsè̠ke̠	E'ta̠ wé̠s i batséi tsè̠ke̠	NOCHANGE
Kó̠pàkök	Kó̠pàkök	NOCHANGE
Kë̀ ie' a̠ sabák yör	Kë̀ ie' a̠ sabák yör	NOCHANGE
Ie'pa balë'këkëpa e' apàke tö ie'pa e' yík ñè̠ke e' wa icha i wö̀ kió ie	Ie'pa balë'këkëpa e' apàke tö ie'pa e' yík ñè̠ke e' wa icha i wö̀ kió ie	NOCHANGE
E' ë̀ kèke̠ka̠	E' ë̀ kèke̠ka̠	NOCHANGE
Kë̀ íyi wàta̠wè̠	Kë̀ íyi wàta̠wè̠	NOCHANGE
Be' tö i wámbalèke	Be' tö i wámbalèke	NOCHANGE
À̠ritsök	À̠ritsök	NOCHANGE
Ma̠ e' tso'	Ma̠ e' tso'	NOCHANGE
Pero e'r ká̠ i̠â̠i̠â̠ë	Pero e'r ká̠ i̠â̠i̠â̠ë	NOCHANGE
Aléka̠ wö̀ë	Aléka̠ wö̀ë	NOCHANGE
Kë̀ ye'r i sa̠wè̠ku̠	Kë̀ ye'r i sa̠wè̠ku̠	NOCHANGE
Entonces e' rö pú̠ kö́twa̠ ie'pa rö	Entonces e' rö pú̠ kö́twa̠ ie'pa rö	NOCHANGE
E'tk e'tk e'tk e'tk ña̠ i apàkö e'tk e'tk e'tk	E'tk e'tk e'tk e'tk ña̠ i apàkö e'tk e'tk e'tk	NOCHANGE
Se' shù̠ wö̀tewa̠ irir e' ku̠é̠ki̠	Se' shù̠ wö̀tewa̠ irir e' ku̠é̠ki̠	NOCHANGE
Ñe̠' yö i ché ye' ma̠nè̠ta̠	Ñe̠' yö i ché ye' ma̠nè̠ta̠	NOCHANGE
Be' shkö̀ke	Be' shkö̀ke	NOCHANGE
Shkè̠u̠k	Shkè̠u̠k	NOCHANGE
Ie' tö i kuátkè	Ie' tö i kuátkè	NOCHANGE
Aíkö dör tsipátsipâ	Aíkö dör tsipátsipâ	NOCHANGE
Ie' shkö̀ke	Ie' shkö̀ke	NOCHANGE
Mí̠shka balo' yök	Mí̠shka balo' yök	NOCHANGE
Ajkö́no̠ ie se' a̠ sè̠no̠ ie	Ajkö́no̠ ie se' a̠ sè̠no̠ ie	NOCHANGE
Ta̠ i̠nì̠na̠ bachábachaë e̠me̠	Ta̠ i̠nì̠na̠ bachábachaë e̠me̠	NOCHANGE
Ye' dör i ale	Ye' dör i ale	NOCHANGE
Ie' tö i síwè̠ke	Ie' tö i síwè̠ke	NOCHANGE
I ka̠nè̠ú̠	I ka̠nè̠ú̠	NOCHANGE
Ie' tö i ichàkèke	Ie' tö i ichàkèke	NOCHANGE
Ù̠ ñe̠' dikì̠	Ù̠ ñe̠' dikì̠	NOCHANGE
Sanjoséwak	Sanjoséwak	NOCHANGE
E' yawè yö í̠ma̠ bua' yawèke̠ í̠ma̠ bua' ie yö i yawè	E' yawè yö í̠ma̠ bua' yawèke̠ í̠ma̠ bua' ie yö i yawè	NOCHANGE
Be' tsë̀rke	Be' tsë̀rke	NOCHANGE
Kirë̀rma̠ kirë̀rma̠la	Kirë̀rma̠ kirë̀rma̠la	NOCHANGE
Ie' ka̠nè̠balö̀ke	Ie' ka̠nè̠balö̀ke	NOCHANGE
Ye' yàmi̠ ù dör ákchaka	Ye' yàmi̠ ù dör ákchaka	NOCHANGE
Ie' tö i yawè	Ie' tö i yawè	NOCHANGE
Ye' tö i tsirìwè̠ke	Ye' tö i tsirìwè̠ke	NOCHANGE
Be' tö i yè	Be' tö i yè	NOCHANGE
Ie' tö i tkè	Ie' tö i tkè	NOCHANGE
Ké̠kra wake' e' bitséitsèke	Ké̠kra wake' e' bitséitsèke	NOCHANGE
E' shù̠ a̠ ie'pa wa̠ shka̠lá̠ mí̠rwa̠	E' shù̠ a̠ ie'pa wa̠ shka̠lá̠ mí̠rwa̠	NOCHANGE
E' a̠ ie'r skà ie' dawè tso' e' ku̠é̠ki̠ e' ñè̠ke	E' a̠ ie'r skà ie' dawè tso' e' ku̠é̠ki̠ e' ñè̠ke	NOCHANGE
Ie' ka̠nè̠balö̀	Ie' ka̠nè̠balö̀	NOCHANGE
Brö̀ ì	Brö̀ ì	NOCHANGE
Sá̠u̠k	Sá̠u̠k	NOCHANGE
Be'r bë́ma̠le̠k!	Be'r bë́ma̠le̠k!	NOCHANGE
Ye' ki̠ dawás tso' dieciocho	Ye' ki̠ dawás tso' dieciocho	NOCHANGE
E' ku̠é̠ki̠ se' ka' i dalö̀iök	E' ku̠é̠ki̠ se' ka' i dalö̀iök	NOCHANGE
E'r be' kutàiene̠	E'r be' kutàiene̠	NOCHANGE
Mu̠lù̠tak ñá̠ tèke̠	Mu̠lù̠tak ñá̠ tèke̠	NOCHANGE
Ie' e̠' chö̀kea̠t	Ie' e̠' chö̀kea̠t	NOCHANGE
E' ta̠ bua' i ya'	E' ta̠ bua' i ya'	NOCHANGE
I tkö́	I tkö́	NOCHANGE
Sa' tso' bàk yulö́k ma̠ñà̠tkue	Sa' tso' bàk yulö́k ma̠ñà̠tkue	NOCHANGE
É̠nu̠k	É̠nu̠k	NOCHANGE
Sí ie' tàyé ta̠' ma̠ ie' tàyë kapö̀ke̠ báne̠t ie' wák kapö̀ke̠ tër báne̠t	Sí ie' tàyé ta̠' ma̠ ie' tàyë kapö̀ke̠ báne̠t ie' wák kapö̀ke̠ tër báne̠t	NOCHANGE
Ie' tö i kièke	Ie' tö i kièke	NOCHANGE
Má̠shma̠sh	Má̠shma̠sh	NOCHANGE
E' dör tsítsipala apàto	E' dör tsítsipala apàto	NOCHANGE
Éjkë éjkë ka̠nè̠balök ye' bák ie' ie' kalö̀ mi̠k	Éjkë éjkë ka̠nè̠balök ye' bák ie' ie' kalö̀ mi̠k	NOCHANGE
Ye' ká̠ko	Ye' ká̠ko	NOCHANGE
Ye'r i bulâo̠	Ye'r i bulâo̠	NOCHANGE
Na̠ñé̠we	Na̠ñé̠we	NOCHANGE
Má̠la tsú̠k ka̠ñí̠k a̠ ña̠ itö̀ki̠ ña̠	Má̠la tsú̠k ka̠ñí̠k a̠ ña̠ itö̀ki̠ ña̠	NOCHANGE
Ie' tö i tsèke	Ie' tö i tsèke	NOCHANGE
Ukö̀ skà	Ukö̀ skà	NOCHANGE
Be' tö i ichàkèke	Be' tö i ichàkèke	NOCHANGE
Ie' tö i ttèke	Ie' tö i ttèke	NOCHANGE
Ye' ká̠wöta̠' be' sa̠ú̠k be' ù a̠	Ye' ká̠wöta̠' be' sa̠ú̠k be' ù a̠	NOCHANGE
Ie' tö i kuátkèke	Ie' tö i kuátkèke	NOCHANGE
Ké̠kraë e' ppèke̠	Ké̠kraë e' ppèke̠	NOCHANGE
Ye'r i sú̠kule	Ye'r i sú̠kule	NOCHANGE
Tsèke̠i̠a̠ ie'pa mi̠'ke̠ itö̀ki̠ itö̀ki̠	Tsèke̠i̠a̠ ie'pa mi̠'ke̠ itö̀ki̠ itö̀ki̠	NOCHANGE
E' ta̠ be' bák i̠a̠ tsítsir wake'	E' ta̠ be' bák i̠a̠ tsítsir wake'	NOCHANGE
Di' katö̀k	Di' katö̀k	NOCHANGE
Ie' tö i shtèke	Ie' tö i shtèke	NOCHANGE
Sí se' rö sìkua icha	Sí se' rö sìkua icha	NOCHANGE
Mí̠shka!	Mí̠shka!	NOCHANGE
Si' wa íyi ta̠wé̠ tsá̠tke	Si' wa íyi ta̠wé̠ tsá̠tke	NOCHANGE
Tàyë kí̠mú̠ i dalì wa!	Tàyë kí̠mú̠ i dalì wa!	NOCHANGE
Kàlula ki̠	Kàlula ki̠	NOCHANGE
Ie' tsò' su̠lì̠ ajkuö̀biök	Ie' tsò' su̠lì̠ ajkuö̀biök	NOCHANGE
Kàrbali ki̠ be' ú̠rke̠ a̠wí̠ e' ëka̠ ta̠ kë̀ be' ú̠r ta̠ ali'wöla wébalök	Kàrbali ki̠ be' ú̠rke̠ a̠wí̠ e' ëka̠ ta̠ kë̀ be' ú̠r ta̠ ali'wöla wébalök	NOCHANGE
I wë̀na̠ i yë́pa ta̠ balë'kë́këpa ta̠	I wë̀na̠ i yë́pa ta̠ balë'kë́këpa ta̠	NOCHANGE
Ñi̠ ni̠mà̠	Ñi̠ ni̠mà̠	NOCHANGE
Kímu̠k	Kímu̠k	NOCHANGE
I kiówa̠ e̠' dör	I kiówa̠ e̠' dör	NOCHANGE
Ie' tö i kínè̠	Ie' tö i kínè̠	NOCHANGE
Be' ká̠	Be' ká̠	NOCHANGE
Ie' tù̠r	Ie' tù̠r	NOCHANGE
Be' e̠' chö̀a̠t	Be' e̠' chö̀a̠t	NOCHANGE
Ie' tö i tsirìwè̠ke	Ie' tö i tsirìwè̠ke	NOCHANGE
E' wa ie'pa i ujtèke̠	E' wa ie'pa i ujtèke̠	NOCHANGE
I kalö̀	I kalö̀	NOCHANGE
Sa' wákpa é̠n a̠ sa' ujtè i̠à̠ne̠	Sa' wákpa é̠n a̠ sa' ujtè i̠à̠ne̠	NOCHANGE
Be' tö i katèke	Be' tö i katèke	NOCHANGE
Ie' tö i yèke	Ie' tö i yèke	NOCHANGE
Kë̀ be' i tsiríwe̠ i̠a̠ bua' ie	Kë̀ be' i tsiríwe̠ i̠a̠ bua' ie	NOCHANGE
Ye' tsë̀rke	Ye' tsë̀rke	NOCHANGE
Ie' i̠i̠'	Ie' i̠i̠'	NOCHANGE
I éjkë ta̠ kë̀ ì à̠te̠	I éjkë ta̠ kë̀ ì à̠te̠	NOCHANGE
O' dör akàdìdì	O' dör akàdìdì	NOCHANGE
Be' tö i ichàkèke	Be' tö i ichàkèke	NOCHANGE
Ie' tsë̀r	Ie' tsë̀r	NOCHANGE
E' ta̠ i'	E' ta̠ i'	NOCHANGE
Kë̀ be' é̠u̠k e's!	Kë̀ be' é̠u̠k e's!	NOCHANGE
Ie' ttö̀	Ie' ttö̀	NOCHANGE
Be' e̠' yawö̀	Be' e̠' yawö̀	NOCHANGE
E' dör i kiàna̠ bàka má̠ péitök bulu'pa i̠a̠ e' ku̠é̠ki̠	E' dör i kiàna̠ bàka má̠ péitök bulu'pa i̠a̠ e' ku̠é̠ki̠	NOCHANGE
E' jkué tkë'te̠r i̠a̠ dià e̠'rök	E' jkué tkë'te̠r i̠a̠ dià e̠'rök	NOCHANGE
Alàralar	Alàralar	NOCHANGE
Ie' tö i kínè̠ke	Ie' tö i kínè̠ke	NOCHANGE
Be' tù̠rke	Be' tù̠rke	NOCHANGE
I̠ù̠tök	I̠ù̠tök	NOCHANGE
Skuë̀ kà	Skuë̀ kà	NOCHANGE
Ie' tsö̀ke	Ie' tsö̀ke	NOCHANGE
Wë́stë	Wë́stë	NOCHANGE
A̠ ie'pa i yík ñè̠ke e'	A̠ ie'pa i yík ñè̠ke e'	NOCHANGE
Ie' è̠r	Ie' è̠r	NOCHANGE
Ie' tö i kàchèke	Ie' tö i kàchèke	NOCHANGE
Dù ñe̠'	Dù ñe̠'	NOCHANGE
E' wa e' wë́m yèwadà irir wake'	E' wa e' wë́m yèwadà irir wake'	NOCHANGE
Ye' tö i wámbalèke	Ye' tö i wámbalèke	NOCHANGE
E'ta̠ e̠' ie'pa ú̠rke̠ ka̠nè̠balök	E'ta̠ e̠' ie'pa ú̠rke̠ ka̠nè̠balök	NOCHANGE
Sè̠nu̠k	Sè̠nu̠k	NOCHANGE
Íyi kò̠s tso'i̠a̠ ni̠mà̠	Íyi kò̠s tso'i̠a̠ ni̠mà̠	NOCHANGE
Ese' ichè irir	Ese' ichè irir	NOCHANGE
Ká̠ kò̠s	Ká̠ kò̠s	NOCHANGE
Talók na̠ú̠yöm	Talók na̠ú̠yöm	NOCHANGE
E' ta̠ i̠â̠chikili ta̠ íse kë̀ ta̠ ta̠wé̠	E' ta̠ i̠â̠chikili ta̠ íse kë̀ ta̠ ta̠wé̠	NOCHANGE
E' ta̠ be' ú̠rke̠ i kuá tkö́k ta̠ be' mí̠a̠ e'köla	E' ta̠ be' ú̠rke̠ i kuá tkö́k ta̠ be' mí̠a̠ e'köla	NOCHANGE
Wìm i dör í̠ma̠ kachúk	Wìm i dör í̠ma̠ kachúk	NOCHANGE
E's e's ë́ yö bö̀t ma̠ñà̠t ë́ yö i chè	E's e's ë́ yö bö̀t ma̠ñà̠t ë́ yö i chè	NOCHANGE
Tsí se' tsiríwè̠ke̠ wa	Tsí se' tsiríwè̠ke̠ wa	NOCHANGE
Be' tö i kàchèke	Be' tö i kàchèke	NOCHANGE
Ie' tö i kímè̠ke	Ie' tö i kímè̠ke	NOCHANGE
Ie' akuö̀ke	Ie' akuö̀ke	NOCHANGE
Ie' tsö̀ bua'ë	Ie' tsö̀ bua'ë	NOCHANGE
Ye' é̠r	Ye' é̠r	NOCHANGE
Es' i' ke	Es' i' ke	NOCHANGE
Kë̀ ye' wa̠ i sù̠ne̠	Kë̀ ye' wa̠ i sù̠ne̠	NOCHANGE
Ma̠ i kuátkök	Ma̠ i kuátkök	NOCHANGE
Ie' é̠rke	Ie' é̠rke	NOCHANGE
I' se' e̠' tkó i'	I' se' e̠' tkó i'	NOCHANGE
Ye' tö i kiè	Ye' tö i kiè	NOCHANGE
Kapö̀kwa̠	Kapö̀kwa̠	NOCHANGE
Se' wake' dawö̀wa̠dà	Se' wake' dawö̀wa̠dà	NOCHANGE
Kàl wö iene̠	Kàl wö iene̠	NOCHANGE
Ye' ë́l a̠ sabák yör	Ye' ë́l a̠ sabák yör	NOCHANGE
Ie' kapö̀wa̠	Ie' kapö̀wa̠	NOCHANGE
Ñe̠' e's bíl e̠' se' yàmi̠pa tso'	Ñe̠' e's bíl e̠' se' yàmi̠pa tso'	NOCHANGE
Ie' e̠' yawö̀ke	Ie' e̠' yawö̀ke	NOCHANGE
Ye' yàmi̠pa ù a̠	Ye' yàmi̠pa ù a̠	NOCHANGE
Ye' tö i katè	Ye' tö i katè	NOCHANGE
Ye'rö trini	Ye'rö trini	NOCHANGE
Be' tö i wèke	Be' tö i wèke	NOCHANGE
Pedro dör biyö̀chö́kna̠me̠ i wámbalerke̠ kàtsi e̠	Pedro dör biyö̀chö́kna̠me̠ i wámbalerke̠ kàtsi e̠	NOCHANGE
Kapá tkë́l	Kapá tkë́l	NOCHANGE
Ye' e̠n bikö e' wö̀ikèke̠ balë'këkëpa	Ye' e̠n bikö e' wö̀ikèke̠ balë'këkëpa	NOCHANGE
Be' ka̠nè̠balö̀	Be' ka̠nè̠balö̀	NOCHANGE
Be' tö i chèke	Be' tö i chèke	NOCHANGE
Mó̠u̠k	Mó̠u̠k	NOCHANGE
Be' tö i alèke	Be' tö i alèke	NOCHANGE
E' dör ie' dawè	E' dör ie' dawè	NOCHANGE
Pero ák mu̠lé̠ ñe̠' sö i sa̠wè̠ ta̠ ì	Pero ák mu̠lé̠ ñe̠' sö i sa̠wè̠ ta̠ ì	NOCHANGE
Ye' tö i kàchèke	Ye' tö i kàchèke	NOCHANGE
Ie' i yulèke	Ie' i yulèke	NOCHANGE
Wë́m èköl	Wë́m èköl	NOCHANGE
Ie' tö i yulèke	Ie' tö i yulèke	NOCHANGE
Ye' kó̠pàkö̀	Ye' kó̠pàkö̀	NOCHANGE
Ye'r iché	Ye'r iché	NOCHANGE
Ajá! e's sa' tsiru' kukö̀ke̠ i wèke̠	Ajá! e's sa' tsiru' kukö̀ke̠ i wèke̠	NOCHANGE
E' shkö̀ke̠ mì̠ka̠ i wa̠ se' mì̠tke̠ ta̠ e' shkö̀ke̠ ë̀me̠	E' shkö̀ke̠ mì̠ka̠ i wa̠ se' mì̠tke̠ ta̠ e' shkö̀ke̠ ë̀me̠	NOCHANGE
Ká̠mì̠	Ká̠mì̠	NOCHANGE
Ká̠ kàchok	Ká̠ kàchok	NOCHANGE
Ye' e̠' chö̀kea̠t	Ye' e̠' chö̀kea̠t	NOCHANGE
Ye' tö i kímè̠ke	Ye' tö i kímè̠ke	NOCHANGE
Kàl tsée	Kàl tsée	NOCHANGE
Sa' bikë̀na̠ i bitséitsök	Sa' bikë̀na̠ i bitséitsök	NOCHANGE
Ba ká̠	Ba ká̠	NOCHANGE
Be' tsë̀rke	Be' tsë̀rke	NOCHANGE
Ma̠ e's	Ma̠ e's	NOCHANGE
Ie' tö i yawèke	Ie' tö i yawèke	NOCHANGE
Kë̀ ye' ki̠ a̠mo̠' kiàna̠	Kë̀ ye' ki̠ a̠mo̠' kiàna̠	NOCHANGE
Ye' è̠r	Ye' è̠r	NOCHANGE
E' chö̀tke se' é̠n a̠	E' chö̀tke se' é̠n a̠	NOCHANGE
I yö́ söla yö́ söla	I yö́ söla yö́ söla	NOCHANGE
Kë̀ e' ki̠ i ku̠ bua'ie	Kë̀ e' ki̠ i ku̠ bua'ie	NOCHANGE
Dabòm éyök kí̠ e'köl	Dabòm éyök kí̠ e'köl	NOCHANGE
Ie' tö i kièke	Ie' tö i kièke	NOCHANGE
Ba kú̠	Ba kú̠	NOCHANGE
E' kë̀ dör se' i̠a̠ bua'ë wa̠	E' kë̀ dör se' i̠a̠ bua'ë wa̠	NOCHANGE
Ì se' tsiríwè̠ke̠ wa	Ì se' tsiríwè̠ke̠ wa	NOCHANGE
Be' kë̀ wa̠ ì pë' ì bua' bua' sù̠ne̠	Be' kë̀ wa̠ ì pë' ì bua' bua' sù̠ne̠	NOCHANGE
Ie' tö i kiè	Ie' tö i kiè	NOCHANGE
Ie' tö i mo̠wè̠	Ie' tö i mo̠wè̠	NOCHANGE
Tsiru'wö	Tsiru'wö	NOCHANGE
Bachâbacha i wà ya'wa̠	Bachâbacha i wà ya'wa̠	NOCHANGE
E' ta̠ íyiwak kë̀ se' tsiríwè̠	E' ta̠ íyiwak kë̀ se' tsiríwè̠	NOCHANGE
Ie' e̠' yawö̀ke	Ie' e̠' yawö̀ke	NOCHANGE
Ma̠ e'ta̠ ñe̠'e̠ ö̀kö téka̠ne̠ i̠a̠	Ma̠ e'ta̠ ñe̠'e̠ ö̀kö téka̠ne̠ i̠a̠	NOCHANGE
E' ku̠é̠ki̠ ie'pa wa̠ ù íse tso'	E' ku̠é̠ki̠ ie'pa wa̠ ù íse tso'	NOCHANGE
Ttö̀ chèke kö̀kokö̀ko	Ttö̀ chèke kö̀kokö̀ko	NOCHANGE
Sibö̀ yë́	Sibö̀ yë́	NOCHANGE
Entonces be' kë̀ dë'ka̠ ó yë́ria ie	Entonces be' kë̀ dë'ka̠ ó yë́ria ie	NOCHANGE
Urrì ma̠ñà̠töm	Urrì ma̠ñà̠töm	NOCHANGE
E̠' ie' dë'rö ye' tsú̠k e̠'rö	E̠' ie' dë'rö ye' tsú̠k e̠'rö	NOCHANGE
Ye' tö i shtèke	Ye' tö i shtèke	NOCHANGE
Chakì àki ye' mì̠ne̠ ù apákök	Chakì àki ye' mì̠ne̠ ù apákök	NOCHANGE
E̠' yawök	E̠' yawök	NOCHANGE
Ye' tö i yulè	Ye' tö i yulè	NOCHANGE
Të́shtesh	Të́shtesh	NOCHANGE
I kí̠ kióne̠ ië́tökicha	I kí̠ kióne̠ ië́tökicha	NOCHANGE
Ie' kapö̀wa̠	Ie' kapö̀wa̠	NOCHANGE
Ie' tö i ka̠nè̠wè̠ke	Ie' tö i ka̠nè̠wè̠ke	NOCHANGE
Be' kó̠pàkö̀ke	Be' kó̠pàkö̀ke	NOCHANGE
Be' wa̠ i sú̠rule	Be' wa̠ i sú̠rule	NOCHANGE
Ie' e̠' chö̀a̠t	Ie' e̠' chö̀a̠t	NOCHANGE
Ye' yë́	Ye' yë́	NOCHANGE
Tsáwak èt	Tsáwak èt	NOCHANGE
Kuö́ska	Kuö́ska	NOCHANGE
Ba yúshka!	Ba yúshka!	NOCHANGE
Ie' tö i yè	Ie' tö i yè	NOCHANGE
Ie'r ó be' a̠ ta̠	Ie'r ó be' a̠ ta̠	NOCHANGE
Kö̀chiwe pàikarö!	Kö̀chiwe pàikarö!	NOCHANGE
Sku' sé̠ dör awá icha	Sku' sé̠ dör awá icha	NOCHANGE
Ke'tke't!	Ke'tke't!	NOCHANGE
Ie' i̠nù̠ke	Ie' i̠nù̠ke	NOCHANGE
Ie'r i ù yawémi̠	Ie'r i ù yawémi̠	NOCHANGE
Na̠mù̠ e' jkuö̀	Na̠mù̠ e' jkuö̀	NOCHANGE
Í̠ma̠ be' kiè	Í̠ma̠ be' kiè	NOCHANGE
Se' má̠la ìsela í̠ma̠la se'	Se' má̠la ìsela í̠ma̠la se'	NOCHANGE
Dawás dö̀ke̠tke e'k ye' ki̠	Dawás dö̀ke̠tke e'k ye' ki̠	NOCHANGE
Ba è̠nú̠	Ba è̠nú̠	NOCHANGE
E' ë̀me̠ bùlikalök	E' ë̀me̠ bùlikalök	NOCHANGE
Ie' tö i tè	Ie' tö i tè	NOCHANGE
Buà bö̀töm	Buà bö̀töm	NOCHANGE
Ie' tö i kímè̠ke	Ie' tö i kímè̠ke	NOCHANGE
Be' tö i yulèke	Be' tö i yulèke	NOCHANGE
Ma̠ i wìwö apàchikíu̠k	Ma̠ i wìwö apàchikíu̠k	NOCHANGE
Ie' tö i batörè	Ie' tö i batörè	NOCHANGE
Ie' tö i shtèke	Ie' tö i shtèke	NOCHANGE
Ye' kutà dör i ajkönè̠mi̠	Ye' kutà dör i ajkönè̠mi̠	NOCHANGE
Shka̠lá̠ wa ie'pa rö	Shka̠lá̠ wa ie'pa rö	NOCHANGE
Kë̀ rö wáñe̠	Kë̀ rö wáñe̠	NOCHANGE
Pulì mà̠t	Pulì mà̠t	NOCHANGE
Ie' tö i ka̠nè̠wè̠ke	Ie' tö i ka̠nè̠wè̠ke	NOCHANGE
Be' e̠' chö̀kea̠t	Be' e̠' chö̀kea̠t	NOCHANGE
Tté ichàkok	Tté ichàkok	NOCHANGE
Alákölpa e'	Alákölpa e'	NOCHANGE
Kùbulu ñe̠' wö̀ppèke ñì̠e̠s ñì̠kë́ë ñì̠e̠s	Kùbulu ñe̠' wö̀ppèke ñì̠e̠s ñì̠kë́ë ñì̠e̠s	NOCHANGE
Be' tö i kuè	Be' tö i kuè	NOCHANGE
Ie'pa e' wö̀tse e' yéstsa̠ e' rö	Ie'pa e' wö̀tse e' yéstsa̠ e' rö	NOCHANGE
Kùkur ta̠ ie' i a̠ ché	Kùkur ta̠ ie' i a̠ ché	NOCHANGE
Ie' ajkö̀a' na̠ñé̠ë	Ie' ajkö̀a' na̠ñé̠ë	NOCHANGE
Ye' kë̀ bák ujtö́k	Ye' kë̀ bák ujtö́k	NOCHANGE
Ñèe̠ ie' dèmi̠ne̠ aìe̠	Ñèe̠ ie' dèmi̠ne̠ aìe̠	NOCHANGE
E' ta̠ chkö̀	E' ta̠ chkö̀	NOCHANGE
Balë' wë́pa mí̠tke e' itö̀ki̠	Balë' wë́pa mí̠tke e' itö̀ki̠	NOCHANGE
Ie' tö i akuö̀wè̠	Ie' tö i akuö̀wè̠	NOCHANGE
Ie' tö i akuö̀wè̠ke	Ie' tö i akuö̀wè̠ke	NOCHANGE
Ie' tö i shtè	Ie' tö i shtè	NOCHANGE
Tsáwak diö́	Tsáwak diö́	NOCHANGE
Ie' tö i tkèke	Ie' tö i tkèke	NOCHANGE
Ye' kínú̠ tsìr	Ye' kínú̠ tsìr	NOCHANGE
Ie' ttö̀ke	Ie' ttö̀ke	NOCHANGE
Ie' tö i tsè	Ie' tö i tsè	NOCHANGE
Ie' tö i ichàkè	Ie' tö i ichàkè	NOCHANGE
Dalö̀tse̠ i̠a̠ sa'	Dalö̀tse̠ i̠a̠ sa'	NOCHANGE
Tö́ bùlikalö̀	Tö́ bùlikalö̀	NOCHANGE
Ì̠e̠ kë̀ i̠nè̠ku̠ naipe wa	Ì̠e̠ kë̀ i̠nè̠ku̠ naipe wa	NOCHANGE
Kàlwö ulìta̠ne̠ alírke̠ mì̠k i tso' akë́ e' ta̠	Kàlwö ulìta̠ne̠ alírke̠ mì̠k i tso' akë́ e' ta̠	NOCHANGE
A' dakö́ mí̠tke a' tabè klö́u̠	A' dakö́ mí̠tke a' tabè klö́u̠	NOCHANGE
Se' e's tër irirla se' e's tër	Se' e's tër irirla se' e's tër	NOCHANGE
Cha̠mù̠ kuátkök	Cha̠mù̠ kuátkök	NOCHANGE
Ni̠mà̠ ètöm	Ni̠mà̠ ètöm	NOCHANGE
Be' tö i ppè	Be' tö i ppè	NOCHANGE
Be' tù̠rke	Be' tù̠rke	NOCHANGE
E' ukö̀ki̠ balë'kë́këpa e' ka̠nè̠o̠' ie'par e' ka̠nè̠o̠ne̠	E' ukö̀ki̠ balë'kë́këpa e' ka̠nè̠o̠' ie'par e' ka̠nè̠o̠ne̠	NOCHANGE
Tabèchka ki̠ e̠' kéka̠ e'ta̠ bétk ie'pa mí̠a̠	Tabèchka ki̠ e̠' kéka̠ e'ta̠ bétk ie'pa mí̠a̠	NOCHANGE
Ká̠ pàköl e'ta̠ ie' i ujté dé ká̠se̠ wë'	Ká̠ pàköl e'ta̠ ie' i ujté dé ká̠se̠ wë'	NOCHANGE
Ye'r ie' diö́ a̠ i ché ùù ye' i ché i̠â̠i̠â̠ e' ta̠	Ye'r ie' diö́ a̠ i ché ùù ye' i ché i̠â̠i̠â̠ e' ta̠	NOCHANGE
Íyök i' apàikalèke̠stsa̠ ké̠weie	Íyök i' apàikalèke̠stsa̠ ké̠weie	NOCHANGE
Ie' shkö̀keka̠	Ie' shkö̀keka̠	NOCHANGE
Bö̀tökicha	Bö̀tökicha	NOCHANGE
E' rö pú̠ kapö̀ wé̠wa̠	E' rö pú̠ kapö̀ wé̠wa̠	NOCHANGE
E' ta̠ e̠' se' kapö̀râ ö se' dótkene̠	E' ta̠ e̠' se' kapö̀râ ö se' dótkene̠	NOCHANGE
Ye' shkö̀ke	Ye' shkö̀ke	NOCHANGE
Be' tö i i̠ù̠tèke	Be' tö i i̠ù̠tèke	NOCHANGE
Be' tö i tkèke	Be' tö i tkèke	NOCHANGE
E' ka̠nè̠u̠kala	E' ka̠nè̠u̠kala	NOCHANGE
Ma̠ e' bikéitsèke̠ sö ká̠ñì̠na̠ ta̠ ì wö́k se' mí̠ke̠ dià e̠' dö́k a̠	Ma̠ e' bikéitsèke̠ sö ká̠ñì̠na̠ ta̠ ì wö́k se' mí̠ke̠ dià e̠' dö́k a̠	NOCHANGE
Ie' é̠rke	Ie' é̠rke	NOCHANGE
A̠mì̠ tso' alà ajkö́nu̠k	A̠mì̠ tso' alà ajkö́nu̠k	NOCHANGE
I klö̀	I klö̀	NOCHANGE
Ì ka̠né̠wè̠mi̠ se' dör e' tsikìna̠ e' pà mi̠k	Ì ka̠né̠wè̠mi̠ se' dör e' tsikìna̠ e' pà mi̠k	NOCHANGE
Ie' tö i tsirìwè̠ke	Ie' tö i tsirìwè̠ke	NOCHANGE
E' ta̠ kë̀ yár bua'	E' ta̠ kë̀ yár bua'	NOCHANGE
Wè̠s si̠ni̠' ku̠è̠ sö	Wè̠s si̠ni̠' ku̠è̠ sö	NOCHANGE
Sibö̀ i sa̠wé̠ ta̠ ká̠köljtö tsakèke̠watke irir	Sibö̀ i sa̠wé̠ ta̠ ká̠köljtö tsakèke̠watke irir	NOCHANGE
Ie' tö i shkè̠wè̠	Ie' tö i shkè̠wè̠	NOCHANGE
Ye' yàmi̠ dör sa' a̠ña̠wé̠	Ye' yàmi̠ dör sa' a̠ña̠wé̠	NOCHANGE
Ie' tö i ppè	Ie' tö i ppè	NOCHANGE
Dabòm dabòbyök	Dabòm dabòbyök	NOCHANGE
E' ta̠	E' ta̠	NOCHANGE
Ie' inù̠ke	Ie' inù̠ke	NOCHANGE
I tso' i tso' u̠jú̠!	I tso' i tso' u̠jú̠!	NOCHANGE
Ie' tö i wámbalè	Ie' tö i wámbalè	NOCHANGE
Ie'pa kapötulur	Ie'pa kapötulur	NOCHANGE
Ie' tö i mo̠wè̠ke	Ie' tö i mo̠wè̠ke	NOCHANGE
Kë̀ ie' a̠ ni̠mà̠ alir	Kë̀ ie' a̠ ni̠mà̠ alir	NOCHANGE
Sibö̀ dör bukë' kiéne̠ bö̀t i ajkö́nu̠k	Sibö̀ dör bukë' kiéne̠ bö̀t i ajkö́nu̠k	NOCHANGE
Ie' tö i wèke	Ie' tö i wèke	NOCHANGE
Wé̠ wa̠ tsiru' tso' e' mà̠so ie ka̠nè̠balök ie	Wé̠ wa̠ tsiru' tso' e' mà̠so ie ka̠nè̠balök ie	NOCHANGE
Se' alákölpa tso' bua'ie	Se' alákölpa tso' bua'ie	NOCHANGE
U̠jù̠ e' balèke̠wa̠ íyök a̠	U̠jù̠ e' balèke̠wa̠ íyök a̠	NOCHANGE
Ye' tö i ttè	Ye' tö i ttè	NOCHANGE
Ì dalé	Ì dalé	NOCHANGE
Kë̀ ña̠ a̠ ki̠ yë̀nu̠k i̠a̠ bö̀t ma̠ñà̠t	Kë̀ ña̠ a̠ ki̠ yë̀nu̠k i̠a̠ bö̀t ma̠ñà̠t	NOCHANGE
Pulë̀ èk	Pulë̀ èk	NOCHANGE
Ta̠ í̠e̠ ie'pa bité̠ a̠ e̠' wö'ikök	Ta̠ í̠e̠ ie'pa bité̠ a̠ e̠' wö'ikök	NOCHANGE
Íyiwak kalö̀ka	Íyiwak kalö̀ka	NOCHANGE
Be' tö i kàchèke	Be' tö i kàchèke	NOCHANGE
Dabòm pàryök	Dabòm pàryök	NOCHANGE
E̠' chö̀ka̠t	E̠' chö̀ka̠t	NOCHANGE
Be' shkö̀keka̠	Be' shkö̀keka̠	NOCHANGE
Bë́rbë́r pa̠'a̠li̠	Bë́rbë́r pa̠'a̠li̠	NOCHANGE
Bulé tulù sú̠rmi̠	Bulé tulù sú̠rmi̠	NOCHANGE
I batà	I batà	NOCHANGE
Ie' tö i síwè̠	Ie' tö i síwè̠	NOCHANGE
Mil éyök	Mil éyök	NOCHANGE
Ie' tö i kínè̠ke	Ie' tö i kínè̠ke	NOCHANGE
Ie' tö i tè	Ie' tö i tè	NOCHANGE
Yárule	Yárule	NOCHANGE
Se' yík a̠ pë́ tkë̀nâ̠na̠ e' dalë̀na̠wa̠ se' a̠	Se' yík a̠ pë́ tkë̀nâ̠na̠ e' dalë̀na̠wa̠ se' a̠	NOCHANGE
Pú̠ èt	Pú̠ èt	NOCHANGE
Shù̠balé mì̠kale ta̠ ma̠ i páköl	Shù̠balé mì̠kale ta̠ ma̠ i páköl	NOCHANGE
E'rö i tso'	E'rö i tso'	NOCHANGE
Ye' tù̠rke	Ye' tù̠rke	NOCHANGE
Mì̠ka̠ sibö̀ tskìne̠	Mì̠ka̠ sibö̀ tskìne̠	NOCHANGE
Ie' tö i sa̠wè̠	Ie' tö i sa̠wè̠	NOCHANGE
Se' tö íyök ña̠ ka̠nè̠balök wè̠ke̠	Se' tö íyök ña̠ ka̠nè̠balök wè̠ke̠	NOCHANGE
Ye' tö i i̠ù̠tèke	Ye' tö i i̠ù̠tèke	NOCHANGE
Se' shù̠ dalë́rke̠ wa̠	Se' shù̠ dalë́rke̠ wa̠	NOCHANGE
Dabòm tkë́yök	Dabòm tkë́yök	NOCHANGE
Ttö̀ pó̠li̠ skà	Ttö̀ pó̠li̠ skà	NOCHANGE
E' yì ta̠ i shkö̀ke̠ ë̀me̠	E' yì ta̠ i shkö̀ke̠ ë̀me̠	NOCHANGE
Ie' tö i katè	Ie' tö i katè	NOCHANGE
E' ukö̀ki̠ a̠wí̠ yawèke̠ shkít a̠wí̠ yawèke̠ sö	E' ukö̀ki̠ a̠wí̠ yawèke̠ shkít a̠wí̠ yawèke̠ sö	NOCHANGE
A̠mù̠baliwak	A̠mù̠baliwak	NOCHANGE
Be' tö i wèke	Be' tö i wèke	NOCHANGE
Ie'pa ká̠	Ie'pa ká̠	NOCHANGE
Dabòm ma̠ñà̠yök	Dabòm ma̠ñà̠yök	NOCHANGE
Aláköl èköl	Aláköl èköl	NOCHANGE
Be' tö i mo̠wè̠ke	Be' tö i mo̠wè̠ke	NOCHANGE
Ie' tö i chèke	Ie' tö i chèke	NOCHANGE
E' tso' e̠'rö	E' tso' e̠'rö	NOCHANGE
Ttö̀ íyi shtáwo̠k dabòm èyök tö̀ki̠	Ttö̀ íyi shtáwo̠k dabòm èyök tö̀ki̠	NOCHANGE
Kë̀ i ta̠' ië̀ka̠ wake'	Kë̀ i ta̠' ië̀ka̠ wake'	NOCHANGE
Ie' e̠' chö̀kea̠t	Ie' e̠' chö̀kea̠t	NOCHANGE
Ye' tö i kèke	Ye' tö i kèke	NOCHANGE
Ye' akuö̀	Ye' akuö̀	NOCHANGE
É̠ma̠ e' stsè stsèke̠ ñe̠'	É̠ma̠ e' stsè stsèke̠ ñe̠'	NOCHANGE
Si̠ni̠' té̠rke̠ ká̠ e't mì̠ka̠ kàlwö tso' kièke̠ àl	Si̠ni̠' té̠rke̠ ká̠ e't mì̠ka̠ kàlwö tso' kièke̠ àl	NOCHANGE
Ye' ttö̀	Ye' ttö̀	NOCHANGE
Dalö̀ ie wa̠ ie balë'kë́këpa dör	Dalö̀ ie wa̠ ie balë'kë́këpa dör	NOCHANGE
Ché irir icha ká̠ i̠â̠i̠â̠ sibö̀ bák mé̠r ie' ù a̠ ta̠	Ché irir icha ká̠ i̠â̠i̠â̠ sibö̀ bák mé̠r ie' ù a̠ ta̠	NOCHANGE
Be' ala'r ta̠	Be' ala'r ta̠	NOCHANGE
Ie' è̠r	Ie' è̠r	NOCHANGE
Ta̠wè̠ke̠ wake'	Ta̠wè̠ke̠ wake'	NOCHANGE
E' ukö̀ki̠ ta̠ ie'pa rö tö	E' ukö̀ki̠ ta̠ ie'pa rö tö	NOCHANGE
Ie' i sa̠wè̠	Ie' i sa̠wè̠	NOCHANGE
E' ë̀ e̠' ta̠ ye'r ikiè ká̠ dör	E' ë̀ e̠' ta̠ ye'r ikiè ká̠ dör	NOCHANGE
A' alà a̠	A' alà a̠	NOCHANGE
Mì̠ka̠ i̠â̠i̠â̠ ta̠ kë'köldi jkö̀ mi̠k	Mì̠ka̠ i̠â̠i̠â̠ ta̠ kë'köldi jkö̀ mi̠k	NOCHANGE
Se'r i kièmi̠	Se'r i kièmi̠	NOCHANGE
Wë'ste be' a̠	Wë'ste be' a̠	NOCHANGE
Ie' e̠' yawö̀	Ie' e̠' yawö̀	NOCHANGE
Ye'yë́	Ye'yë́	NOCHANGE
Ta̠ bua' i wö̀na̠	Ta̠ bua' i wö̀na̠	NOCHANGE
Be' tö i ppèke	Be' tö i ppèke	NOCHANGE
Ye' tö i yawèke	Ye' tö i yawèke	NOCHANGE
Ye' tö i tkè	Ye' tö i tkè	NOCHANGE
Ákwö shté ye'r ña̠là̠ ki̠	Ákwö shté ye'r ña̠là̠ ki̠	NOCHANGE
Ye' tö i sa̠wè̠	Ye' tö i sa̠wè̠	NOCHANGE
Kë̀ e' dë wè̠s	Kë̀ e' dë wè̠s	NOCHANGE
I ichàkö́	I ichàkö́	NOCHANGE
Dùsi̠a̠ kö̀	Dùsi̠a̠ kö̀	NOCHANGE
Be' tö i wámbalèke	Be' tö i wámbalèke	NOCHANGE
Ba ka̠nè̠balö́	Ba ka̠nè̠balö́	NOCHANGE
Awápa ma̠ñá̠l	Awápa ma̠ñá̠l	NOCHANGE
Ma̠ i wö̀ ma̠ síwö e' ta̠ se' é̠n a̠ i yawö́k i̠ña̠'ie balo' dawàie	Ma̠ i wö̀ ma̠ síwö e' ta̠ se' é̠n a̠ i yawö́k i̠ña̠'ie balo' dawàie	NOCHANGE
I̠â̠i̠â̠ e' ta̠ sa' i yawé	I̠â̠i̠â̠ e' ta̠ sa' i yawé	NOCHANGE
Kë̀ i rë éjkë	Kë̀ i rë éjkë	NOCHANGE
E's se' ká̠ apàkö bë́rërëpa	E's se' ká̠ apàkö bë́rërëpa	NOCHANGE
Ie' ta̠	Ie' ta̠	NOCHANGE
Be' tö i batörèke	Be' tö i batörèke	NOCHANGE
Awì̠ëka̠ tkë́töm tsa'kicha i' wa	Awì̠ëka̠ tkë́töm tsa'kicha i' wa	NOCHANGE
Ye' ttö̀ke	Ye' ttö̀ke	NOCHANGE
Be' tö i chè	Be' tö i chè	NOCHANGE
Ie' kó̠pàkö̀ke	Ie' kó̠pàkö̀ke	NOCHANGE
Ákwö shté ye' tö ña̠là̠ ki̠	Ákwö shté ye' tö ña̠là̠ ki̠	NOCHANGE
Ye' i klö'wè̠de	Ye' i klö'wè̠de	NOCHANGE
É̠nu̠k	É̠nu̠k	NOCHANGE
Ie' tö i ñè̠ke	Ie' tö i ñè̠ke	NOCHANGE
Ùshikalök	Ùshikalök	NOCHANGE
A' yàmi̠ akáluk dör shamà̠ë	A' yàmi̠ akáluk dör shamà̠ë	NOCHANGE
Bríbriwak siwo̠'	Bríbriwak siwo̠'	NOCHANGE
Ye' tö i síwè̠ke	Ye' tö i síwè̠ke	NOCHANGE
I i̠ù̠tö́	I i̠ù̠tö́	NOCHANGE
Ie' tö i katèke	Ie' tö i katèke	NOCHANGE
Yö i èwami̠	Yö i èwami̠	NOCHANGE
Bikli' arki̠ cha e' apë' chkè ar	Bikli' arki̠ cha e' apë' chkè ar	NOCHANGE
Alákölpa e'	Alákölpa e'	NOCHANGE
Ie' déne̠ i dawö' a̠ i chö́k tö à! dawö'	Ie' déne̠ i dawö' a̠ i chö́k tö à! dawö'	NOCHANGE
Pà mâ̠tk wö́kir mâ̠tk	Pà mâ̠tk wö́kir mâ̠tk	NOCHANGE
Ie'pa icha i ku̠é̠ki̠ sa' icha i ku̠é̠ki̠	Ie'pa icha i ku̠é̠ki̠ sa' icha i ku̠é̠ki̠	NOCHANGE
Pulì mà̠t	Pulì mà̠t	NOCHANGE
Ie' akuö̀ke	Ie' akuö̀ke	NOCHANGE
Yö wàtu̠e̠ e'ta̠	Yö wàtu̠e̠ e'ta̠	NOCHANGE
Ie' kë̀ ku̠' na̠mù̠ yë́balök	Ie' kë̀ ku̠' na̠mù̠ yë́balök	NOCHANGE
Ta̠ wé̠ wé̠ wa̠ i ujche̠n	Ta̠ wé̠ wé̠ wa̠ i ujche̠n	NOCHANGE
Ie' inù̠	Ie' inù̠	NOCHANGE
Pues e' ta̠ tsikìna̠ ése wè sö e' bakèke̠ sö	Pues e' ta̠ tsikìna̠ ése wè sö e' bakèke̠ sö	NOCHANGE
Ye' mí̠ne̠ chakì	Ye' mí̠ne̠ chakì	NOCHANGE
U̠jú̠!	U̠jú̠!	NOCHANGE
Be' ulà dé iska é̠ma̠ tö̀	Be' ulà dé iska é̠ma̠ tö̀	NOCHANGE
Ké̠we ta̠ sibö̀ wa̠ sa' rë́ka̠ ditsö̀wö ie	Ké̠we ta̠ sibö̀ wa̠ sa' rë́ka̠ ditsö̀wö ie	NOCHANGE
Wë́m ki̠ dawás bö̀k ë̀ dë́ka̠	Wë́m ki̠ dawás bö̀k ë̀ dë́ka̠	NOCHANGE
I̠ì̠ne̠	I̠ì̠ne̠	NOCHANGE
Se' e̠' dalë̀na̠i̠a̠ e' ta̠ kë̀ se' e̠' dalë̀ne̠ e' ta̠	Se' e̠' dalë̀na̠i̠a̠ e' ta̠ kë̀ se' e̠' dalë̀ne̠ e' ta̠	NOCHANGE
Íyök a̠ i balèke̠wa̠	Íyök a̠ i balèke̠wa̠	NOCHANGE
Be'r ye' tsì̠ biö́!	Be'r ye' tsì̠ biö́!	NOCHANGE
Bueno í̠e̠ ye'r a' a̠ i pàkeke̠	Bueno í̠e̠ ye'r a' a̠ i pàkeke̠	NOCHANGE
Cien éyök	Cien éyök	NOCHANGE
Sa' i dalö̀tse̠ ñe̠' e's	Sa' i dalö̀tse̠ ñe̠' e's	NOCHANGE
Ma̠ tsu'ku e'r wé̠	Ma̠ tsu'ku e'r wé̠	NOCHANGE
Ie' tö i à̠ritsèke	Ie' tö i à̠ritsèke	NOCHANGE
Be' tö i ñè̠	Be' tö i ñè̠	NOCHANGE
Ye' tö i wèke	Ye' tö i wèke	NOCHANGE
E̠'rö ie'r ë̀ ù tö̀ a̠mé̠a̠t	E̠'rö ie'r ë̀ ù tö̀ a̠mé̠a̠t	NOCHANGE
Mò̠sopa ë̀ mí̠yartke campo ikalö́k e' ki̠ ie'pa e̠' da'u̠k	Mò̠sopa ë̀ mí̠yartke campo ikalö́k e' ki̠ ie'pa e̠' da'u̠k	NOCHANGE
I yö́ söla i yö́ söla	I yö́ söla i yö́ söla	NOCHANGE
Ba inú̠	Ba inú̠	NOCHANGE
Ie' kó̠pàkö̀	Ie' kó̠pàkö̀	NOCHANGE
Ie' tsë̀rke	Ie' tsë̀rke	NOCHANGE
Kàl wö́löm e' wa ie'pa pú̠ ppé mi̠lí̠s	Kàl wö́löm e' wa ie'pa pú̠ ppé mi̠lí̠s	NOCHANGE
Ye' ùshikalö̀	Ye' ùshikalö̀	NOCHANGE
Ie' tö i sa̠wè̠ke	Ie' tö i sa̠wè̠ke	NOCHANGE
E'tkla ë̀ e' mí̠k be' tso'se̠n	E'tkla ë̀ e' mí̠k be' tso'se̠n	NOCHANGE
Durla re e' bikéitseke̠ dur ki̠la	Durla re e' bikéitseke̠ dur ki̠la	NOCHANGE
Ù yö́rketke	Ù yö́rketke	NOCHANGE
Ie' tö i chè	Ie' tö i chè	NOCHANGE
Alàköl bua'ë	Alàköl bua'ë	NOCHANGE
Ye' tö i síwè̠	Ye' tö i síwè̠	NOCHANGE
Sa' a̠ sibö̀ tö ák mè̠a̠t yulár wö́köl ie	Sa' a̠ sibö̀ tö ák mè̠a̠t yulár wö́köl ie	NOCHANGE
E' wö̀ishchèke̠ e' ajkuö́lit yéulur	E' wö̀ishchèke̠ e' ajkuö́lit yéulur	NOCHANGE
Bríbripa e̠na̠ i ttö̀ kí̠	Bríbripa e̠na̠ i ttö̀ kí̠	NOCHANGE
San pedro	San pedro	NOCHANGE
E̠' ie'pa se' wö'ikèke̠	E̠' ie'pa se' wö'ikèke̠	NOCHANGE
É! ye' ma̠ i skà ichàkeke̠ tö	É! ye' ma̠ i skà ichàkeke̠ tö	NOCHANGE
Ie' tö i kímè̠ke	Ie' tö i kímè̠ke	NOCHANGE
Ie' tö i ppèke	Ie' tö i ppèke	NOCHANGE
Ye' kó̠pàkö̀ke	Ye' kó̠pàkö̀ke	NOCHANGE
Ye' tö i balë	Ye' tö i balë	NOCHANGE
Ie' ka̠nè̠balö̀ke	Ie' ka̠nè̠balö̀ke	NOCHANGE
Be' é̠rke	Be' é̠rke	NOCHANGE
Kë̀ a' wa̠ i kièmi̠	Kë̀ a' wa̠ i kièmi̠	NOCHANGE
Ká̠ tèröl	Ká̠ tèröl	NOCHANGE
Ye'r i sú̠ule	Ye'r i sú̠ule	NOCHANGE
Ie' tö i pàlèke	Ie' tö i pàlèke	NOCHANGE
Alátsitsi e' ta̠ bák i̠a̠ alátsítsi bua' ë	Alátsitsi e' ta̠ bák i̠a̠ alátsítsi bua' ë	NOCHANGE
Ie' tö i tèke	Ie' tö i tèke	NOCHANGE
Kùkurkùkur	Kùkurkùkur	NOCHANGE
Tsiö̀ ù batà	Tsiö̀ ù batà	NOCHANGE
Sa̠mé̠ ñe̠' ichö́kle mì̠k	Sa̠mé̠ ñe̠' ichö́kle mì̠k	NOCHANGE
Kukula' tö ye' kué ye' ó̠k ki̠	Kukula' tö ye' kué ye' ó̠k ki̠	NOCHANGE
Ie' tö i ppèke	Ie' tö i ppèke	NOCHANGE
Ie' tö i ñè̠	Ie' tö i ñè̠	NOCHANGE
E' ta̠ wé̠ ë̀töm ki̠ bua'ie i tso'	E' ta̠ wé̠ ë̀töm ki̠ bua'ie i tso'	NOCHANGE
É̠ma̠ se' chkö̀ke̠ e' chkö̀ke̠	É̠ma̠ se' chkö̀ke̠ e' chkö̀ke̠	NOCHANGE
Pú̠ ñe̠' ù a̠	Pú̠ ñe̠' ù a̠	NOCHANGE
I skà wébalö	I skà wébalö	NOCHANGE
Kua'kua wé̠lè	Kua'kua wé̠lè	NOCHANGE
Ie' tsö̀ke	Ie' tsö̀ke	NOCHANGE
Be' tö i kínè̠	Be' tö i kínè̠	NOCHANGE
Be' tö i pàlèke	Be' tö i pàlèke	NOCHANGE
E'ta̠ e' tsé̠bite̠ yö wé̠shke̠	E'ta̠ e' tsé̠bite̠ yö wé̠shke̠	NOCHANGE
Be' tö i tèke	Be' tö i tèke	NOCHANGE
Be' tö i kímè̠ke	Be' tö i kímè̠ke	NOCHANGE
Be' ka̠nè̠balö̀	Be' ka̠nè̠balö̀	NOCHANGE
Dakarò we	Dakarò we	NOCHANGE
Ye' chkö̀	Ye' chkö̀	NOCHANGE
Ulìta̠ne̠ ë̀ sa' ka̠nè̠balöke̠ sa' yë́ ta̠ sa' a̠mì̠ ta̠ á̠jà̠!	Ulìta̠ne̠ ë̀ sa' ka̠nè̠balöke̠ sa' yë́ ta̠ sa' a̠mì̠ ta̠ á̠jà̠!	NOCHANGE
Ské̠iki	Ské̠iki	NOCHANGE
Be' tö i à̠ritsèke	Be' tö i à̠ritsèke	NOCHANGE
Be' ka̠nè̠balö̀ke	Be' ka̠nè̠balö̀ke	NOCHANGE
E' e' dör e' bua'ë ti̠è̠ka̠ wö́kir a̠	E' e' dör e' bua'ë ti̠è̠ka̠ wö́kir a̠	NOCHANGE
Be' e̠' chö̀kea̠t	Be' e̠' chö̀kea̠t	NOCHANGE
Ka̠nè̠o̠rule wa	Ka̠nè̠o̠rule wa	NOCHANGE
Kë̀ ká̠wö kú̠nu̠k se' a̠	Kë̀ ká̠wö kú̠nu̠k se' a̠	NOCHANGE
Të́rke̠ tèke̠rak irir si' e't si' e't si' e't	Të́rke̠ tèke̠rak irir si' e't si' e't si' e't	NOCHANGE
E' a̠ ie' dawè tso' e' ku̠é̠ki̠ e' ñè̠ke ie' yö́ki̠	E' a̠ ie' dawè tso' e' ku̠é̠ki̠ e' ñè̠ke ie' yö́ki̠	NOCHANGE
E' tkër di' ajkö̀ ki̠	E' tkër di' ajkö̀ ki̠	NOCHANGE
Ye' tö i sa̠wè̠ke	Ye' tö i sa̠wè̠ke	NOCHANGE
Ye'r iché	Ye'r iché	NOCHANGE
Ye' tö i à̠ritsèke	Ye' tö i à̠ritsèke	NOCHANGE
Ye' ma̠lé̠pa wö̀balao̠' ka̠nè̠balök wö̀balao̠'	Ye' ma̠lé̠pa wö̀balao̠' ka̠nè̠balök wö̀balao̠'	NOCHANGE
Ë́ e' se' wö̀ike e' wö̀ike se' wö̀ikèmi̠ tkë́l	Ë́ e' se' wö̀ike e' wö̀ike se' wö̀ikèmi̠ tkë́l	NOCHANGE
Dabòm bö́yök	Dabòm bö́yök	NOCHANGE
Chìchi dör kö̀chi ma̠lé̠k kué	Chìchi dör kö̀chi ma̠lé̠k kué	NOCHANGE
Be' tö i yawèke	Be' tö i yawèke	NOCHANGE
E̠' kéka̠ diö́ e̠' dö̀ à̠na̠ shtö' a̠	E̠' kéka̠ diö́ e̠' dö̀ à̠na̠ shtö' a̠	NOCHANGE
Tèktökicha	Tèktökicha	NOCHANGE
Dabòm ma̠ñà̠yök kí̠ kúl	Dabòm ma̠ñà̠yök kí̠ kúl	NOCHANGE
Antonio dör akalö́kna̠me̠	Antonio dör akalö́kna̠me̠	NOCHANGE
Ye'r e'köl	Ye'r e'köl	NOCHANGE
Ie' tö i ichàkèke	Ie' tö i ichàkèke	NOCHANGE
Sula' ye' mí̠tkela ulà a̠me̠' e'tala	Sula' ye' mí̠tkela ulà a̠me̠' e'tala	NOCHANGE
Ma̠ páköl	Ma̠ páköl	NOCHANGE
Ie' é̠r	Ie' é̠r	NOCHANGE
Ye' tö i ttèke	Ye' tö i ttèke	NOCHANGE
E'rö tsu'ku ajkö̀ awí̠she̠t	E'rö tsu'ku ajkö̀ awí̠she̠t	NOCHANGE
Ie' tö i síwè̠ke	Ie' tö i síwè̠ke	NOCHANGE
Kë̀ be' apàio iâu̠k cha̠mù̠ wö́li wa!	Kë̀ be' apàio iâu̠k cha̠mù̠ wö́li wa!	NOCHANGE
Ma̠ se' tö i kiè e̠ma̠ dlásháwö	Ma̠ se' tö i kiè e̠ma̠ dlásháwö	NOCHANGE
E'r e'r se' kapówa̠ie e'r	E'r e'r se' kapówa̠ie e'r	NOCHANGE
Ajá! kápiwö kë̀ wà ta̠wè̠ ta̠ ie'pa	Ajá! kápiwö kë̀ wà ta̠wè̠ ta̠ ie'pa	NOCHANGE
Ie' shkö̀	Ie' shkö̀	NOCHANGE
Ye' kàl e' kë̀ mì̠ne̠ bua' alátsítsi	Ye' kàl e' kë̀ mì̠ne̠ bua' alátsítsi	NOCHANGE
I chè se' ditsö̀ kàne̠ e' ajkö́nu̠k	I chè se' ditsö̀ kàne̠ e' ajkö́nu̠k	NOCHANGE
Kë'köldi dör	Kë'köldi dör	NOCHANGE
I kímú̠	I kímú̠	NOCHANGE
Ie' tö i kuátkèke	Ie' tö i kuátkèke	NOCHANGE
Stsa'wö we	Stsa'wö we	NOCHANGE
Ie' tö i tsèke	Ie' tö i tsèke	NOCHANGE
E's sa' tö í̠e̠ ta̠ i ka̠nè̠wè̠ke̠	E's sa' tö í̠e̠ ta̠ i ka̠nè̠wè̠ke̠	NOCHANGE
Ie' tö i kièke	Ie' tö i kièke	NOCHANGE
Be' mí̠ke̠ i sa̠ú̠k	Be' mí̠ke̠ i sa̠ú̠k	NOCHANGE
Ie' kó̠pàkö̀	Ie' kó̠pàkö̀	NOCHANGE
E' a̠ ye' tso' ajá!	E' a̠ ye' tso' ajá!	NOCHANGE
Tsawì èk	Tsawì èk	NOCHANGE
Ie' tö i alèke	Ie' tö i alèke	NOCHANGE
Ák bö̀k	Ák bö̀k	NOCHANGE
Kë̀ a̠ se' bák a̠	Kë̀ a̠ se' bák a̠	NOCHANGE
Ye'r i su̠wé̠mi̠	Ye'r i su̠wé̠mi̠	NOCHANGE
E' ta̠ e' wö̀ni̠è̠ke̠	E' ta̠ e' wö̀ni̠è̠ke̠	NOCHANGE
I ù dë'ka̠ ì wa tèröl tèröl wé ù bák te̠r dià tsu'ku	I ù dë'ka̠ ì wa tèröl tèröl wé ù bák te̠r dià tsu'ku	NOCHANGE
Be' è̠rke	Be' è̠rke	NOCHANGE
E' ku̠é̠ki̠ ie'r e' a̠mé̠a̠t	E' ku̠é̠ki̠ ie'r e' a̠mé̠a̠t	NOCHANGE
Ie'pa mí̠a̠ akë́këpa òka̠ma̠ ska o' apéitök	Ie'pa mí̠a̠ akë́këpa òka̠ma̠ ska o' apéitök	NOCHANGE
Dabòm ma̠ñá̠yök	Dabòm ma̠ñá̠yök	NOCHANGE
Ye' tö i tèke	Ye' tö i tèke	NOCHANGE
Diö́ ma̠ i wà e̠' ièka̠ ma̠ shalít	Diö́ ma̠ i wà e̠' ièka̠ ma̠ shalít	NOCHANGE
Ie' tö i kuèke	Ie' tö i kuèke	NOCHANGE
Éjkë ie'pa sé̠r wák wa e' ta̠ tsè ie'pa dör	Éjkë ie'pa sé̠r wák wa e' ta̠ tsè ie'pa dör	NOCHANGE
Ditséwö	Ditséwö	NOCHANGE
Ie'pa dör e' kapéyèke̠ be' ñe̠' ye' wö́s i kiè e' kapë ie'pa e' bua'wè̠ke̠ne̠	Ie'pa dör e' kapéyèke̠ be' ñe̠' ye' wö́s i kiè e' kapë ie'pa e' bua'wè̠ke̠ne̠	NOCHANGE
Be' tö i à̠ritsèke	Be' tö i à̠ritsèke	NOCHANGE
Ye' yàmi̠pa	Ye' yàmi̠pa	NOCHANGE
Ì ye' i ché ala se' kibìna̠tke éjkë se'r bö'wö	Ì ye' i ché ala se' kibìna̠tke éjkë se'r bö'wö	NOCHANGE
E̠' i̠ ù̠ i tkër e'rö e'rö ma̠	E̠' i̠ ù̠ i tkër e'rö e'rö ma̠	NOCHANGE
Mì̠ka̠ ie' déka̠ ká̠ aìe̠	Mì̠ka̠ ie' déka̠ ká̠ aìe̠	NOCHANGE
Be' inù̠ke	Be' inù̠ke	NOCHANGE
Ujú! e's e's sa' tsiru' wö̀ke̠	Ujú! e's e's sa' tsiru' wö̀ke̠	NOCHANGE
Ike be' dör e' ta̠ i na̠mé̠ be' wa̠	Ike be' dör e' ta̠ i na̠mé̠ be' wa̠	NOCHANGE
E' ta̠ kë̀ se' é̠n a̠ i ya'ku̠	E' ta̠ kë̀ se' é̠n a̠ i ya'ku̠	NOCHANGE
Ma̠ tsí	Ma̠ tsí	NOCHANGE
Ie' tö i ttèke	Ie' tö i ttèke	NOCHANGE
Ye' tö i à̠ritsè	Ye' tö i à̠ritsè	NOCHANGE
Ye' tö i tsèke	Ye' tö i tsèke	NOCHANGE
E'r ie' dawè e's se' shù̠ a̠ shù̠ wö̀tëna̠ ie	E'r ie' dawè e's se' shù̠ a̠ shù̠ wö̀tëna̠ ie	NOCHANGE
Kabék èt	Kabék èt	NOCHANGE
Di' dià	Di' dià	NOCHANGE
Ie' tö i yulèke	Ie' tö i yulèke	NOCHANGE
Awá tso' i kàl apasíu̠k tabè wa	Awá tso' i kàl apasíu̠k tabè wa	NOCHANGE
I sú̠ bö	I sú̠ bö	NOCHANGE
Ákajkue bák ikuö̀ wóie ajkè̠n ta̠'	Ákajkue bák ikuö̀ wóie ajkè̠n ta̠'	NOCHANGE
Ba tú̠nu̠	Ba tú̠nu̠	NOCHANGE
Ése e̠n	Ése e̠n	NOCHANGE
Ie' tö i kuèke	Ie' tö i kuèke	NOCHANGE
E' mé̠a̠t sibö̀ dör se' a̠	E' mé̠a̠t sibö̀ dör se' a̠	NOCHANGE
Sa' sawàna̠ ie' yö́k kë̀ sa' ie' tsiríwe̠	Sa' sawàna̠ ie' yö́k kë̀ sa' ie' tsiríwe̠	NOCHANGE
Ukö̀ki̠ be' rö a̠wí̠ apà biéstsa̠ be' rö shkít a̠wì̠	Ukö̀ki̠ be' rö a̠wí̠ apà biéstsa̠ be' rö shkít a̠wì̠	NOCHANGE
Ie' shkö̀ke	Ie' shkö̀ke	NOCHANGE
Be' tö i yèke	Be' tö i yèke	NOCHANGE
Kë̀ i wà ta̠'	Kë̀ i wà ta̠'	NOCHANGE
I à̠ritsö́	I à̠ritsö́	NOCHANGE
Ie' è̠rke	Ie' è̠rke	NOCHANGE
Ie' tö i tsè	Ie' tö i tsè	NOCHANGE
Ila bikéitse dur ki̠la söla e'la bikéitseke̠	Ila bikéitse dur ki̠la söla e'la bikéitseke̠	NOCHANGE
Ie' tö i sa̠wè̠ke	Ie' tö i sa̠wè̠ke	NOCHANGE
Wë́pa kúl	Wë́pa kúl	NOCHANGE
E' ku̠é̠ki̠ balë'këkëpa ichè icha ie'	E' ku̠é̠ki̠ balë'këkëpa ichè icha ie'	NOCHANGE
Sa̠nâ̠nâ̠ ë̀me̠ á̠jà̠ ña̠là̠ ë̀	Sa̠nâ̠nâ̠ ë̀me̠ á̠jà̠ ña̠là̠ ë̀	NOCHANGE
Së́baliwak	Së́baliwak	NOCHANGE
Pedro wa̠ íyi akák dé ye' a̠	Pedro wa̠ íyi akák dé ye' a̠	NOCHANGE
Bríbriwak	Bríbriwak	NOCHANGE
E' ta̠ ká̠ wé̠ à̠ta̠ e' ki̠ íyi tsikìna̠	E' ta̠ ká̠ wé̠ à̠ta̠ e' ki̠ íyi tsikìna̠	NOCHANGE
E'ta̠ e' ò̠mi̠k ta̠ kàlkö dóma̠le̠ se' ka̠nè̠wo̠ irir ì dawè	E'ta̠ e' ò̠mi̠k ta̠ kàlkö dóma̠le̠ se' ka̠nè̠wo̠ irir ì dawè	NOCHANGE
Mí̠shka chkök	Mí̠shka chkök	NOCHANGE
Ie' tö i tsirìwè̠	Ie' tö i tsirìwè̠	NOCHANGE
Ahora kë̀ ì à̠te̠ne̠ i éjkë ta̠	Ahora kë̀ ì à̠te̠ne̠ i éjkë ta̠	NOCHANGE
Ë́ e' ukö̀ mì̠ri̠a̠ sa' wa̠ í̠e̠ rö́k	Ë́ e' ukö̀ mì̠ri̠a̠ sa' wa̠ í̠e̠ rö́k	NOCHANGE
Dabòm kúlyök kí̠ tkë̀töm	Dabòm kúlyök kí̠ tkë̀töm	NOCHANGE
Be' tö i yulè	Be' tö i yulè	NOCHANGE
Ie' tö i akuö̀wè̠	Ie' tö i akuö̀wè̠	NOCHANGE
Ujche̠n ta̠ ike be' ichè ká̠che irir	Ujche̠n ta̠ ike be' ichè ká̠che irir	NOCHANGE
I shkè̠ú̠	I shkè̠ú̠	NOCHANGE
Kapö́li	Kapö́li	NOCHANGE
Ie' inù̠ke	Ie' inù̠ke	NOCHANGE
Ditséwö diö̀ya' ie'r e' kuátkë ie' rö ditsö̀wö ulìta̠ne̠ a̠	Ditséwö diö̀ya' ie'r e' kuátkë ie' rö ditsö̀wö ulìta̠ne̠ a̠	NOCHANGE
Ye' a̠ i su̠r	Ye' a̠ i su̠r	NOCHANGE
Dabòm kúlyök	Dabòm kúlyök	NOCHANGE
Alàbusi a̠wí̠ kalötó	Alàbusi a̠wí̠ kalötó	NOCHANGE
Kë̀ e' se' bua'ne̠	Kë̀ e' se' bua'ne̠	NOCHANGE
Ie' tö i chè	Ie' tö i chè	NOCHANGE
Be' tö i kuèke	Be' tö i kuèke	NOCHANGE
E' ka̠nè̠o̠ bitù̠tke ie'pa dör	E' ka̠nè̠o̠ bitù̠tke ie'pa dör	NOCHANGE
Ie' tö i kínè̠	Ie' tö i kínè̠	NOCHANGE
Íyök ka̠nè̠wè̠ke̠ ké̠weie	Íyök ka̠nè̠wè̠ke̠ ké̠weie	NOCHANGE
Bùsi sé̠ tko̠' òmi̠k	Bùsi sé̠ tko̠' òmi̠k	NOCHANGE
Tö́ íyi ajkö́nu̠k	Tö́ íyi ajkö́nu̠k	NOCHANGE
Trini̠ a̠	Trini̠ a̠	NOCHANGE
Ye' kutà be' diö́köl mu̠é̠ka̠ ako̠' â̠mi̠k	Ye' kutà be' diö́köl mu̠é̠ka̠ ako̠' â̠mi̠k	NOCHANGE
Ye' tö i kuèke	Ye' tö i kuèke	NOCHANGE
Ie' kalö̀tö̀	Ie' kalö̀tö̀	NOCHANGE
Balë'kë́këpa rö i pàke sa' a̠ tö tö	Balë'kë́këpa rö i pàke sa' a̠ tö tö	NOCHANGE
Ie' tö i kàchè	Ie' tö i kàchè	NOCHANGE
Kë̀ dör i ku̠é̠ki̠ sé̠râ a̠	Kë̀ dör i ku̠é̠ki̠ sé̠râ a̠	NOCHANGE
Bueno í̠e̠ se' rè e'ta̠ í̠e̠ sa' yulár wö̀ke̠	Bueno í̠e̠ se' rè e'ta̠ í̠e̠ sa' yulár wö̀ke̠	NOCHANGE
Kë̀ kapö̀ku̠ e̠'	Kë̀ kapö̀ku̠ e̠'	NOCHANGE
Ye' tö i batörè	Ye' tö i batörè	NOCHANGE
Ë̀kë̀kë	Ë̀kë̀kë	NOCHANGE
È̠ni̠a̠ na̠ñé̠we kipö̀ yö̀na̠	È̠ni̠a̠ na̠ñé̠we kipö̀ yö̀na̠	NOCHANGE
Ye' wa̠ kàl de ma̠ñà̠töm	Ye' wa̠ kàl de ma̠ñà̠töm	NOCHANGE
Ká̠ tèröl	Ká̠ tèröl	NOCHANGE
Pulë̀ pulë̀ i ukö̀ pà̠rlor ma̠	Pulë̀ pulë̀ i ukö̀ pà̠rlor ma̠	NOCHANGE
Íyi ajkö́nu̠k	Íyi ajkö́nu̠k	NOCHANGE
Sa yë́	Sa yë́	NOCHANGE
Be' tö i kuátkè	Be' tö i kuátkè	NOCHANGE
Ta̠ e' wö̀ a̠la kë̀la se' aë̀rwala	Ta̠ e' wö̀ a̠la kë̀la se' aë̀rwala	NOCHANGE
E' ku̠é̠ki̠ se' icha wö̀ balërke̠wa̠ kë̀ e's yì i tsiríwe̠	E' ku̠é̠ki̠ se' icha wö̀ balërke̠wa̠ kë̀ e's yì i tsiríwe̠	NOCHANGE
É e' ta̠ bua' ya'	É e' ta̠ bua' ya'	NOCHANGE
Ie' tö i i̠ù̠tèke	Ie' tö i i̠ù̠tèke	NOCHANGE
E' wö̀ ie e'ta̠ sé̠ àlim icha dör a̠wí̠ âr ki̠ e'	E' wö̀ ie e'ta̠ sé̠ àlim icha dör a̠wí̠ âr ki̠ e'	NOCHANGE
A̠lò̠chka e' kë̀ yawè í̠e̠	A̠lò̠chka e' kë̀ yawè í̠e̠	NOCHANGE
I̠ ma̠lé̠k	I̠ ma̠lé̠k	NOCHANGE
Be' tö i mo̠wè̠	Be' tö i mo̠wè̠	NOCHANGE
É i̠â̠chki ta̠	É i̠â̠chki ta̠	NOCHANGE
I a̠mì̠ wa̠ ie' mì̠né̠tse ká̠ aìe̠	I a̠mì̠ wa̠ ie' mì̠né̠tse ká̠ aìe̠	NOCHANGE
Pero ë́ e' se' ulà dé ska	Pero ë́ e' se' ulà dé ska	NOCHANGE
Ie' tö i kuèke	Ie' tö i kuèke	NOCHANGE
Ie' tö i mo̠wè̠	Ie' tö i mo̠wè̠	NOCHANGE
Àkna̠me̠pa dör banco a̠ inú̠köl baléwa̠	Àkna̠me̠pa dör banco a̠ inú̠köl baléwa̠	NOCHANGE
Kali'wè̠ dàne̠ sö sku' wa	Kali'wè̠ dàne̠ sö sku' wa	NOCHANGE
Ká̠ ta̠ì̠ë di' bitù̠tse̠ cha	Ká̠ ta̠ì̠ë di' bitù̠tse̠ cha	NOCHANGE
Ye' e̠' yawö̀	Ye' e̠' yawö̀	NOCHANGE
Ña̠ a̠mì̠	Ña̠ a̠mì̠	NOCHANGE
Sö i ché tö kë̀ i ta̠ e' be' tso' ká̠chök	Sö i ché tö kë̀ i ta̠ e' be' tso' ká̠chök	NOCHANGE
Ie' tö i tsèke	Ie' tö i tsèke	NOCHANGE
Ye' ùshikalö̀ke	Ye' ùshikalö̀ke	NOCHANGE
Ye' tö i wèke	Ye' tö i wèke	NOCHANGE
Be' tö i ñè̠ke	Be' tö i ñè̠ke	NOCHANGE
Pedro yë́ dör akë̀chake bulùka	Pedro yë́ dör akë̀chake bulùka	NOCHANGE
Ie' shkö̀	Ie' shkö̀	NOCHANGE
Tsí̠ne̠t	Tsí̠ne̠t	NOCHANGE
Wìm ètöm	Wìm ètöm	NOCHANGE
Ye'r i u'	Ye'r i u'	NOCHANGE
E' ù kuèke e'r e' a̠	E' ù kuèke e'r e' a̠	NOCHANGE
Ie' tö i yulè	Ie' tö i yulè	NOCHANGE
Ie' kàbalë shkö́k	Ie' kàbalë shkö́k	NOCHANGE
Costa ricaël	Costa ricaël	NOCHANGE
Ie' tö i yè	Ie' tö i yè	NOCHANGE
Ye' kutà tër aka̠' ki̠ i dawöke̠ e' ku̠é̠ki̠	Ye' kutà tër aka̠' ki̠ i dawöke̠ e' ku̠é̠ki̠	NOCHANGE
Tú̠nu̠k	Tú̠nu̠k	NOCHANGE
Sa̠mé̠ wö ñe̠' shkö̀ke̠ se' se' ki̠	Sa̠mé̠ wö ñe̠' shkö̀ke̠ se' se' ki̠	NOCHANGE
Ye' tö i kuátkèke	Ye' tö i kuátkèke	NOCHANGE
Na̠mù̠	Na̠mù̠	NOCHANGE
Sìkuapa icha itö̀ièke̠ se' dör	Sìkuapa icha itö̀ièke̠ se' dör	NOCHANGE
Ma̠ i shù̠baléka̠	Ma̠ i shù̠baléka̠	NOCHANGE
E' mí̠ke̠	E' mí̠ke̠	NOCHANGE
Ma̠ñà̠tökicha	Ma̠ñà̠tökicha	NOCHANGE
Ba tsö́	Ba tsö́	NOCHANGE
Ye' a̠ ta̠	Ye' a̠ ta̠	NOCHANGE
Yì yàmi̠	Yì yàmi̠	NOCHANGE
Ie' tö i ichàkèke	Ie' tö i ichàkèke	NOCHANGE
Ie' é̠ne̠	Ie' é̠ne̠	NOCHANGE
Ë́ yö be' ki̠ à̠ ku̠e̠	Ë́ yö be' ki̠ à̠ ku̠e̠	NOCHANGE
Be' tö i à̠ritsè	Be' tö i à̠ritsè	NOCHANGE
Ie' tö i ka̠nè̠wè̠	Ie' tö i ka̠nè̠wè̠	NOCHANGE
Ba e̠' yawö́	Ba e̠' yawö́	NOCHANGE
Kë̀ ie' ujtö́k	Kë̀ ie' ujtö́k	NOCHANGE
Dabòm kúlyök	Dabòm kúlyök	NOCHANGE
Ye' tö i shkè̠wè̠ke	Ye' tö i shkè̠wè̠ke	NOCHANGE
Ba inú̠	Ba inú̠	NOCHANGE
Ie' yulè	Ie' yulè	NOCHANGE
Ie' tö i ka̠nè̠wè̠ke	Ie' tö i ka̠nè̠wè̠ke	NOCHANGE
Pero e' alè ñe̠'e̠ wè sö e'r i̠ña̠'ie	Pero e' alè ñe̠'e̠ wè sö e'r i̠ña̠'ie	NOCHANGE
Ali' iö́köl ie	Ali' iö́köl ie	NOCHANGE
I jtö̀	I jtö̀	NOCHANGE
E' të́rke̠	E' të́rke̠	NOCHANGE
Be' tö i katèke	Be' tö i katèke	NOCHANGE
Ye' tö i batörèke	Ye' tö i batörèke	NOCHANGE
Ie' kalö̀tö̀ke	Ie' kalö̀tö̀ke	NOCHANGE
Ká̠ i̠â̠i̠â̠ e' ta̠ yö i yawé	Ká̠ i̠â̠i̠â̠ e' ta̠ yö i yawé	NOCHANGE
Ie' kó̠pàkö̀ke	Ie' kó̠pàkö̀ke	NOCHANGE
E's ie'pa bák ka̠nè̠balök	E's ie'pa bák ka̠nè̠balök	NOCHANGE
Wé̠jkë ma̠ ta̠ se' ditsö̀wö a̠ ká̠wö mé̠rmi̠ ö kë̀ ká̠wö ta̠ da' a̠	Wé̠jkë ma̠ ta̠ se' ditsö̀wö a̠ ká̠wö mé̠rmi̠ ö kë̀ ká̠wö ta̠ da' a̠	NOCHANGE
E' ta̠ se' déka̠ i ki̠	E' ta̠ se' déka̠ i ki̠	NOCHANGE
Tcho̠'dawe	Tcho̠'dawe	NOCHANGE
Ì ku̠é̠ki̠ e's irir	Ì ku̠é̠ki̠ e's irir	NOCHANGE
Ie' tù̠rke	Ie' tù̠rke	NOCHANGE
Balë'kë́këpa a̠ i ché tö i ka̠nè̠u̠	Balë'kë́këpa a̠ i ché tö i ka̠nè̠u̠	NOCHANGE
À̠a̠! se' ma̠ ma̠ ú̠rke̠ ka̠ñí̠k a̠ ña̠	À̠a̠! se' ma̠ ma̠ ú̠rke̠ ka̠ñí̠k a̠ ña̠	NOCHANGE
Kàl i'	Kàl i'	NOCHANGE
Ajkö̀nú̠kna̠me̠ dör àkbalö́kna̠me̠ su̠wé̠ wa̠	Ajkö̀nú̠kna̠me̠ dör àkbalö́kna̠me̠ su̠wé̠ wa̠	NOCHANGE
Ali' tso'	Ali' tso'	NOCHANGE
Ie' tö i pàlèke	Ie' tö i pàlèke	NOCHANGE
Ye' yàk sa̠ e̠' ye' sè̠ne̠	Ye' yàk sa̠ e̠' ye' sè̠ne̠	NOCHANGE
E's e' tër e' ku̠é̠ki̠	E's e' tër e' ku̠é̠ki̠	NOCHANGE
Ye' alà ujtó	Ye' alà ujtó	NOCHANGE
Érë wé̠ wa̠ i ujche̠n e' ta̠ wé̠ wa̠ i si̠wé̠ ujche̠n e' ta̠ e'r se' bua'wé̠	Érë wé̠ wa̠ i ujche̠n e' ta̠ wé̠ wa̠ i si̠wé̠ ujche̠n e' ta̠ e'r se' bua'wé̠	NOCHANGE
Wé̠ kë̀ wa̠ e' ujche̠n wé̠ yö̀nâ̠na̠ ë́ yànâ̠na̠ ë́	Wé̠ kë̀ wa̠ e' ujche̠n wé̠ yö̀nâ̠na̠ ë́ yànâ̠na̠ ë́	NOCHANGE
Ì be' kièrö bétk a̠ e̠' rö	Ì be' kièrö bétk a̠ e̠' rö	NOCHANGE
Ie' tö i ppè	Ie' tö i ppè	NOCHANGE
Ie' tö i ichàkè	Ie' tö i ichàkè	NOCHANGE
Ye' tö i chèke	Ye' tö i chèke	NOCHANGE
Ie' tö i katè	Ie' tö i katè	NOCHANGE
Ye' inù̠ke	Ye' inù̠ke	NOCHANGE
Tabèla káu̠ se' wö̀a̠ bula'me̠ dià i yër	Tabèla káu̠ se' wö̀a̠ bula'me̠ dià i yër	NOCHANGE
Érë kë̀ ie' ki̠ i ku̠' bua'ie	Érë kë̀ ie' ki̠ i ku̠' bua'ie	NOCHANGE
Wé̠jkë e' à̠ta̠ í̠e̠ ta̠	Wé̠jkë e' à̠ta̠ í̠e̠ ta̠	NOCHANGE
Kò̠s be' ki̠ dawás tso'	Kò̠s be' ki̠ dawás tso'	NOCHANGE
Se' dalö̀ièke̠	Se' dalö̀ièke̠	NOCHANGE
I à̠ritsö́	I à̠ritsö́	NOCHANGE
E' yawè yö ma̠ kalö́m iö́köl ie	E' yawè yö ma̠ kalö́m iö́köl ie	NOCHANGE
Tú̠nu̠k	Tú̠nu̠k	NOCHANGE
Cien su̠lì̠túyök	Cien su̠lì̠túyök	NOCHANGE
Mil bö́yök	Mil bö́yök	NOCHANGE
Ye' mí̠k ye' ák dalë́ta̠	Ye' mí̠k ye' ák dalë́ta̠	NOCHANGE
I shtö́	I shtö́	NOCHANGE
Be' tö i síwè̠ke	Be' tö i síwè̠ke	NOCHANGE
Ká̠ dö̀ pàköl ká̠ su̠lì̠tu	Ká̠ dö̀ pàköl ká̠ su̠lì̠tu	NOCHANGE
Kutà ie ne̠ irir	Kutà ie ne̠ irir	NOCHANGE
Ie' shkö̀ke	Ie' shkö̀ke	NOCHANGE
I yö́ söla i yö́ söla balo'rila	I yö́ söla i yö́ söla balo'rila	NOCHANGE
Ñe̠' balë'këkëpa dö iche se' shù̠a̠ ì dalë̀na̠ wa̠ bö̀ ë̀ e' ta̠ e' se'	Ñe̠' balë'këkëpa dö iche se' shù̠a̠ ì dalë̀na̠ wa̠ bö̀ ë̀ e' ta̠ e' se'	NOCHANGE
Ie' chkö̀	Ie' chkö̀	NOCHANGE
Ák ki̠ ajá! ák ki̠	Ák ki̠ ajá! ák ki̠	NOCHANGE
Ì ku̠é̠ sö mí̠ke̠ dià e̠ tsì̠ ki̠	Ì ku̠é̠ sö mí̠ke̠ dià e̠ tsì̠ ki̠	NOCHANGE
I yéwa	I yéwa	NOCHANGE
Ie' i̠ù̠ke	Ie' i̠ù̠ke	NOCHANGE
Dìwö dö̀ke̠tke batà a̠ éjkë	Dìwö dö̀ke̠tke batà a̠ éjkë	NOCHANGE
Be' dakö́ chakè ta̠ú̠k se' a̠!	Be' dakö́ chakè ta̠ú̠k se' a̠!	NOCHANGE
Yulö̀k	Yulö̀k	NOCHANGE
I yawö́	I yawö́	NOCHANGE
Sula' sula' ichàkökala	Sula' sula' ichàkökala	NOCHANGE
Anastasia ù	Anastasia ù	NOCHANGE
A̠mù̠bali	A̠mù̠bali	NOCHANGE
Ie' tö i alè	Ie' tö i alè	NOCHANGE
Ie' kó̠pàkö̀ke	Ie' kó̠pàkö̀ke	NOCHANGE
Ie' tö i batörèke	Ie' tö i batörèke	NOCHANGE
Ie' ùshikalö̀	Ie' ùshikalö̀	NOCHANGE
Tsë̀nu̠k	Tsë̀nu̠k	NOCHANGE
Ba kapö́wa̠	Ba kapö́wa̠	NOCHANGE
E' ta̠ i wà ma̠ tsikírmi̠ i ki̠	E' ta̠ i wà ma̠ tsikírmi̠ i ki̠	NOCHANGE
Ie' tö i katèke	Ie' tö i katèke	NOCHANGE
Na̠mù̠ bulùbulù	Na̠mù̠ bulùbulù	NOCHANGE
U̠jú̠! u̠jú̠!	U̠jú̠! u̠jú̠!	NOCHANGE
Be' akuö̀ke	Be' akuö̀ke	NOCHANGE
Ie' tö i alèke	Ie' tö i alèke	NOCHANGE
Íyiwak e̠na̠ i ë́ltë	Íyiwak e̠na̠ i ë́ltë	NOCHANGE
Ie' tö i chèke	Ie' tö i chèke	NOCHANGE
Ta̠ ie' dur nú̠ie	Ta̠ ie' dur nú̠ie	NOCHANGE
Se' bua'ne̠	Se' bua'ne̠	NOCHANGE
Batörö̀k	Batörö̀k	NOCHANGE
À! kápi báu̠k	À! kápi báu̠k	NOCHANGE
Mí̠shka dë̀untö batà wébalök!	Mí̠shka dë̀untö batà wébalök!	NOCHANGE
Na̠mù̠ tsée	Na̠mù̠ tsée	NOCHANGE
Mí̠k se' dör ie' tè pú a̠wì̠ ta̠	Mí̠k se' dör ie' tè pú a̠wì̠ ta̠	NOCHANGE
Kuë̀ èk	Kuë̀ èk	NOCHANGE
E' wake' dalì wö e' dalì wö e' wa̠ i ujche̠n e' ta̠ e' se' bua'wé̠	E' wake' dalì wö e' dalì wö e' wa̠ i ujche̠n e' ta̠ e' se' bua'wé̠	NOCHANGE
Ie' datsi' a̠mé̠ se' yë́ a̠ ta̠ ie' e̠' iéka̠ i kipö̀ a̠	Ie' datsi' a̠mé̠ se' yë́ a̠ ta̠ ie' e̠' iéka̠ i kipö̀ a̠	NOCHANGE
Be' kalö̀tö̀	Be' kalö̀tö̀	NOCHANGE
Be' inù̠ke	Be' inù̠ke	NOCHANGE
E' icha e' wa ie' icha jtö̀ië'	E' icha e' wa ie' icha jtö̀ië'	NOCHANGE
Ye' ùshikalö̀ke	Ye' ùshikalö̀ke	NOCHANGE
Ie' bitséitsè ta̠'	Ie' bitséitsè ta̠'	NOCHANGE
Be' tö i síwè̠	Be' tö i síwè̠	NOCHANGE
Se' ká̠	Se' ká̠	NOCHANGE
Be' tö i alèke	Be' tö i alèke	NOCHANGE
Diö́se	Diö́se	NOCHANGE
Dentista dör ye' akàña̠k yéttsa̠ bö̀t	Dentista dör ye' akàña̠k yéttsa̠ bö̀t	NOCHANGE
Libro leaú̠k ye' tso' e'r aì	Libro leaú̠k ye' tso' e'r aì	NOCHANGE
Dù tkámi̠ ù tsá̠ka	Dù tkámi̠ ù tsá̠ka	NOCHANGE
Kiè ë́ltë e̠na̠ tté shtáwo̠k	Kiè ë́ltë e̠na̠ tté shtáwo̠k	NOCHANGE
Kaë̀ chkàla wë́rke̠ ta̠ e' mi̠'ke̠	Kaë̀ chkàla wë́rke̠ ta̠ e' mi̠'ke̠	NOCHANGE
Ie' kapötkër	Ie' kapötkër	NOCHANGE
E' rö ö̀kö	E' rö ö̀kö	NOCHANGE
E' kë́pa kàl skö̀ irík	E' kë́pa kàl skö̀ irík	NOCHANGE
Alàköl datsi'	Alàköl datsi'	NOCHANGE
Kutàie irir wak kë̀ ye' i tsiríwe̠	Kutàie irir wak kë̀ ye' i tsiríwe̠	NOCHANGE
Cha̠mù̠ dë ña̠ a̠mì̠ wa̠ wé̠sh chakì e' dör áki	Cha̠mù̠ dë ña̠ a̠mì̠ wa̠ wé̠sh chakì e' dör áki	NOCHANGE
Wé̠ ie'pa bák ka̠nè̠balök e̠'rök	Wé̠ ie'pa bák ka̠nè̠balök e̠'rök	NOCHANGE
Sa' é̠n a̠ sa' wákpa i̠à̠ne̠	Sa' é̠n a̠ sa' wákpa i̠à̠ne̠	NOCHANGE
Ie' i̠ni̠	Ie' i̠ni̠	NOCHANGE
Si̠o̠' bö̀t	Si̠o̠' bö̀t	NOCHANGE
Ká̠ bák ye' i kiè i ku̠é̠ki̠	Ká̠ bák ye' i kiè i ku̠é̠ki̠	NOCHANGE
À̠s kë̀ à̠s kë̀ si̠wa̠' i pö̀u̠	À̠s kë̀ à̠s kë̀ si̠wa̠' i pö̀u̠	NOCHANGE
E'r i̠ña̠'ie ñè̠	E'r i̠ña̠'ie ñè̠	NOCHANGE
Na̠mù̠ jkuö̀ e'	Na̠mù̠ jkuö̀ e'	NOCHANGE
Akuö̀u̠k	Akuö̀u̠k	NOCHANGE
Kë̀ cha̠mù̠ wàta̠wè̠ ta̠	Kë̀ cha̠mù̠ wàta̠wè̠ ta̠	NOCHANGE
María dör i alà wí̠	María dör i alà wí̠	NOCHANGE
Mì̠kalè ta̠ i chówa	Mì̠kalè ta̠ i chówa	NOCHANGE
I stsë́rdak	I stsë́rdak	NOCHANGE
Se' a̠ se' o̠' dalë́r ma̠ e' rö mu̠lù̠tak yèke̠ sö	Se' a̠ se' o̠' dalë́r ma̠ e' rö mu̠lù̠tak yèke̠ sö	NOCHANGE
Ie' tö i kímè̠ke	Ie' tö i kímè̠ke	NOCHANGE
Ká̠ kà̠jtö yö' sibö̀ rö	Ká̠ kà̠jtö yö' sibö̀ rö	NOCHANGE
Ye' tö i wámbalè	Ye' tö i wámbalè	NOCHANGE
Àlim icha dör	Àlim icha dör	NOCHANGE
Kùktökicha	Kùktökicha	NOCHANGE
Inù̠k bola wa	Inù̠k bola wa	NOCHANGE
Ie' tö i kínè̠ke	Ie' tö i kínè̠ke	NOCHANGE
Ie' tö i wè	Ie' tö i wè	NOCHANGE
Ye' tö i alí	Ye' tö i alí	NOCHANGE
Be' tö i yulèke	Be' tö i yulèke	NOCHANGE
Wé̠ be' sé̠rke̠	Wé̠ be' sé̠rke̠	NOCHANGE
Ká̠ bìt ta̠ se' déka̠	Ká̠ bìt ta̠ se' déka̠	NOCHANGE
À̠a̠! na̠i̠'chka	À̠a̠! na̠i̠'chka	NOCHANGE
Ye' tö i kàchèke	Ye' tö i kàchèke	NOCHANGE
Ba akuö́	Ba akuö́	NOCHANGE
Yulö̀r	Yulö̀r	NOCHANGE
I alö́	I alö́	NOCHANGE
Ye' tö i shkè̠wè̠ke	Ye' tö i shkè̠wè̠ke	NOCHANGE
E̠' ë̀ ie'pa bák ka̠nè̠balök	E̠' ë̀ ie'pa bák ka̠nè̠balök	NOCHANGE
Si̠nà̠ èk	Si̠nà̠ èk	NOCHANGE
Ye' tö i kuátkè	Ye' tö i kuátkè	NOCHANGE
I wö̀na̠ bua'	I wö̀na̠ bua'	NOCHANGE
Ie' é̠r	Ie' é̠r	NOCHANGE
Ie' é̠r	Ie' é̠r	NOCHANGE
I kiö́	I kiö́	NOCHANGE
Buà ètöm	Buà ètöm	NOCHANGE
Si̠nà̠ èk	Si̠nà̠ èk	NOCHANGE
Ù tkër di' á̠mi̠k	Ù tkër di' á̠mi̠k	NOCHANGE
Uyë̀jkuö à̠ritsök	Uyë̀jkuö à̠ritsök	NOCHANGE
Kë̀ ie' ujtö́k	Kë̀ ie' ujtö́k	NOCHANGE
Ie' tö i akuö̀wè̠ke	Ie' tö i akuö̀wè̠ke	NOCHANGE
Ñé̠ be' dör i chè tö na̠mà̠söl	Ñé̠ be' dör i chè tö na̠mà̠söl	NOCHANGE
I' dör se' icha	I' dör se' icha	NOCHANGE
Be' tö i kímè̠ke	Be' tö i kímè̠ke	NOCHANGE
Ie' i sa̠wè̠ke	Ie' i sa̠wè̠ke	NOCHANGE
Ai' dör sa' á̠wé̠	Ai' dör sa' á̠wé̠	NOCHANGE
No ñe̠' be' ichè dalö̀ ie' tso' ie' dalö̀ mí̠k ie' ie'	No ñe̠' be' ichè dalö̀ ie' tso' ie' dalö̀ mí̠k ie' ie'	NOCHANGE
Ók tsìrtsir	Ók tsìrtsir	NOCHANGE
Se' diché déka̠ ma̠ ta̠ sö i kímè̠ke̠	Se' diché déka̠ ma̠ ta̠ sö i kímè̠ke̠	NOCHANGE
Së́ dör pàköl	Së́ dör pàköl	NOCHANGE
Ye' é̠n bikö balë'këkëpa ulìta̠ne̠ wa̠ e' si̠wé̠ ujche̠n	Ye' é̠n bikö balë'këkëpa ulìta̠ne̠ wa̠ e' si̠wé̠ ujche̠n	NOCHANGE
Yë́ria tso' ajkàku̠k i chìchi tsa̠k	Yë́ria tso' ajkàku̠k i chìchi tsa̠k	NOCHANGE
Ie' tö i tkèke	Ie' tö i tkèke	NOCHANGE
San pedrowak	San pedrowak	NOCHANGE
Wé̠ ñe̠' talók akà	Wé̠ ñe̠' talók akà	NOCHANGE
Ajá! kë̀ wè̠s se' ulà dö̀pa	Ajá! kë̀ wè̠s se' ulà dö̀pa	NOCHANGE
Ë́ ajkuö tè bë́rërë	Ë́ ajkuö tè bë́rërë	NOCHANGE
Ie'pa i kéli tso' se' bua'wó̠ ie	Ie'pa i kéli tso' se' bua'wó̠ ie	NOCHANGE
Ie' tö i ka̠nè̠wè̠	Ie' tö i ka̠nè̠wè̠	NOCHANGE
Tcho̠'dawe sulù pë'!	Tcho̠'dawe sulù pë'!	NOCHANGE
Dawë́ e' kë̀ sú̠rule be' wa̠	Dawë́ e' kë̀ sú̠rule be' wa̠	NOCHANGE
Be' ka̠nè̠balö̀ke	Be' ka̠nè̠balö̀ke	NOCHANGE
Chkö̀ ie e'ta̠ sö i̠ ñé̠ sé̠se̠ sé̠se̠la	Chkö̀ ie e'ta̠ sö i̠ ñé̠ sé̠se̠ sé̠se̠la	NOCHANGE
Kàl wö iene̠	Kàl wö iene̠	NOCHANGE
E' ë̀ ti̠è̠ke̠ka̠mi̠ mà̠sopa tsá̠li̠ ta̠ dó kéu̠n	E' ë̀ ti̠è̠ke̠ka̠mi̠ mà̠sopa tsá̠li̠ ta̠ dó kéu̠n	NOCHANGE
Ye' tö i tè	Ye' tö i tè	NOCHANGE
Ì se' shù̠ wö̀teke̠wa̠ ñe̠'	Ì se' shù̠ wö̀teke̠wa̠ ñe̠'	NOCHANGE
Ye' kapákwa̠!	Ye' kapákwa̠!	NOCHANGE
Í̠e̠ rö í̠e̠ ye' dé	Í̠e̠ rö í̠e̠ ye' dé	NOCHANGE
Se' a̠ sibö̀ dör ká̠ a̠me̠'a̠t ikuá̠ki̠	Se' a̠ sibö̀ dör ká̠ a̠me̠'a̠t ikuá̠ki̠	NOCHANGE
Ye' yàmi̠ wö́ke wö́ular áksaku yawö́k	Ye' yàmi̠ wö́ke wö́ular áksaku yawö́k	NOCHANGE
Be' inù̠	Be' inù̠	NOCHANGE
Wë́m sù̠na̠wa̠	Wë́m sù̠na̠wa̠	NOCHANGE
Sa'' i' ël sa' ë́ltë ta̠ wake' i bitséitsèke̠ ké̠kra	Sa'' i' ël sa' ë́ltë ta̠ wake' i bitséitsèke̠ ké̠kra	NOCHANGE
Cien kúlyök	Cien kúlyök	NOCHANGE
Ajá! e' ku̠é̠ki̠ ká̠ kiè sulàyöm	Ajá! e' ku̠é̠ki̠ ká̠ kiè sulàyöm	NOCHANGE
E's ie i wà dör	E's ie i wà dör	NOCHANGE
Ie' tö i kuátkè	Ie' tö i kuátkè	NOCHANGE
Ie' e̠ne̠'	Ie' e̠ne̠'	NOCHANGE
Ye' tù̠r	Ye' tù̠r	NOCHANGE
Ye' tö i kínè̠	Ye' tö i kínè̠	NOCHANGE
Be' tö i ka̠nè̠wè̠	Be' tö i ka̠nè̠wè̠	NOCHANGE
Batörö̀k	Batörö̀k	NOCHANGE
Ye' tso' i sa̠ú̠k	Ye' tso' i sa̠ú̠k	NOCHANGE
Ie'pa kalötö	Ie'pa kalötö	NOCHANGE
Dù tkër àl ulà ki̠	Dù tkër àl ulà ki̠	NOCHANGE
Se' mí̠ke̠la ta̠la sula' söla i bikéitseke̠ tela	Se' mí̠ke̠la ta̠la sula' söla i bikéitseke̠ tela	NOCHANGE
Kua'kua ma̠ñà̠t	Kua'kua ma̠ñà̠t	NOCHANGE
Ye' tö i ka̠nè̠wè̠	Ye' tö i ka̠nè̠wè̠	NOCHANGE
Ú̠rke̠ mì̠kalè ma̠ñá̠l ö ské̠l	Ú̠rke̠ mì̠kalè ma̠ñá̠l ö ské̠l	NOCHANGE
A yë́!	A yë́!	NOCHANGE
E' wa̠ kò̠s se' tso'se̠r í̠e̠ e' mí̠ke̠ tsé̠r	E' wa̠ kò̠s se' tso'se̠r í̠e̠ e' mí̠ke̠ tsé̠r	NOCHANGE
Dabòm dabòbyök dabòbyök	Dabòm dabòbyök dabòbyök	NOCHANGE
Ie' ka̠nè̠balö̀ke	Ie' ka̠nè̠balö̀ke	NOCHANGE
Wìm ku̠è̠ sö	Wìm ku̠è̠ sö	NOCHANGE
Be' ttö̀ke	Be' ttö̀ke	NOCHANGE
Be' tö i tkèke	Be' tö i tkèke	NOCHANGE
Se' yèkewa se' yèwa se' yèkewa irir ta̠	Se' yèkewa se' yèwa se' yèkewa irir ta̠	NOCHANGE
Akuk kë̀ dör bua' kàl tak ie	Akuk kë̀ dör bua' kàl tak ie	NOCHANGE
Dawë́ ku̠è̠ sö	Dawë́ ku̠è̠ sö	NOCHANGE
Sakuèke̠ bö bua' ë	Sakuèke̠ bö bua' ë	NOCHANGE
I sá̠u̠	I sá̠u̠	NOCHANGE
Ie' tö i kímè̠	Ie' tö i kímè̠	NOCHANGE
Kàlbali ajké̠	Kàlbali ajké̠	NOCHANGE
Bulámi̠	Bulámi̠	NOCHANGE
Si̠ni̠' ku̠è̠ sö	Si̠ni̠' ku̠è̠ sö	NOCHANGE
Ukö̀ki̠ kéli a̠wí̠ ñè̠ke̠ sö	Ukö̀ki̠ kéli a̠wí̠ ñè̠ke̠ sö	NOCHANGE
Térriki	Térriki	NOCHANGE
Bö' bö́wö ièke̠ ké̠kra à̠s shka̠lá̠ rö i síù̠wa̠ wé̠shke̠	Bö' bö́wö ièke̠ ké̠kra à̠s shka̠lá̠ rö i síù̠wa̠ wé̠shke̠	NOCHANGE
Kë̀ ye' wa̠ i sa̠wé̠	Kë̀ ye' wa̠ i sa̠wé̠	NOCHANGE
Ña̠là̠ yéstsa̠ be'rö	Ña̠là̠ yéstsa̠ be'rö	NOCHANGE
Ése ujtèke̠ balë'kë́këpa sulë̀wö wa kua'böt wa	Ése ujtèke̠ balë'kë́këpa sulë̀wö wa kua'böt wa	NOCHANGE
Ba shkö́	Ba shkö́	NOCHANGE
Ajkö́na̠mu̠ dör kö̀chi katèke̠	Ajkö́na̠mu̠ dör kö̀chi katèke̠	NOCHANGE
I yulö́	I yulö́	NOCHANGE
Ie' tö i alèke	Ie' tö i alèke	NOCHANGE
Kë̀ be' ë́l apàchök!	Kë̀ be' ë́l apàchök!	NOCHANGE
Ie' chkö̀ke	Ie' chkö̀ke	NOCHANGE
E' dör ie' dawè	E' dör ie' dawè	NOCHANGE
Ye'r i sa̠wé̠	Ye'r i sa̠wé̠	NOCHANGE
Dakarò sé̠	Dakarò sé̠	NOCHANGE
Kë̀ bachàne̠	Kë̀ bachàne̠	NOCHANGE
Cha̠mù̠ kuá	Cha̠mù̠ kuá	NOCHANGE
Uya' alö́ si̠a̠!	Uya' alö́ si̠a̠!	NOCHANGE
Balë'këkëpa se' kapèye ta̠ se' bua'na̠ne̠	Balë'këkëpa se' kapèye ta̠ se' bua'na̠ne̠	NOCHANGE
I̠ù̠tök	I̠ù̠tök	NOCHANGE
Be' na̠ù̠	Be' na̠ù̠	NOCHANGE
Awá dakarò ta̠	Awá dakarò ta̠	NOCHANGE
E' rö se' icha wake'	E' rö se' icha wake'	NOCHANGE
Ye' akuö̀ke	Ye' akuö̀ke	NOCHANGE
Ie' tö i shkè̠wè̠	Ie' tö i shkè̠wè̠	NOCHANGE
Ká̠ tkë́l	Ká̠ tkë́l	NOCHANGE
E' duà ë̀ yulèke̠ne̠	E' duà ë̀ yulèke̠ne̠	NOCHANGE
E'rör ie'pa ë̀ wàpie	E'rör ie'pa ë̀ wàpie	NOCHANGE
E's i ché irir icha dayë̀ yö̀ne̠	E's i ché irir icha dayë̀ yö̀ne̠	NOCHANGE
Sa' tso' é̠nu̠k kàl dikì̠ a̠	Sa' tso' é̠nu̠k kàl dikì̠ a̠	NOCHANGE
Sawë́ èk	Sawë́ èk	NOCHANGE
Tkabë̀ tkë̀töm	Tkabë̀ tkë̀töm	NOCHANGE
Yi ya'	Yi ya'	NOCHANGE
Mì̠k a' déka̠ aìk e'ta̠ i biyö̀chö́	Mì̠k a' déka̠ aìk e'ta̠ i biyö̀chö́	NOCHANGE
Ì wë̀na̠la ése ka̠né̠we̠ke̠ ie'pa	Ì wë̀na̠la ése ka̠né̠we̠ke̠ ie'pa	NOCHANGE
Ie' i su̠'	Ie' i su̠'	NOCHANGE
Ie' dawè tsikírke̠ ma̠ se' chál wö̀tërke̠	Ie' dawè tsikírke̠ ma̠ se' chál wö̀tërke̠	NOCHANGE
Ye' tö i yulèke	Ye' tö i yulèke	NOCHANGE
Ie' tö i yawèke	Ie' tö i yawèke	NOCHANGE
I kàchö́	I kàchö́	NOCHANGE
Dabòm èyök	Dabòm èyök	NOCHANGE
Ye' kó̠pàkö̀ke	Ye' kó̠pàkö̀ke	NOCHANGE
Chë́r wé̠ pú̠ sé̠r wé̠ ie' ishtirìne̠ ta̠ e' ie' e̠' tké dé e̠'rö	Chë́r wé̠ pú̠ sé̠r wé̠ ie' ishtirìne̠ ta̠ e' ie' e̠' tké dé e̠'rö	NOCHANGE
Ie' tö i kuè	Ie' tö i kuè	NOCHANGE
Cha̠né̠ka̠ a̠wì̠ yawó ie	Cha̠né̠ka̠ a̠wì̠ yawó ie	NOCHANGE
Se' wö̀ni̠è̠ke̠ ie'pa balë'këkë dör se' wö̀ni̠è̠ke̠ wö̀ni̠rule	Se' wö̀ni̠è̠ke̠ ie'pa balë'këkë dör se' wö̀ni̠è̠ke̠ wö̀ni̠rule	NOCHANGE
A' bák kalö̀tök	A' bák kalö̀tök	NOCHANGE
Cien ma̠ñá̠yök	Cien ma̠ñá̠yök	NOCHANGE
Ye' a̠ kápi ur	Ye' a̠ kápi ur	NOCHANGE
Ie' tö i kàchèke	Ie' tö i kàchèke	NOCHANGE
Mò̠ aì	Mò̠ aì	NOCHANGE
Ká̠ e'tk ë̀	Ká̠ e'tk ë̀	NOCHANGE
Ie'pa té̠rke̠	Ie'pa té̠rke̠	NOCHANGE
Ye' tö i katèke	Ye' tö i katèke	NOCHANGE
Ie' tö i wámbalèke	Ie' tö i wámbalèke	NOCHANGE
Se' wö̀ téiela	Se' wö̀ téiela	NOCHANGE
Ie' tö i tsirìwè̠ke	Ie' tö i tsirìwè̠ke	NOCHANGE
Í̠e̠ i tso'	Í̠e̠ i tso'	NOCHANGE
Shtö̀k	Shtö̀k	NOCHANGE
Wé̠alè é! be' dë́rule ka̠ñí̠k a̠ e' apàkö́ ña̠	Wé̠alè é! be' dë́rule ka̠ñí̠k a̠ e' apàkö́ ña̠	NOCHANGE
Shù̠ wö̀teke̠wa̠ irir ñé̠se ku̠é̠ki̠ icha kë̀ i kutùne̠	Shù̠ wö̀teke̠wa̠ irir ñé̠se ku̠é̠ki̠ icha kë̀ i kutùne̠	NOCHANGE
Ie' tö i shtè	Ie' tö i shtè	NOCHANGE
Wë́stëla	Wë́stëla	NOCHANGE
Na̠i̠' bö̀töm	Na̠i̠' bö̀töm	NOCHANGE
Be' kó̠pàkö̀ke	Be' kó̠pàkö̀ke	NOCHANGE
Pedro dör ajkö̀ö́na̠me̠ mì̠k ie' mí̠ke̠ sa' ta̠	Pedro dör ajkö̀ö́na̠me̠ mì̠k ie' mí̠ke̠ sa' ta̠	NOCHANGE
Ma̠ mù̠	Ma̠ mù̠	NOCHANGE
Be' tö i kàchè	Be' tö i kàchè	NOCHANGE
Ie' shkö̀ke	Ie' shkö̀ke	NOCHANGE
Tsikirístsikiris	Tsikirístsikiris	NOCHANGE
Ie' tö i kàchè	Ie' tö i kàchè	NOCHANGE
Ye' tö i tsirìwè̠	Ye' tö i tsirìwè̠	NOCHANGE
Ye' kiè tomasa pereira	Ye' kiè tomasa pereira	NOCHANGE
Ie' tö i tèke	Ie' tö i tèke	NOCHANGE
Kapö́li	Kapö́li	NOCHANGE
Tsipátsipâ	Tsipátsipâ	NOCHANGE
E's ie'pa batàie ta̠ e' tö i sa̠wé̠ tö sibö̀ ie'pala a̠ ikuö̀wö a̠mé̠ katè	E's ie'pa batàie ta̠ e' tö i sa̠wé̠ tö sibö̀ ie'pala a̠ ikuö̀wö a̠mé̠ katè	NOCHANGE
Ie' tö i katèke	Ie' tö i katèke	NOCHANGE
Ye' tö i alè	Ye' tö i alè	NOCHANGE
Ye' kalö̀tö̀ke	Ye' kalö̀tö̀ke	NOCHANGE
Ye' ikítule	Ye' ikítule	NOCHANGE
Ye' sé̠rke̠ e'ta̠ aíkie ña̠là̠ domi̠	Ye' sé̠rke̠ e'ta̠ aíkie ña̠là̠ domi̠	NOCHANGE
Ie' e̠' chö̀kea̠t	Ie' e̠' chö̀kea̠t	NOCHANGE
Ie' kó̠pàkö̀ke	Ie' kó̠pàkö̀ke	NOCHANGE
Ká̠ tö́k tabè wa	Ká̠ tö́k tabè wa	NOCHANGE
E' ku̠é̠ki̠ sa' é̠n a̠ wë'stela chak mí̠a̠	E' ku̠é̠ki̠ sa' é̠n a̠ wë'stela chak mí̠a̠	NOCHANGE
Ie' tö i à̠ritsèke	Ie' tö i à̠ritsèke	NOCHANGE
Be' tö i i̠ù̠tè	Be' tö i i̠ù̠tè	NOCHANGE
Alà kë̀ ku̠' i̠ú̠k	Alà kë̀ ku̠' i̠ú̠k	NOCHANGE
Wé̠ wa̠ tsiru' kalö̀ tso' e' ta̠ e' wa̠	Wé̠ wa̠ tsiru' kalö̀ tso' e' ta̠ e' wa̠	NOCHANGE
Dìwö dé ma̠ñà̠t ta̠ ie' dawówa̠	Dìwö dé ma̠ñà̠t ta̠ ie' dawówa̠	NOCHANGE
Ie' tö i kuè	Ie' tö i kuè	NOCHANGE
I ku̠é̠ki̠ sa' dör chè í̠e̠ coroma i ku̠é̠ki̠	I ku̠é̠ki̠ sa' dör chè í̠e̠ coroma i ku̠é̠ki̠	NOCHANGE
Ye' tö i kuátkèke	Ye' tö i kuátkèke	NOCHANGE
Dabòptökicha	Dabòptökicha	NOCHANGE
Be' tö i kè	Be' tö i kè	NOCHANGE
Kàpi yök	Kàpi yök	NOCHANGE
Yë́ria dör su̠lì̠ ajkö̀ië'	Yë́ria dör su̠lì̠ ajkö̀ië'	NOCHANGE
Ye' tö i batörèke	Ye' tö i batörèke	NOCHANGE
I kínú̠	I kínú̠	NOCHANGE
Ye' e̠' yawö̀ke	Ye' e̠' yawö̀ke	NOCHANGE
I ujtéwa̠ irir	I ujtéwa̠ irir	NOCHANGE
Ye' è̠rke	Ye' è̠rke	NOCHANGE
E's dayë̀ yö̀ne̠	E's dayë̀ yö̀ne̠	NOCHANGE
Tkabë̀ ye' kuéwa̠ e̠'rök	Tkabë̀ ye' kuéwa̠ e̠'rök	NOCHANGE
Ta̠ wè̠s ie' dë	Ta̠ wè̠s ie' dë	NOCHANGE
I chö́	I chö́	NOCHANGE
Ye' chkö̀ke	Ye' chkö̀ke	NOCHANGE
Ie' tö i yèke	Ie' tö i yèke	NOCHANGE
Ie' tsö̀ke	Ie' tsö̀ke	NOCHANGE
Kë̀ be' ichè e' ta̠ ie' se' skétsa̠ a̠	Kë̀ be' ichè e' ta̠ ie' se' skétsa̠ a̠	NOCHANGE
Be' tö i akuö̀wè̠ke	Be' tö i akuö̀wè̠ke	NOCHANGE
Ie' tö i tkè	Ie' tö i tkè	NOCHANGE
Kièke̠ balë'këkëpa sa̠mé̠	Kièke̠ balë'këkëpa sa̠mé̠	NOCHANGE
Sarúlsarul	Sarúlsarul	NOCHANGE
E' tso' ie'pa wa̠ ka̠nè̠balo ie i tsítsipa yawó ie	E' tso' ie'pa wa̠ ka̠nè̠balo ie i tsítsipa yawó ie	NOCHANGE
Ta̠ ie' sibìkuke̠ ie' ujtè bö̀tökicha ie' sibìku̠ke̠	Ta̠ ie' sibìkuke̠ ie' ujtè bö̀tökicha ie' sibìku̠ke̠	NOCHANGE
Kàl ták	Kàl ták	NOCHANGE
Dabòm tkë́yök	Dabòm tkë́yök	NOCHANGE
Ichàko ie	Ichàko ie	NOCHANGE
Ka̠ñí̠k a̠	Ka̠ñí̠k a̠	NOCHANGE
E' tulèke̠wa̠	E' tulèke̠wa̠	NOCHANGE
Ye'r ni̠mà̠ sulúsi shù̠búts	Ye'r ni̠mà̠ sulúsi shù̠búts	NOCHANGE
Ie' chkö̀	Ie' chkö̀	NOCHANGE
Be' kapö̀kewa̠	Be' kapö̀kewa̠	NOCHANGE
Dabòm èyök kí̠ èköl	Dabòm èyök kí̠ èköl	NOCHANGE
Ie' tso' siwö' ajkàchök	Ie' tso' siwö' ajkàchök	NOCHANGE
E' ku̠é̠ki̠ e' ka' e' ajkö́nu̠k se' ka' wébalök se' ka'	E' ku̠é̠ki̠ e' ka' e' ajkö́nu̠k se' ka' wébalök se' ka'	NOCHANGE
Be' tö i kièke	Be' tö i kièke	NOCHANGE
Ye' tö i kè	Ye' tö i kè	NOCHANGE
I kí̠ kió ie	I kí̠ kió ie	NOCHANGE
Ie' tö i kàchèke	Ie' tö i kàchèke	NOCHANGE
E's i yawèke̠	E's i yawèke̠	NOCHANGE
Ba é̠nú̠	Ba é̠nú̠	NOCHANGE
Ta̠ ie' ki̠ ká̠ tawìna̠ ie' dé e' ta̠ ie' ki̠ ká̠ tawìna̠ ta̠	Ta̠ ie' ki̠ ká̠ tawìna̠ ie' dé e' ta̠ ie' ki̠ ká̠ tawìna̠ ta̠	NOCHANGE
I i̠ù̠tö́	I i̠ù̠tö́	NOCHANGE
Dabòm tèryök	Dabòm tèryök	NOCHANGE
Ye' tö i yawèke	Ye' tö i yawèke	NOCHANGE
E̠' ie'pa balë'kë́këpa ká̠ pàkö̀ke̠	E̠' ie'pa balë'kë́këpa ká̠ pàkö̀ke̠	NOCHANGE
E' yawèke̠ne̠ balo'ie	E' yawèke̠ne̠ balo'ie	NOCHANGE
Ye' inù̠ke	Ye' inù̠ke	NOCHANGE
Dabòm bö̀yök kí̠ ské̠l	Dabòm bö̀yök kí̠ ské̠l	NOCHANGE
Ye' tö i síwè̠ke	Ye' tö i síwè̠ke	NOCHANGE
I ké̠bata a̠ se' déka̠ ë́	I ké̠bata a̠ se' déka̠ ë́	NOCHANGE
Sa' kalötö̀mi̠	Sa' kalötö̀mi̠	NOCHANGE
Ye' a̠ ta̠ e' e's irir	Ye' a̠ ta̠ e' e's irir	NOCHANGE
Ie' è̠rke	Ie' è̠rke	NOCHANGE
U̠jú̠!	U̠jú̠!	NOCHANGE
Ù̠ tsée	Ù̠ tsée	NOCHANGE
Ie' tö i shkè̠wè̠ke	Ie' tö i shkè̠wè̠ke	NOCHANGE
Be' tö i shkè̠wè̠	Be' tö i shkè̠wè̠	NOCHANGE
Kapówé̠tsa̠	Kapówé̠tsa̠	NOCHANGE
Wè̠s ie' i dawè klö́o̠	Wè̠s ie' i dawè klö́o̠	NOCHANGE
E' ta̠	E' ta̠	NOCHANGE
Ie' tö i kuèke	Ie' tö i kuèke	NOCHANGE
Kë̀ i yawèi̠a̠ kë̀ i ta̠'i̠a̠	Kë̀ i yawèi̠a̠ kë̀ i ta̠'i̠a̠	NOCHANGE
Ye' tö i tsirìwè̠ke	Ye' tö i tsirìwè̠ke	NOCHANGE
Se' kapö́li	Se' kapö́li	NOCHANGE
Pero a' i yawé ta̠	Pero a' i yawé ta̠	NOCHANGE
Ká̠ i̠â̠i̠â̠ e'r kë̀ ye' wa̠ e' sù̠ne̠i̠a̠	Ká̠ i̠â̠i̠â̠ e'r kë̀ ye' wa̠ e' sù̠ne̠i̠a̠	NOCHANGE
Ma̠ ma̠ í̠ma̠ i yilíwöla si̠à̠la e' ë̀ à̠ta̠ se' wák a̠	Ma̠ ma̠ í̠ma̠ i yilíwöla si̠à̠la e' ë̀ à̠ta̠ se' wák a̠	NOCHANGE
I i̠ù̠tö́	I i̠ù̠tö́	NOCHANGE
Ajkö́kicha yö́k se' mi̠'ke̠	Ajkö́kicha yö́k se' mi̠'ke̠	NOCHANGE
Kö̀chi chakà	Kö̀chi chakà	NOCHANGE
Be' tö i ñè̠ke	Be' tö i ñè̠ke	NOCHANGE
E̠' yawö̀kbalapa tsée	E̠' yawö̀kbalapa tsée	NOCHANGE
U̠jú̠ bitséitsèke̠	U̠jú̠ bitséitsèke̠	NOCHANGE
I ujtèwa̠ e's bitséitsèke̠ dör ká̠ pàköl	I ujtèwa̠ e's bitséitsèke̠ dör ká̠ pàköl	NOCHANGE
Be' tö i wè	Be' tö i wè	NOCHANGE
Ie' dé	Ie' dé	NOCHANGE
Tkabë̀ tso' iku̠á̠ki̠ iku̠á̠ki̠	Tkabë̀ tso' iku̠á̠ki̠ iku̠á̠ki̠	NOCHANGE
Chèke̠mi̠ne̠ e's	Chèke̠mi̠ne̠ e's	NOCHANGE
E's e's se' mí̠tse̠n ie' wa̠ e'tökicha ë̀	E's e's se' mí̠tse̠n ie' wa̠ e'tökicha ë̀	NOCHANGE
Ie' tö i kiè	Ie' tö i kiè	NOCHANGE
Kë̀ ye'r i tkìnu̠k	Kë̀ ye'r i tkìnu̠k	NOCHANGE
Ye' tö i yulèke	Ye' tö i yulèke	NOCHANGE
Ma̠ na̠ù̠	Ma̠ na̠ù̠	NOCHANGE
Ka̠nè̠u̠k	Ka̠nè̠u̠k	NOCHANGE
Ie' ttö̀	Ie' ttö̀	NOCHANGE
Ye' e̠' chö̀kea̠t	Ye' e̠' chö̀kea̠t	NOCHANGE
Be' tö i akuö̀wè̠ke	Be' tö i akuö̀wè̠ke	NOCHANGE
Ye' tö i mo̠wè̠	Ye' tö i mo̠wè̠	NOCHANGE
Kó̠jke̠	Kó̠jke̠	NOCHANGE
Ie' é̠rke	Ie' é̠rke	NOCHANGE
Kë̀ ba akálök ye' ta̠!	Kë̀ ba akálök ye' ta̠!	NOCHANGE
Be' tö i ka̠nè̠wè̠ke	Be' tö i ka̠nè̠wè̠ke	NOCHANGE
I síú̠	I síú̠	NOCHANGE
Sakuè bua' ë̀ e̠ be' mí̠tke bö i tsè ù pàkök	Sakuè bua' ë̀ e̠ be' mí̠tke bö i tsè ù pàkök	NOCHANGE
Ie' e̠' yawö̀ke	Ie' e̠' yawö̀ke	NOCHANGE
Pàktökicha	Pàktökicha	NOCHANGE
Ye' tö i yèke	Ye' tö i yèke	NOCHANGE
Ùshikalök	Ùshikalök	NOCHANGE
Dù kièke̠ kù e' ku̠è̠ sö	Dù kièke̠ kù e' ku̠è̠ sö	NOCHANGE
Balë'kë́këpa rö i ka̠nè̠wé̠	Balë'kë́këpa rö i ka̠nè̠wé̠	NOCHANGE
