Ha’e ombojára kuri mbovy apekuéra ama oikomi ka’aguy hovy’ûvare	Che ambojára kuri mbovy apekuéra che aikomi ka’aguy hovy’ûvare	PERSON:1_SI
Ha’e oguapy ha’e ombojára kuri mbovy apekuéra	Ha’e ndoguapýi ha’e ndombojárai kuri mbovy apekuéra	TYPE:NEG
Ha’e ojupi kuri ha’e ombojerekuri umi kutuhakuéra poro’o	Nde rejupi kuri nde rembojerekuri umi kutuhakuéra tuicháva	PERSON:2_SI
Peẽ napejapómi ogyke pokã che rasy	Ore norojapómi ogyke pokã ore rorasy	PERSON:1_PL_EXC
Ñeñemitỹko maymáva ndaha’ei nemba’erã.	Ñeñemitỹko maymáva ndaha’ei nemba’erã.	NOCHANGE
Oipuru hikuái ka’a ha ho’u terere. che mba’éma ko ykua	Oipuruta hikuái ka’a ha ho’uta terere. che mba’éta ko ykua	TENSE:FUT_SIM
Che rasy ha’e oguapy	Peê penderasy peẽ peguapy	PERSON:2_PL
Ko peteĩ osẽ háichama osẽva.	Ko peteĩ osẽ háichama osẽva.	NOCHANGE
Mombe’ukuéra omboty kuri pende arete ore temimbo’e tie’ỹ ojapopami	Mombe’ukuéra ndombotyi kuri pende arete ore temimbo’e tie’ỹ nojapopami	TYPE:NEG
Ojehechakuaa heta mba’e iporãva.	Ojehechakuaa heta mba’e iporãva.	NOCHANGE
Ha’e ojupi kuri apurahéi kuri	Ha’e ojupi kuri hína apurahéihina kuri	ASPECT:IPFV
Oipuru hikuái ka’a ha ho’u terere. pakova roguépe omo’â hembi’ukuéra.	Nde reipuru ka’a ha re’u terere. pakova roguépe remo’â nderembi’ukuéra.	PERSON:2_SI
Ñaimo’ã’ỹva’erã	Ñaimo’ã’ỹva’erã	NOCHANGE
Ñande ko ñande	Ñande ko ñande	NOCHANGE
Nahániri. ndachéiko. oñembojánteko che rehe.	Nahániri. ndachéiko. oñembojánteko che rehe.	NOCHANGE
Oipuru hikuái ka’a ha ho’u terere. che ajavými iñeikotevẽva akuápe	Ndoipurui hikuái ka’a térã ho’u terere. che ndajavýimi iñeikotevẽva akuápe	TYPE:NEG
Ha’e ndombojaruita he’i ka’i ruvicha ta’ýra kuérape	Nde nderembojarui mo’ãi nde, ka’i ruvicha ere nde ta’yrakuérape	PERSON:2_SI
Temirendukuéra omongakuaa ore temimbo’e tie’ỹ ojapopami	Temirendukuéra omongakuaata ore temimbo’e tie’ỹ ojapopata	TENSE:FUT_SIM
Ñanderesaraivóve ñandehegui, jajapo mba’ekuéra momba’eguasurã ha mandu’arãpy	Ñanderesaraivóve ñandehegui, jajapo mba’ekuéra momba’eguasurã ha mandu’arãpy	NOCHANGE
Ha’e nombotujaimi che ogyke - ha’e ndombyaimi che ogyke pohanohára akãguapy ndombovuta	Ha’e ndombotujaikuri hina che ogyke - ha’e ndombyaikuri hina che ogyke pohanohára akãguapy ndombovúi kuri	TENSE:PAS_REC
He’i ka’i ruvicha ta’ýra kuérape pakova roguépe omo’â hembi’ukuéra.	Nde, ka’i ruvicha ere nde ta’yrakuérape pakova roguépe remo’â nderembi’ukuéra.	PERSON:2_SI
Tahachi rekópe.	Tahachi rekópe.	NOCHANGE
Che mba’éma ko ykua che ajavými iñeikotevẽva akuápe	Che mba’éta ko ykua che ajavýta iñeikotevẽva akuápe	TENSE:FUT_SIM
Apurahéi kuri ku mbói oñorairõ	Ndapurahéi kuri ku mbói noñorairõi	TYPE:NEG
Ha’ekuéra naiñemoñaréi kuri che nañemoingeta	Ha’ekuéra ndoñemoñaréi che nañemoingei	TENSE:PRE_SIM
Ku mbói oñorairõ ha’e ojupi kuri	Ku mbói oñorairõ hína ha’e ojupi kuri hína	ASPECT:IPFV
Ndaipokuaái ipore’ỹ.	Ndaipokuaái ipore’ỹ.	NOCHANGE
Apurahéi kuri nde nderemoheñói	Ha’ekuéra opurahéikuri ha’ekuéra ndomoheñoi	PERSON:3_PL
Ha’ekuéra naiñemoñaréi kuri chéngo ndaikuaái upévape.	Ha’ekuéra oñemoñaréi kuri chéngo aikuaá upévape.	TYPE:AFF
Ku mbói oñorairõ ha’ekuéra naiñemoñaréi kuri	Ku mbói oñorairõta ha’ekuéra naiñemoñaréita	TENSE:FUT_SIM
Che rasy ha’e ombojerekuri umi kutuhakuéra poro’o	Che rasypota hina ha’e ombojerehina kuri umi kutuhakuéra tuicháva	ASPECT:IPFV
Upe riremínte oguahẽ tujami ra’ykuéra ha ohechakuaávo hikuái mávapa itúva jukahare, oñondivepa osẽ omuña ha ojuka hikuái chavukúpe.	Upe riremínte oguahẽ tujami ra’ykuéra ha ohechakuaávo hikuái mávapa itúva jukahare, oñondivepa osẽ omuña ha ojuka hikuái chavukúpe.	NOCHANGE
Ha’e ojupi kuri okũmbymi hikuái	Ñande jajupi kuri ñande ñakũmbýimi	PERSON:1_PL_INC
Ha’e ojupi kuri ha’e nombotujaimi che ogyke - ha’e ndombyaimi che ogyke	Ñande jajupi kuri ñande ndañambotujáimi che ogyke - ñande ndañambyaimi che ogyke	PERSON:1_PL_INC
Pohanohára akãguapy ndombovuta che nañemoingeta	Pohanohára akãguapy ndombovúi che nañemoingei	TENSE:PRE_SIM
Pohanohára akãguapy ndombovuta ore temimbo’e tie’ỹ ojapopami	Pohanohára akãguapy ndombovúiva’ekue ore temimbo’e tie’ỹ ojapopava’ekue	TENSE:PAS_PLU
Amo ñemuha osapukái kuri ko po ojupi	Amo ñemuha nosapukái kuri ko po ndojupíri	TYPE:NEG
Ha’e ojupi kuri che rasy	Ha’e ndojupirí kuri ndacherásyi	TYPE:NEG
Ñande ypykuéra ojapo mboguaha ha ombohéra yrupê.	Ñande ypykuéra ojapo mboguaha ha ombohéra yrupê.	NOCHANGE
Upe mba’eguasuete	Upe mba’eguasuete	NOCHANGE
Tembipuru ojejapova’ekue	Tembipuru ojejapova’ekue	NOCHANGE
Ore ndorokuave’ẽi umi tembi’ukuéra pytagua temirendukuéra omongakuaa	Ore ndorokuave’ẽimi umi tembi’ukuéra pytagua temirendukuéra omongakuaami	TENSE:PAS_IMP
Che sýpente ndaipotái remombe’u pa’i.	Che sýpente ndaipotái remombe’u pa’i.	NOCHANGE
Temirendukuéra omongakuaa ko mombe’upy ohenduká kuri chéve che ru.	Temirendukuéra ndomongakuaai ko mombe’upy ndohenduká kuri chéve che ru.	TYPE:NEG
Nda’ipóri avaréicha ohayhúva yvypóra	Nda’ipóri avaréicha ohayhúva yvypóra	NOCHANGE
He’iséva akâjere ñembotakuére térâ ambue mba’ére.	He’iséva akâjere ñembotakuére térâ ambue mba’ére.	NOCHANGE
Ha’e ombojerekuri umi kutuhakuéra poro’o apurahéi kuri	Ha’e ombojerehina kuri umi kutuhakuéra tuicháva apurahéihina kuri	ASPECT:IPFV
Jaguarete katu itáicha okirirĩ. upérö (che) añani hína kuri	Nde katu itáicha rekirirĩ. upérõ (nde) reñanihínakuri	PERSON:2_SI
Jaguarete katu itáicha okirirĩ. che mba’éma ko ykua	Jaguarete katu itáicha ndokirirĩ. ndachemba’ei ko ykua	TYPE:NEG
Che mba’éma ko ykua oipuru hikuái ka’a ha ho’u terere.	Che mba’éta ko ykua oipuruta hikuái ka’a ha ho’uta terere.	TENSE:FUT_SIM
He’i ka’i ruvicha ta’ýra kuérape okũmbymi hikuái	He’i ka’i ruvicha ita’ýrakuérape ndokũmbýimi hikuái	TYPE:NEG
Temirendukuéra omongakuaa ha’e ndombojaruita	Temirendukuéra omongakuaa hína ha’e ndombojaruita hína	ASPECT:IPFV
Ha ndaipóri imbojojaha.	Ha ndaipóri imbojojaha.	NOCHANGE
Ko mombe’upy ohenduká kuri chéve che ru. ha’ekuéra naiñemoñaréi kuri	Ko mombe’upy ohendukáta chéve che ru. ha’ekuéra naiñemoñaréita	TENSE:FUT_SIM
Che mba’éma ko ykua jaguarete katu itáicha okirirĩ.	Nde mba’e ko ykua nde katu itáicha rekirirĩ.	PERSON:2_SI
Norohepyme’ẽi nde mba’ekuaarã ñandutiguávape jeike. kyta.	Norohepyme’ẽi nde mba’ekuaarã ñandutiguávape jeike. kyta.	NOCHANGE
Pakova roguépe omo’â hembi’ukuéra. che rasy	Pakova roguépe pemo’â penderembi’ukuéra. peê penderasy	PERSON:2_PL
Ha’e ombojára kuri mbovy apekuéra che rasy	Ha’e ombojára kuri hína mbovy apekuéra che rasypota hina	ASPECT:IPFV
Che rasy oipuru hikuái ka’a ha ho’u terere.	Nde nderasy nde reipuru ka’a ha re’u terere.	PERSON:2_SI
Okũmbymi hikuái ha’e ndombojaruita	Okũmby kuri hikuái. ha’e ndombojarui kuri	TENSE:PAS_REC
Pyhare, ku ijapyra’ỹva	Pyhare, ku ijapyra’ỹva	NOCHANGE
Ombohory nde sýpe ne ñe’ê.	Ombohory nde sýpe ne ñe’ê.	NOCHANGE
Oipuru hikuái ka’a ha ho’u terere. che rasy	Ñande jaipuru ka’a ha ja’u terere. ñande rasy	PERSON:1_PL_INC
Apurahéi kuri oipuru hikuái ka’a ha ho’u terere.	Ndapurahéi kuri ndoipurui hikuái ka’a térã ho’u terere.	TYPE:NEG
Pakova roguépe omo’â hembi’ukuéra. ha’e ombojerekuri umi kutuhakuéra poro’o	Pakova roguépe ndomo’âi hembi’ukuéra. ha’e ndombojereikuri umi kutuhakuéra tuicháva	TYPE:NEG
Nde reñembosarái hína chéngo ndaikuaái upévape.	Nde reñembosarái kuri hína chéngo ndaikuaái kuri hina upévape.	TENSE:PAS_REC
Mba’asykuérape guarâ.	Mba’asykuérape guarâ.	NOCHANGE
Ndaipóri mba’eve re’aguyjeveme’ê hagua.	Ndaipóri mba’eve re’aguyjeveme’ê hagua.	NOCHANGE
Mombe’ukuéra omboty kuri pende arete temirendukuéra omongakuaa	Mombe’ukuéra ombotyta pende arete temirendukuéra omongakuaata	TENSE:FUT_SIM
Ore ndorokuave’ẽi umi tembi’ukuéra pytagua che nañemoingeta	Ore rokuave’ẽ umi tembi’ukuéra pytagua che añemoingeta	TYPE:AFF
Ha’e ndombojaruita ha’e nombotujaimi che ogyke - ha’e ndombyaimi che ogyke	Ha’e ombojaruita ha’e ombotujaimi che ogyke - ha’e ombyaimi che ogyke	TYPE:AFF
Ha’e ojupi kuri ko mombe’upy ohenduká kuri chéve che ru.	Nde rejupi kuri ko mombe’upy emohenduká kuri chéve nde.	PERSON:2_SI
Ha nde tyvyta ku jasy ra’y	Ha nde tyvyta ku jasy ra’y	NOCHANGE
Okũmbymi hikuái nde reñembosarái hína	Ndokũmbýimi hikuái nde nereñembosaráiri hína	TYPE:NEG
Jaguarete katu itáicha okirirĩ. temirendukuéra omongakuaa	Jaguarete katu itáicha okirirĩta. temirendukuéra omongakuaata	TENSE:FUT_SIM
Pohanohára akãguapy ndombovuta che rasy	Pohanohára akãguapy ndombovúiva’ekue che cherasy va’ekue	TENSE:PAS_PLU
I py rei pe o ñembosarái.	I py rei pe o ñembosarái.	NOCHANGE
Okũmbymi hikuái ha’e oguapy	Che akũmbymi che aguapy	PERSON:1_SI
Ha’e nombotujaimi che ogyke - ha’e ndombyaimi che ogyke peẽ napejapómi ogyke pokã	Ñande ndañambotujáimi che ogyke - ñande ndañambyaimi che ogyke ñande najajapómi ogyke pokã	PERSON:1_PL_INC
Tyapu ojoguáva ñe’ẽme.	Tyapu ojoguáva ñe’ẽme.	NOCHANGE
Mombe’ukuéra omboty kuri pende arete ku mbói oñorairõ	Mombe’ukuéra omboty kuri hína pende arete ku mbói oñorairõ hína	ASPECT:IPFV
Peẽ napejapómi ogyke pokã ha’ekuéra naiñemoñaréi kuri	Ñande najajapómi ogyke pokã ñande naiñañemoñaréi kuri	PERSON:1_PL_INC
Ñemenda kuña rehayhúvare ha ha’e nderayhúva, ha’e ñeha’ã hendive jahecha mávapa ohayhu poi raẽve	Ñemenda kuña rehayhúvare ha ha’e nderayhúva, ha’e ñeha’ã hendive jahecha mávapa ohayhu poi raẽve	NOCHANGE
Peẽ napejapómi ogyke pokã ijuru ñeimo’ã’ỹva ndojurata che aovevekuéra - ijuru ñeimo’ã’ỹva ndojuramo’ãi che aovevekuéra	Peẽ napejapói ogyke pokã ijuru ñeimo’ã’ỹva ndojurai che aovevekuéra	TENSE:PRE_SIM
(hetave tera sa’ive yvyramatakuéra)	(hetave tera sa’ive yvyramatakuéra)	NOCHANGE
Che mba’éma ko ykua ha’e ojupi kuri	Che mba’éta ko ykua ha’e ojupita	TENSE:FUT_SIM
Che mba’éma ko ykua jaguarete katu itáicha okirirĩ.	Ndachemba’ei ko ykua jaguarete katu itáicha ndokirirĩ.	TYPE:NEG
. térã yvyra guýpe mymba apytépe	. térã yvyra guýpe mymba apytépe	NOCHANGE
Pe kosereva oñeñongatu areséramo oñemoĩva’erã pype, oñembosako’i aja, hetave asuka ha eira hũ.	Pe kosereva oñeñongatu areséramo oñemoĩva’erã pype, oñembosako’i aja, hetave asuka ha eira hũ.	NOCHANGE
Avyu ha vy’ápe mitã iñapesã	Avyu ha vy’ápe mitã iñapesã	NOCHANGE
Upérö (che) añani hína kuri che rasy	Upérõ (che) añanihínava’ekue che cherasy va’ekue	TENSE:PAS_PLU
(uicn tembiapohára paraguaigua omba’apo ñane retãme)	(uicn tembiapohára paraguaigua omba’apo ñane retãme)	NOCHANGE
Mba’ekuéra jaikuaa porãvéva ha’e umi araka’eve jaikuaapyhyvaekue	Mba’ekuéra jaikuaa porãvéva ha’e umi araka’eve jaikuaapyhyvaekue	NOCHANGE
Ha’e ombojára kuri mbovy apekuéra apurahéi kuri	Ha’e ndombojárai kuri mbovy apekuéra ndapurahéi kuri	TYPE:NEG
Ha’e ojupi kuri oipuru hikuái ka’a ha ho’u terere.	Ñande jajupi kuri ñande jaipuru ka’a ha ja’u terere.	PERSON:1_PL_INC
Ore ndorokuave’ẽi umi tembi’ukuéra pytagua ku mbói oñorairõ	Ore ndorokuave’ẽi ikóni umi tembi’ukuéra pytagua ku mbói oñorairõ ikóni	ASPECT:INM
Ñe’ẽ ha rekotee oñemombareteve	Ñe’ẽ ha rekotee oñemombareteve	NOCHANGE
Ama oikomi ka’aguy hovy’ûvare okũmbymi hikuái	Ama ndoikomi ka’aguy hovy’ûvare ndokũmbýimi hikuái	TYPE:NEG
Ku mbói oñorairõ che mba’éma ko ykua	Ku mbói noñorairõi ndachemba’ei ko ykua	TYPE:NEG
Ombojopyrúva. ouva’ekue oiko paraguaýpe, omoñe’ẽva	Ombojopyrúva. ouva’ekue oiko paraguaýpe, omoñe’ẽva	NOCHANGE
Nde nderemoheñói ha’e nombotujaimi che ogyke - ha’e ndombyaimi che ogyke	Ñande ndañamoheñói ñande ndañambotujáimi che ogyke - ñande ndañambyaimi che ogyke	PERSON:1_PL_INC
Ajopy ajora amboty avañe’ẽme,	Ajopy ajora amboty avañe’ẽme,	NOCHANGE
Che rasy peẽ napejapómi ogyke pokã	Ore rorasy ore norojapómi ogyke pokã	PERSON:1_PL_EXC
Rekávo ka’aguýpe. upépe osê chupe guaikurukuéra, kyhyjepópe oñani pe	Rekávo ka’aguýpe. upépe osê chupe guaikurukuéra, kyhyjepópe oñani pe	NOCHANGE
Topytánte ha’ekuéra	Topytánte ha’ekuéra	NOCHANGE
Nde reñembosarái hína ha’e ombojára kuri mbovy apekuéra	Nde nereñembosaráiri hína ha’e ndombojárai kuri mbovy apekuéra	TYPE:NEG
Ojehaíva, ko’a iguýpe, akýpe guarani ha oejhaíva hovy kângýpe karaiñe’ê.	Ojehaíva, ko’a iguýpe, akýpe guarani ha oejhaíva hovy kângýpe karaiñe’ê.	NOCHANGE
Okũmbymi hikuái apurahéi kuri	Ndokũmbýimi hikuái ndapurahéi kuri	TYPE:NEG
Che rasy ko po ojupi	Ndacherásyi ko po ndojupíri	TYPE:NEG
Chéngo ndaikuaái upévape. jaguarete katu itáicha okirirĩ.	Ndéngo ndereikuaái upévape. nde katu itáicha rekirirĩ.	PERSON:2_SI
Che ajavými iñeikotevẽva akuápe okũmbymi hikuái	Che ajavýta iñeikotevẽva akuápe okũmbyta hikuái.	TENSE:FUT_SIM
Ko po ojupi pakova roguépe omo’â hembi’ukuéra.	Ko po ndojupíri pakova roguépe ndomo’âi hembi’ukuéra.	TYPE:NEG
He’i ka’i ruvicha ta’ýra kuérape apurahéi kuri	He’i ka’i ruvicha ita’ýrakuérape ndapurahéi kuri	TYPE:NEG
Oipuru hikuái ka’a ha ho’u terere. ha’e ombojerekuri umi kutuhakuéra poro’o	Ndoipurui hikuái ka’a térã ho’u terere. ha’e ndombojereikuri umi kutuhakuéra tuicháva	TYPE:NEG
Upéicha avei ñande	Upéicha avei ñande	NOCHANGE
Ñanduti upe guive oñepyrũ omba’apo, opa chugui pe ate’ỹ oguerokóvami ha oipyaha umi mba’e	Ñanduti upe guive oñepyrũ omba’apo, opa chugui pe ate’ỹ oguerokóvami ha oipyaha umi mba’e	NOCHANGE
Ore ndorokuave’ẽi umi tembi’ukuéra pytagua peẽ napejapómi ogyke pokã	Ñande ndañakuave’ẽi umi tembi’ukuéra pytagua ñande najajapómi ogyke pokã	PERSON:1_PL_INC
Ko po ojupi ha’e ombojerekuri umi kutuhakuéra poro’o	Ko po ndojupíri ha’e ndombojereikuri umi kutuhakuéra tuicháva	TYPE:NEG
Ha’ekuéra naiñemoñaréi kuri pohanohára akãguapy ndombovuta	Ha’ekuéra oñemoñaréi kuri pohanohára akãguapy ombovuta	TYPE:AFF
Ha’e oguapy ijuru ñeimo’ã’ỹva ndojurata che aovevekuéra - ijuru ñeimo’ã’ỹva ndojuramo’ãi che aovevekuéra	Ha’e oguapýkuri ijuru ñeimo’ã’ỹva ndojurai kuri che aovevekuéra	TENSE:PAS_REC
Jepiveguáicha oñongatu sapy’arei oujeýrõ omba’ejerure. py’ỹinte niko	Jepiveguáicha oñongatu sapy’arei oujeýrõ omba’ejerure. py’ỹinte niko	NOCHANGE
Ha’e ndombojaruita che nañemoingeta	Nde nderembojarui mo’ãi nde nareñemoingeta	PERSON:2_SI
Temirendukuéra omongakuaa upérö (che) añani hína kuri	Temirendukuéra omongakuaata upérõ (che) añanita hína	TENSE:FUT_SIM
Tupã ñemoñare jeroviapy.	Tupã ñemoñare jeroviapy.	NOCHANGE
Okũmbymi hikuái oipuru hikuái ka’a ha ho’u terere.	Okũmbyta hikuái. oipuruta hikuái ka’a ha ho’uta terere.	TENSE:FUT_SIM
Ayvu rapyta rã i oikuaá ma vy ojeupe,	Ayvu rapyta rã i oikuaá ma vy ojeupe,	NOCHANGE
Jaguarete katu itáicha okirirĩ. amo ñemuha osapukái kuri	Jaguarete katu itáicha okirirĩta. amo ñemuha osapukáita	TENSE:FUT_SIM
Apurahéi kuri okũmbymi hikuái	Ndapurahéi kuri ndokũmbýimi hikuái	TYPE:NEG
Jaguarete katu itáicha okirirĩ. che nañemoingeta	Nde katu itáicha rekirirĩ. nde nareñemoingeta	PERSON:2_SI
Poyvi imara’ỹva	Poyvi imara’ỹva	NOCHANGE
Mba’éicha hesukirito	Mba’éicha hesukirito	NOCHANGE
Oguahẽvo nde ára	Oguahẽvo nde ára	NOCHANGE
Mombe’ukuéra omboty kuri pende arete che mba’éma ko ykua	Mombe’ukuéra ndombotyi kuri pende arete ndachemba’ei ko ykua	TYPE:NEG
Jasypoapy, ava ñe’ê jasy	Jasypoapy, ava ñe’ê jasy	NOCHANGE
Che nañemoingeta ha’e ndombojaruita	Nde nareñemoingeta nde nderembojarui mo’ãi	PERSON:2_SI
Oipuru hikuái ka’a ha ho’u terere. he’i ka’i ruvicha ta’ýra kuérape	Nde reipuru ka’a ha re’u terere. nde, ka’i ruvicha ere nde ta’yrakuérape	PERSON:2_SI
Ha’ekuéra naiñemoñaréi kuri ha’e ojupi kuri	Ñande naiñañemoñaréi kuri ñande jajupi kuri	PERSON:1_PL_INC
Apurahéi kuri ko po ojupi	Apurahéihina kuri ko po ojupíhina	ASPECT:IPFV
Ko mombe’upy ohenduká kuri chéve che ru. ha’e ndombojaruita	Ko mombe’upy emohenduká kuri chéve nde. nde nderembojarui mo’ãi	PERSON:2_SI
Temirendukuéra omongakuaa oipuru hikuái ka’a ha ho’u terere.	Temirendukuéra omongakuaata oipuruta hikuái ka’a ha ho’uta terere.	TENSE:FUT_SIM
Ha’e ojupi kuri ha’ekuéra naiñemoñaréi kuri	Ñande jajupi kuri ñande naiñañemoñaréi kuri	PERSON:1_PL_INC
Ha’e ombojerekuri umi kutuhakuéra poro’o ha’e ndombojaruita	Ha’e ombojerehina kuri umi kutuhakuéra tuicháva ha’e ndombojaruita hína	ASPECT:IPFV
Okũmbymi hikuái ha’e ojupi kuri	Ndokũmbýimi hikuái ha’e ndojupirí kuri	TYPE:NEG
Ha’e ombojerekuri umi kutuhakuéra poro’o ko mombe’upy ohenduká kuri chéve che ru.	Ha’e ndombojereikuri umi kutuhakuéra tuicháva ko mombe’upy ndohenduká kuri chéve che ru.	TYPE:NEG
Mbo’ehára ikatupyryveva’ekue	Mbo’ehára ikatupyryveva’ekue	NOCHANGE
Amo ñemuha osapukái kuri ko mombe’upy ohenduká kuri chéve che ru.	Amo ñemuha nosapukái kuri ko mombe’upy ndohenduká kuri chéve che ru.	TYPE:NEG
Che ajavými iñeikotevẽva akuápe ha’e oguapy	Nde rejavýimi iñeikotevẽva akuápe peẽ peguapy	PERSON:2_PL
Peẽ napejapómi ogyke pokã ijuru ñeimo’ã’ỹva ndojurata che aovevekuéra - ijuru ñeimo’ã’ỹva ndojuramo’ãi che aovevekuéra	Peẽ napejapói kuri ogyke pokã ijuru ñeimo’ã’ỹva ndojurai kuri che aovevekuéra	TENSE:PAS_REC
Ha iñakã porãva.	Ha iñakã porãva.	NOCHANGE
Peẽ napejapómi ogyke pokã upérö (che) añani hína kuri	Peẽ napejapói ogyke pokã upérõ (che) añani hína	TENSE:PRE_SIM
Che ajavými iñeikotevẽva akuápe temirendukuéra omongakuaa	Che ajavýta iñeikotevẽva akuápe temirendukuéra omongakuaata	TENSE:FUT_SIM
Pohanohára akãguapy ndombovuta ha’ekuéra naiñemoñaréi kuri	Pohanohára akãguapy ndombovúi ha’ekuéra ndoñemoñaréi	TENSE:PRE_SIM
Ko po ojupi ore temimbo’e tie’ỹ ojapopami	Ko po ndojupíri ore temimbo’e tie’ỹ nojapopami	TYPE:NEG
Apurahéi kuri ore temimbo’e tie’ỹ ojapopami	Apurahéitta ore temimbo’e tie’ỹ ojapopata	TENSE:FUT_SIM
Ojepyta ha mba’épepa ojeguevi	Ojepyta ha mba’épepa ojeguevi	NOCHANGE
Temirendukuéra omongakuaa ha’e ojupi kuri	Temirendukuéra omongakuaata ha’e ojupita	TENSE:FUT_SIM
He’i ka’i ruvicha ta’ýra kuérape jaguarete katu itáicha okirirĩ.	Che, ka’i ruvicha, ha’e che ta’yrakuérape che katu itáicha akirirĩ.	PERSON:1_SI
Oipytyvõ va’erã abogado oikuaháva mitã ha okakuaháva derecho rehegua, oñepyrũ guive	Oipytyvõ va’erã abogado oikuaháva mitã ha okakuaháva derecho rehegua, oñepyrũ guive	NOCHANGE
Okáguio ojeporu kangue rasýpe guarâ ha mba’asykuéra ñande pire reheguápe.	Okáguio ojeporu kangue rasýpe guarâ ha mba’asykuéra ñande pire reheguápe.	NOCHANGE
Ha’e oguapy temirendukuéra omongakuaa	Ha’e ndoguapýi temirendukuéra ndomongakuaai	TYPE:NEG
Temirendukuéra omongakuaa ko po ojupi	Temirendukuéra ndomongakuaai ko po ndojupíri	TYPE:NEG
Ku mbói oñorairõ ore temimbo’e tie’ỹ ojapopami	Umi mbóikuera oñorairõ ore temimbo’ekuéra tie’ỹ ojapopami	PERSON:3_PL
Amo ñemuha osapukái kuri apurahéi kuri	Amo ñemuha osapukáita apurahéitta	TENSE:FUT_SIM
Mba’apo araka’eve ndojapoiva’erã tembiguái avavégui.	Mba’apo araka’eve ndojapoiva’erã tembiguái avavégui.	NOCHANGE
Che rasy pakova roguépe omo’â hembi’ukuéra.	Peê penderasy pakova roguépe pemo’â penderembi’ukuéra.	PERSON:2_PL
Ndaha’éiva hesegua.	Ndaha’éiva hesegua.	NOCHANGE
Ña’e chararã, mbohyapuha - pires.	Ña’e chararã, mbohyapuha - pires.	NOCHANGE
Ama oikomi ka’aguy hovy’ûvare ijuru ñeimo’ã’ỹva ndojurata che aovevekuéra - ijuru ñeimo’ã’ỹva ndojuramo’ãi che aovevekuéra	Ama oiko ka’aguy hovy’ûvare ijuru ñeimo’ã’ỹva ndojurai che aovevekuéra	TENSE:PRE_SIM
Nde nderejapói ore ndorokuave’ẽi umi tembi’ukuéra pytagua	Nde rejapo ore rokuave’ẽ umi tembi’ukuéra pytagua	TYPE:AFF
Upégui osêha pe jeiko porãve opa tetãme.	Upégui osêha pe jeiko porãve opa tetãme.	NOCHANGE
Ha’e ojupi kuri ha’e ndombojaruita	Ha’e ojupi kuri hína ha’e ndombojaruita hína	ASPECT:IPFV
Ama oikomi ka’aguy hovy’ûvare pohanohára akãguapy ndombovuta	Ama oiko ka’aguy hovy’ûvare pohanohára akãguapy ndombovúi	TENSE:PRE_SIM
Jaikovéva ára ha ára	Jaikovéva ára ha ára	NOCHANGE
Apurahéi kuri ha’e ombojára kuri mbovy apekuéra	Apurahéitta ha’e ombojárata mbovy apekuéra	TENSE:FUT_SIM
Amo ñemuha osapukái kuri che mba’éma ko ykua	Amo ñemuha nosapukái kuri ndachemba’ei ko ykua	TYPE:NEG
Ñande ypykuéra ka’aguygua ojesarekóva iñe’ê rehe.	Ñande ypykuéra ka’aguygua ojesarekóva iñe’ê rehe.	NOCHANGE
Añemboheko guaraní ñe’ẽme	Añemboheko guaraní ñe’ẽme	NOCHANGE
Nde nderemoheñói nde nderejapói	Ha’ekuéra ndomoheñoi ha’ekuéra ndojapói	PERSON:3_PL
Pohanohára akãguapy ndombovuta ore ndorokuave’ẽi umi tembi’ukuéra pytagua	Pohanohára akãguapy ombovuta ore rokuave’ẽ umi tembi’ukuéra pytagua	TYPE:AFF
Ko mombe’upy ohenduká kuri chéve che ru. upérö (che) añani hína kuri	Ko mombe’upy ohenduka chéve che ru. upérõ (che) añani hína	TENSE:PRE_SIM
Ore temimbo’e tie’ỹ ojapopami ha’e oguapy	Ore temimbo’e tie’ỹ ojapopava’ekue ha’e oguapýva’ekue	TENSE:PAS_PLU
Ore temimbo’e tie’ỹ ojapopami che mba’éma ko ykua	Ore temimbo’e tie’ỹ nojapopami ndachemba’ei ko ykua	TYPE:NEG
Che mba’éma ko ykua ha’e ombojára kuri mbovy apekuéra	Ndachemba’ei ko ykua ha’e ndombojárai kuri mbovy apekuéra	TYPE:NEG
Upérö (che) añani hína kuri ha’ekuéra naiñemoñaréi kuri	Upérõ (che) añani hína ha’ekuéra ndoñemoñaréi	TENSE:PRE_SIM
Ñane retãnguérare, ikatu haguã oñemopu’ã mbarete pe jopói ha	Ñane retãnguérare, ikatu haguã oñemopu’ã mbarete pe jopói ha	NOCHANGE
Ha ani orerejátei roñepy’ara’ã	Ha ani orerejátei roñepy’ara’ã	NOCHANGE
Pakova roguépe omo’â hembi’ukuéra. chéngo ndaikuaái upévape.	Pakova roguépe remo’â nderembi’ukuéra. ndéngo ndereikuaái upévape.	PERSON:2_SI
Che rasy ha’e nombotujaimi che ogyke - ha’e ndombyaimi che ogyke	Che cherasy kuri ha’e ndombotujaikuri hina che ogyke - ha’e ndombyaikuri hina che ogyke	TENSE:PAS_REC
Ko arapy kuápe.	Ko arapy kuápe.	NOCHANGE
Tekopykuaa apopýpe, ohupyty haguã ko’ã mba’e.	Tekopykuaa apopýpe, ohupyty haguã ko’ã mba’e.	NOCHANGE
(mba’apo ha ñeipytyvõ panamá pe)	(mba’apo ha ñeipytyvõ panamá pe)	NOCHANGE
Ko mombe’upy ohenduká kuri chéve che ru. ama oikomi ka’aguy hovy’ûvare	Ko mombe’upy ndohenduká kuri chéve che ru. ama ndoikomi ka’aguy hovy’ûvare	TYPE:NEG
(mba’e vai itenonde haguâ tekotevênte yvyporakuéra hekokatúva ndojapói mba’eve).	(mba’e vai itenonde haguâ tekotevênte yvyporakuéra hekokatúva ndojapói mba’eve).	NOCHANGE
Pakova roguépe omo’â hembi’ukuéra. che rasy	Pakova roguépe remo’â nderembi’ukuéra. nde nderasy	PERSON:2_SI
Y ñe’ẽ opararã ohasávo yvykuáre	Y ñe’ẽ opararã ohasávo yvykuáre	NOCHANGE
Nde nderejapói ha’e nombotujaimi che ogyke - ha’e ndombyaimi che ogyke	Nde rejapo ha’e ombotujaimi che ogyke - ha’e ombyaimi che ogyke	TYPE:AFF
Ko mombe’upy ohenduká kuri chéve che ru. mombe’ukuéra omboty kuri pende arete	Ko mombe’upy ohendukáta chéve che ru. mombe’ukuéra ombotyta pende arete	TENSE:FUT_SIM
Ore temimbo’e tie’ỹ ojapopami che ajavými iñeikotevẽva akuápe	Ore temimbo’e tie’ỹ nojapopami che ndajavýimi iñeikotevẽva akuápe	TYPE:NEG
Peẽ napejapómi ogyke pokã ha’e ombojára kuri mbovy apekuéra	Nde nderejapómi ogyke pokã nde rembojára kuri mbovy apekuéra	PERSON:2_SI
Ha’e ndombojaruita ko po ojupi	Ha’e ndombojaruita hína ko po ojupíhina	ASPECT:IPFV
Tavaguasu ojeaho’i reboso ñembyasýpe ha itindy, okirirĩ. ha’ete ku hasẽva kirirĩháme, tesay’ỹme. ikatu te’onguety voi ra’e.	Tavaguasu ojeaho’i reboso ñembyasýpe ha itindy, okirirĩ. ha’ete ku hasẽva kirirĩháme, tesay’ỹme. ikatu te’onguety voi ra’e.	NOCHANGE
Ha’e kuéra oguereko tembi’u ramo,	Ha’e kuéra oguereko tembi’u ramo,	NOCHANGE
Che rasy apurahéi kuri	Che rasypota hina apurahéihina kuri	ASPECT:IPFV
Che mba’éma ko ykua ku mbói oñorairõ	Ndachemba’ei ko ykua ku mbói noñorairõi	TYPE:NEG
Mombe’ukuéra omboty kuri pende arete ha’e nombotujaimi che ogyke - ha’e ndombyaimi che ogyke	Mombe’ukuéra ombotyta pende arete ha’e ombotujáta che ogyke - ha’e ombyaíta che ogyke	TENSE:FUT_SIM
Che mba’éma ko ykua oipuru hikuái ka’a ha ho’u terere.	Nde mba’e ko ykua nde reipuru ka’a ha re’u terere.	PERSON:2_SI
Ñande rape pyahurã.	Ñande rape pyahurã.	NOCHANGE
Ha’eva’erãmo’ãkuri peteĩ katupyry mbarete	Ha’eva’erãmo’ãkuri peteĩ katupyry mbarete	NOCHANGE
Ama oikomi ka’aguy hovy’ûvare ha’e oguapy	Che aikomi ka’aguy hovy’ûvare che aguapy	PERSON:1_SI
Pakova roguépe omo’â hembi’ukuéra. okũmbymi hikuái	Pakova roguépe ndomo’âi hembi’ukuéra. ndokũmbýimi hikuái	TYPE:NEG
Peteĩ ára ndaje vichokuéra oñomboaty hikuái ka’aguýpe. ha’e oñomongetase ha ombosako’i haguã peteĩ ñani guasu.	Peteĩ ára ndaje vichokuéra oñomboaty hikuái ka’aguýpe. ha’e oñomongetase ha ombosako’i haguã peteĩ ñani guasu.	NOCHANGE
Temirendukuéra omongakuaa amo ñemuha osapukái kuri	Temirendukuéra omongakuaata amo ñemuha osapukáita	TENSE:FUT_SIM
Mombe’ukuéra omboty kuri pende arete amo ñemuha osapukái kuri	Mombe’ukuéra ndombotyi kuri pende arete amo ñemuha nosapukái kuri	TYPE:NEG
Omimbi nomimbipáiva kuarahy rata omo’ã,	Omimbi nomimbipáiva kuarahy rata omo’ã,	NOCHANGE
Che rasy he’i ka’i ruvicha ta’ýra kuérape	Nde nderasy nde, ka’i ruvicha ere nde ta’yrakuérape	PERSON:2_SI
Che mba’éma ko ykua ko po ojupi	Che mba’éta ko ykua ko po ojupíta	TENSE:FUT_SIM
Mombe’ukuéra omboty kuri pende arete ha’e ombojerekuri umi kutuhakuéra poro’o	Mombe’ukuéra omboty kuri hína pende arete ha’e ombojerehina kuri umi kutuhakuéra tuicháva	ASPECT:IPFV
He’i ka’i ruvicha ta’ýra kuérape ko mombe’upy ohenduká kuri chéve che ru.	Nde, ka’i ruvicha ere nde ta’yrakuérape ko mombe’upy emohenduká kuri chéve nde.	PERSON:2_SI
Peẽ napejapómi ogyke pokã ha’e nombotujaimi che ogyke - ha’e ndombyaimi che ogyke	Peẽ napejapói kuri ogyke pokã ha’e ndombotujaikuri hina che ogyke - ha’e ndombyaikuri hina che ogyke	TENSE:PAS_REC
Ojupe peñomombarete va’erã	Ojupe peñomombarete va’erã	NOCHANGE
Ndaha’éi itavýva ñe’ẽ che ñe’ẽ porãite,	Ndaha’éi itavýva ñe’ẽ che ñe’ẽ porãite,	NOCHANGE
Ore temimbo’e tie’ỹ ojapopami ha’e ojupi kuri	Ore temimbo’e tie’ỹ nojapopami ha’e ndojupirí kuri	TYPE:NEG
Ore táva rérape roiméva ha ore táva pu’aka roguerekóva,	Ore táva rérape roiméva ha ore táva pu’aka roguerekóva,	NOCHANGE
Pohanohára akãguapy ndombovuta che ajavými iñeikotevẽva akuápe	Pohanohára akãguapy ndombovúi che ajavy iñeikotevẽva akuápe	TENSE:PRE_SIM
Ñande rekove.	Ñande rekove.	NOCHANGE
Ha upéi ñande paraguái	Ha upéi ñande paraguái	NOCHANGE
Ha’e ojupi kuri temirendukuéra omongakuaa	Ha’e ojupita temirendukuéra omongakuaata	TENSE:FUT_SIM
Che mba’éma ko ykua ha’e oguapy	Ndachemba’ei ko ykua ha’e ndoguapýi	TYPE:NEG
Mombe’ukuéra omboty kuri pende arete oipuru hikuái ka’a ha ho’u terere.	Mombe’ukuéra ndombotyi kuri pende arete ndoipurui hikuái ka’a térã ho’u terere.	TYPE:NEG
Ko po ojupi amo ñemuha osapukái kuri	Ko po ojupíta amo ñemuha osapukáita	TENSE:FUT_SIM
Temirendukuéra omongakuaa ama oikomi ka’aguy hovy’ûvare	Temirendukuéra ndomongakuaai ama ndoikomi ka’aguy hovy’ûvare	TYPE:NEG
Ha’e oguapy chéngo ndaikuaái upévape.	Nde reguapy ndéngo ndereikuaái upévape.	PERSON:2_SI
Apurahéi kuri ama oikomi ka’aguy hovy’ûvare	Ndapurahéi kuri ama ndoikomi ka’aguy hovy’ûvare	TYPE:NEG
Che ajavými iñeikotevẽva akuápe ko mombe’upy ohenduká kuri chéve che ru.	Che ajavy iñeikotevẽva akuápe ko mombe’upy ohenduka chéve che ru.	TENSE:PRE_SIM
Jaguarete katu itáicha okirirĩ. apurahéi kuri	Jaguarete katu itáicha okirirĩta. apurahéitta	TENSE:FUT_SIM
Avei topopo umi ñe’ẽ topo toikove	Avei topopo umi ñe’ẽ topo toikove	NOCHANGE
Ñe’ẽñemi ñangarekoha	Ñe’ẽñemi ñangarekoha	NOCHANGE
Ojepuru sa’y pytãngy péva ha’égui kuña sa’y ko yvóra tuichakue javeve.	Ojepuru sa’y pytãngy péva ha’égui kuña sa’y ko yvóra tuichakue javeve.	NOCHANGE
Ha’e ombojerekuri umi kutuhakuéra poro’o jaguarete katu itáicha okirirĩ.	Nde rembojerekuri umi kutuhakuéra tuicháva nde katu itáicha rekirirĩ.	PERSON:2_SI
Hagua omanóvape), hembipurukuéra yvy, ita ha kanguégui ijapopyréva.	Hagua omanóvape), hembipurukuéra yvy, ita ha kanguégui ijapopyréva.	NOCHANGE
Ha’ekuéra naiñemoñaréi kuri pohanohára akãguapy ndombovuta	Ha’ekuéra ndoñemoñaréi pohanohára akãguapy ndombovúi	TENSE:PRE_SIM
Pakova roguépe omo’â hembi’ukuéra. he’i ka’i ruvicha ta’ýra kuérape	Pakova roguépe remo’â nderembi’ukuéra. nde, ka’i ruvicha ere nde ta’yrakuérape	PERSON:2_SI
Mombe’ukuéra omboty kuri pende arete upérö (che) añani hína kuri	Mombe’ukuéra omboty pende arete upérõ (che) añani hína	TENSE:PRE_SIM
Ko po ojupi amo ñemuha osapukái kuri	Ko po ojupíhina amo ñemuha osapukái kuri hína	ASPECT:IPFV
Ko mombe’upy ohenduká kuri chéve che ru. ha’e oguapy	Ko mombe’upy emohenduká kuri chéve nde. nde reguapy	PERSON:2_SI
Ha’e oguapy jaguarete katu itáicha okirirĩ.	Che aguapy che katu itáicha akirirĩ.	PERSON:1_SI
Upérö (che) añani hína kuri ha’e oguapy	Upérõ (che) añanita hína ha’e oguapýta	TENSE:FUT_SIM
Pe techakuaa, ñepysyrõ, jehechauka ha ñeñangareko umi arandu yma	Pe techakuaa, ñepysyrõ, jehechauka ha ñeñangareko umi arandu yma	NOCHANGE
Temirendukuéra omongakuaa ku mbói oñorairõ	Temirendukuéra omongakuaa hína ku mbói oñorairõ hína	ASPECT:IPFV
Mbo’eharakuéra ateneoguápe aheja che ñe’ãpoty morotĩva	Mbo’eharakuéra ateneoguápe aheja che ñe’ãpoty morotĩva	NOCHANGE
Mombe’ukuéra omboty kuri pende arete amo ñemuha osapukái kuri	Mombe’ukuéra omboty kuri hína pende arete amo ñemuha osapukái kuri hína	ASPECT:IPFV
Ha’e ojupi kuri ore ndorokuave’ẽi umi tembi’ukuéra pytagua	Ha’e ojupi kuri hína ore ndorokuave’ẽi hina umi tembi’ukuéra pytagua	ASPECT:IPFV
Ku mbói oñorairõ nde reñembosarái hína	Ku mbói oñorairõ ikóni nde reñembosarái ikóni	ASPECT:INM
Nde reñembosarái hína ku mbói oñorairõ	Nde reñembosarái ikóni ku mbói oñorairõ ikóni	ASPECT:INM
Pe pu’ã ñamoñe’ẽ ñande poyvi potĩ sakãme,	Pe pu’ã ñamoñe’ẽ ñande poyvi potĩ sakãme,	NOCHANGE
Ha’e oguapy che nañemoingeta	Nde reguapy nde nareñemoingeta	PERSON:2_SI
Pakova roguépe omo’â hembi’ukuéra. ko mombe’upy ohenduká kuri chéve che ru.	Pakova roguépe ndomo’âi hembi’ukuéra. ko mombe’upy ndohenduká kuri chéve che ru.	TYPE:NEG
Che rasy upérö (che) añani hína kuri	Ñande rasy upérõ (ñande) ñañanihínakuri	PERSON:1_PL_INC
Apurahéi kuri temirendukuéra omongakuaa	Ndapurahéi kuri temirendukuéra ndomongakuaai	TYPE:NEG
(aty guasu rupive oñemba’apo arapytu rehe)	(aty guasu rupive oñemba’apo arapytu rehe)	NOCHANGE
Che mba’éma ko ykua amo ñemuha osapukái kuri	Che mba’éta ko ykua amo ñemuha osapukáita	TENSE:FUT_SIM
Mombe’ukuéra omboty kuri pende arete ha’e oguapy	Mombe’ukuéra ombotyta pende arete ha’e oguapýta	TENSE:FUT_SIM
Che ajavými iñeikotevẽva akuápe okũmbymi hikuái	Che ndajavýimi iñeikotevẽva akuápe ndokũmbýimi hikuái	TYPE:NEG
Nde ára jarohory.	Nde ára jarohory.	NOCHANGE
Pohanohára akãguapy ndombovuta nde nderejapói	Pohanohárakuera akãguapy ndombovúita ha’ekuéra ndojapói	PERSON:3_PL
Ore temimbo’e tie’ỹ ojapopami ku mbói oñorairõ	Ore temimbo’e tie’ỹ nojapopami ku mbói noñorairõi	TYPE:NEG
Oipuru hikuái ka’a ha ho’u terere. ha’ekuéra naiñemoñaréi kuri	Ñande jaipuru ka’a ha ja’u terere. ñande naiñañemoñaréi kuri	PERSON:1_PL_INC
Temirendukuéra omongakuaa ha’e ombojára kuri mbovy apekuéra	Temirendukuéra ndomongakuaai ha’e ndombojárai kuri mbovy apekuéra	TYPE:NEG
Ikatu hupytyrã ndaha’ei ko’árape jeikua mba’epa ñande, hákatu ñembotove pe ñande ha’eva	Ikatu hupytyrã ndaha’ei ko’árape jeikua mba’epa ñande, hákatu ñembotove pe ñande ha’eva	NOCHANGE
Tetã ñembyatypyre amandaje-mburuvicha rapépe	Tetã ñembyatypyre amandaje-mburuvicha rapépe	NOCHANGE
Nde reñembosarái hína ha’e ombojára kuri mbovy apekuéra	Che añembosarái hína che ambojára kuri mbovy apekuéra	PERSON:1_SI
Ore temimbo’e tie’ỹ ojapopami ha’ekuéra naiñemoñaréi kuri	Ore temimbo’e tie’ỹ ojapopa ha’ekuéra ndoñemoñaréi	TENSE:PRE_SIM
Tapicha marina-guápe.	Tapicha marina-guápe.	NOCHANGE
Che mba’éma ko ykua che ajavými iñeikotevẽva akuápe	Ore mba’e ko ykua ore rojavýimi iñeikotevẽva akuápe	PERSON:1_SI_EXC
Ha’ekuéra naiñemoñaréi kuri che rasy	Ore nairoñemoñaréi kuri ore rorasy	PERSON:1_PL_EXC
Oipuru hikuái ka’a ha ho’u terere. pakova roguépe omo’â hembi’ukuéra.	Ndoipurui hikuái ka’a térã ho’u terere. pakova roguépe ndomo’âi hembi’ukuéra.	TYPE:NEG
Hina tau ha kerana ñemoñare irundyha. ko mitã’i yvágaicha hesa hovy hasy ha	Hina tau ha kerana ñemoñare irundyha. ko mitã’i yvágaicha hesa hovy hasy ha	NOCHANGE
Che mba’éma ko ykua ko mombe’upy ohenduká kuri chéve che ru.	Nde mba’e ko ykua ko mombe’upy emohenduká kuri chéve nde.	PERSON:2_SI
Ha’e ombojára kuri mbovy apekuéra che ajavými iñeikotevẽva akuápe	Ha’e ndombojárai kuri mbovy apekuéra che ndajavýimi iñeikotevẽva akuápe	TYPE:NEG
Che rasy nde reñembosarái hína	Ndacherásyi nde nereñembosaráiri hína	TYPE:NEG
Peteĩ mba’e neporãva ojejapóva ha’e	Peteĩ mba’e neporãva ojejapóva ha’e	NOCHANGE
Ha ani orerejátei roñepy’ara’ã,	Ha ani orerejátei roñepy’ara’ã,	NOCHANGE
Jaguarete katu itáicha okirirĩ. pakova roguépe omo’â hembi’ukuéra.	Che katu itáicha akirirĩ. pakova roguépe amo’â cherembi’ukuéra.	PERSON:1_SI
Ore temimbo’e tie’ỹ ojapopami amo ñemuha osapukái kuri	Ore temimbo’e tie’ỹ ojapopata amo ñemuha osapukáita	TENSE:FUT_SIM
Ore ndorokuave’ẽi umi tembi’ukuéra pytagua pakova roguépe omo’â hembi’ukuéra.	Nde ndereikuave’ẽi umi tembi’ukuéra pytagua pakova roguépe pemo’â penderembi’ukuéra.	PERSON:2_PL
Pakova roguépe omo’â hembi’ukuéra. upérö (che) añani hína kuri	Pakova roguépe remo’â nderembi’ukuéra. upérõ (nde) reñanihínakuri	PERSON:2_SI
Che mba’éma ko ykua upérö (che) añani hína kuri	Nde mba’e ko ykua upérõ (nde) reñanihínakuri	PERSON:2_SI
Ha’e ojupi kuri ore ndorokuave’ẽi umi tembi’ukuéra pytagua	Che ajupi kuri che ndaikuave’ẽi umi tembi’ukuéra pytagua	PERSON:1_SI
Tupã, ñande jára, nde irũnamo oiko imombe’u katupýra nde kuña pavẽgui.	Tupã, ñande jára, nde irũnamo oiko imombe’u katupýra nde kuña pavẽgui.	NOCHANGE
Ha’e ojupi kuri nde nderemoheñói	Ñande jajupi kuri ñande ndañamoheñói	PERSON:1_PL_INC
Temirendukuéra omongakuaa che mba’éma ko ykua	Temirendukuéra omongakuaata che mba’éta ko ykua	TENSE:FUT_SIM
Mombe’ukuéra omboty kuri pende arete che nañemoingeta	Mombe’ukuéra omboty pende arete che nañemoingei	TENSE:PRE_SIM
Anichéne opuka guaikuru ñande rehe.	Anichéne opuka guaikuru ñande rehe.	NOCHANGE
Ojapo yvy ñemboja’o oñemba’apo porãve haguã administración-pe.	Ojapo yvy ñemboja’o oñemba’apo porãve haguã administración-pe.	NOCHANGE
Mbo’ehao - kuatiañe’ẽ -jasyteĩ -arateĩ	Mbo’ehao - kuatiañe’ẽ -jasyteĩ -arateĩ	NOCHANGE
Guive ojerereko va’erã ambue asunto-rõ ha opytáne upéicha oñemba’apo haguã hese oimeraẽva	Guive ojerereko va’erã ambue asunto-rõ ha opytáne upéicha oñemba’apo haguã hese oimeraẽva	NOCHANGE
Ha ñanepytuhê avei.	Ha ñanepytuhê avei.	NOCHANGE
Oguahẽma pytu’u ichupe.	Oguahẽma pytu’u ichupe.	NOCHANGE
Apurahéi kuri pohanohára akãguapy ndombovuta	Ha’ekuéra opurahéikuri pohanohárakuera akãguapy ndombovúita	PERSON:3_PL
Ama oikomi ka’aguy hovy’ûvare che nañemoingeta	Ama oiko ka’aguy hovy’ûvare che nañemoingei	TENSE:PRE_SIM
Ko po ojupi ha’e ombojára kuri mbovy apekuéra	Ko po ojupíhina ha’e ombojára kuri hína mbovy apekuéra	ASPECT:IPFV
Ha’e ohecha ko yvy ári ojehúva,	Ha’e ohecha ko yvy ári ojehúva,	NOCHANGE
Ha’e oguapy okũmbymi hikuái	Ha’e oguapýkuri okũmby kuri hikuái.	TENSE:PAS_REC
Che nañemoingeta che mba’éma ko ykua	Nde nareñemoingeta nde mba’e ko ykua	PERSON:2_SI
Tetãvore joapykuéra pegua	Tetãvore joapykuéra pegua	NOCHANGE
Jaguarete katu itáicha okirirĩ. ha’e ombojára kuri mbovy apekuéra	Jaguarete katu itáicha okirirĩta. ha’e ombojárata mbovy apekuéra	TENSE:FUT_SIM
Jaguarete katu itáicha okirirĩ. he’i ka’i ruvicha ta’ýra kuérape	Jaguarete katu itáicha ndokirirĩ. he’i ka’i ruvicha ita’ýrakuérape	TYPE:NEG
Che rasy peẽ napejapómi ogyke pokã	Che cherasy kuri peẽ napejapói kuri ogyke pokã	TENSE:PAS_REC
Amo ñemuha osapukái kuri pohanohára akãguapy ndombovuta	Amo ñemuha osapukáiva’ekue pohanohára akãguapy ndombovúiva’ekue	TENSE:PAS_PLU
Apurahéi kuri ha’e ombojára kuri mbovy apekuéra	Ndapurahéi kuri ha’e ndombojárai kuri mbovy apekuéra	TYPE:NEG
Ha’e ojupi kuri che mba’éma ko ykua	Nde rejupi kuri nde mba’e ko ykua	PERSON:2_SI
Ndaipóri ñe’ê	Ndaipóri ñe’ê	NOCHANGE
Ama oikomi ka’aguy hovy’ûvare okũmbymi hikuái	Che aikomi ka’aguy hovy’ûvare che akũmbymi	PERSON:1_SI
Jaguarete katu itáicha okirirĩ. apurahéi kuri	Jaguarete katu itáicha ndokirirĩ. ndapurahéi kuri	TYPE:NEG
Ha’e nombotujaimi che ogyke - ha’e ndombyaimi che ogyke jaguarete katu itáicha okirirĩ.	Ha’e ombotujáta che ogyke - ha’e ombyaíta che ogyke jaguarete katu itáicha okirirĩta.	TENSE:FUT_SIM
Ijuru ñeimo’ã’ỹva ndojurata che aovevekuéra - ijuru ñeimo’ã’ỹva ndojuramo’ãi che aovevekuéra che rasy	Ijuru ñeimo’ã’ỹva ndojuraiva’ekue che aovevekuéra che cherasy va’ekue	TENSE:PAS_PLU
Ja’e ichupekuéra pe tavy tuichágui	Ja’e ichupekuéra pe tavy tuichágui	NOCHANGE
Ha’ekuéra naiñemoñaréi kuri peẽ napejapómi ogyke pokã	Ñande naiñañemoñaréi kuri ñande najajapómi ogyke pokã	PERSON:1_PL_INC
Ha’e ombojerekuri umi kutuhakuéra poro’o che mba’éma ko ykua	Nde rembojerekuri umi kutuhakuéra tuicháva nde mba’e ko ykua	PERSON:2_SI
Va’ekue, ha’e gui ajapo va’ekue guive.	Va’ekue, ha’e gui ajapo va’ekue guive.	NOCHANGE
Che rasy ha’e oguapy	Che cherasy kuri ha’e oguapýkuri	TENSE:PAS_REC
Pahápe umi apañuãi ñemyatyrõ, ýrõ katu oñemyesakã umi mba’e ñemimby.	Pahápe umi apañuãi ñemyatyrõ, ýrõ katu oñemyesakã umi mba’e ñemimby.	NOCHANGE
Pohanohára akãguapy ndombovuta nde reñembosarái hína	Pohanohára akãguapy ndombovúi kuri nde reñembosarái kuri hína	TENSE:PAS_REC
Ko po ojupi mombe’ukuéra omboty kuri pende arete	Ko po ojupíhina mombe’ukuéra omboty kuri hína pende arete	ASPECT:IPFV
Ha’ekuéra naiñemoñaréi kuri ha’e ojupi kuri	Ha’ekuéra naiñemoñaréita ha’e ojupita	TENSE:FUT_SIM
Táva ndivei kuéra. péicharõ ndaha’evéima diputado, he’i rirérõ guive tenondérupi iñirũnguéra	Táva ndivei kuéra. péicharõ ndaha’evéima diputado, he’i rirérõ guive tenondérupi iñirũnguéra	NOCHANGE
Ndaupéichairõ upe veto ojerereko va’erã mba’evérõ.	Ndaupéichairõ upe veto ojerereko va’erã mba’evérõ.	NOCHANGE
Ha’e ombojerekuri umi kutuhakuéra poro’o ko po ojupi	Ha’e ombojerehina kuri umi kutuhakuéra tuicháva ko po ojupíhina	ASPECT:IPFV
Ha’e ombojára kuri mbovy apekuéra che rasy	Nde rembojára kuri mbovy apekuéra nde nderasy	PERSON:2_SI
Ko mombe’upy ohenduká kuri chéve che ru. che rasy	Ko mombe’upy ndohenduká kuri chéve che ru. ndacherásyi	TYPE:NEG
Ijuru ñeimo’ã’ỹva ndojurata che aovevekuéra - ijuru ñeimo’ã’ỹva ndojuramo’ãi che aovevekuéra ore temimbo’e tie’ỹ ojapopami	Ijuru ñeimo’ã’ỹva ndojurai che aovevekuéra ore temimbo’e tie’ỹ ojapopa	TENSE:PRE_SIM
Ha’e oguapy he’i ka’i ruvicha ta’ýra kuérape	Ha’e ndoguapýi he’i ka’i ruvicha ita’ýrakuérape	TYPE:NEG
Oipuru hikuái ka’a ha ho’u terere. ko po ojupi	Ndoipurui hikuái ka’a térã ho’u terere. ko po ndojupíri	TYPE:NEG
Ñe’ẽngatujára kuimba’e ha kuña omýiva tesape oguerúva	Ñe’ẽngatujára kuimba’e ha kuña omýiva tesape oguerúva	NOCHANGE
Mba’éichapa ha moõ mevépa oho ojopóre mokõive. ko tembiapo	Mba’éichapa ha moõ mevépa oho ojopóre mokõive. ko tembiapo	NOCHANGE
Ha’e ndombojaruita chéngo ndaikuaái upévape.	Ha’e ndombojarui kuri chéngo ndaikuaái kuri hina upévape.	TENSE:PAS_REC
Nde nderemoheñói nde nderejapói	Nde remoheñói nde rejapo	TYPE:AFF
Peẽ napejapómi ogyke pokã ha’e ombojerekuri umi kutuhakuéra poro’o	Nde nderejapómi ogyke pokã nde rembojerekuri umi kutuhakuéra tuicháva	PERSON:2_SI
Ha’e ojupi kuri he’i ka’i ruvicha ta’ýra kuérape	Che ajupi kuri che, ka’i ruvicha, ha’e che ta’yrakuérape	PERSON:1_SI
Amo ñemuha osapukái kuri he’i ka’i ruvicha ta’ýra kuérape	Amo ñemuha nosapukái kuri he’i ka’i ruvicha ita’ýrakuérape	TYPE:NEG
- nde tuja pituva, sonseraiténgo peteĩ ña’ẽ pyahu, mba’eháiko nderejeruré pe pira’ípe ñande róga pyahurã.	- nde tuja pituva, sonseraiténgo peteĩ ña’ẽ pyahu, mba’eháiko nderejeruré pe pira’ípe ñande róga pyahurã.	NOCHANGE
Ku mbói oñorairõ jaguarete katu itáicha okirirĩ.	Ku mbói oñorairõta jaguarete katu itáicha okirirĩta.	TENSE:FUT_SIM
Apurahéi kuri ha’e oguapy	Ndapurahéi kuri ha’e ndoguapýi	TYPE:NEG
Okũmbymi hikuái amo ñemuha osapukái kuri	Ndokũmbýimi hikuái amo ñemuha nosapukái kuri	TYPE:NEG
Apurahéi kuri temirendukuéra omongakuaa	Apurahéitta temirendukuéra omongakuaata	TENSE:FUT_SIM
Apurahéi kuri ha’e oguapy	Apurahéi va’ekue ha’e oguapýva’ekue	TENSE:PAS_PLU
Ku mbói oñorairõ ha’e ombojára kuri mbovy apekuéra	Ku mbói oñorairõta ha’e ombojárata mbovy apekuéra	TENSE:FUT_SIM
- te’ýi hetahápe, ombohérakuri te’ýi (te’yikuary)	- te’ýi hetahápe, ombohérakuri te’ýi (te’yikuary)	NOCHANGE
Ija’e’y rupi pe mitâkuña ndojejuhúi.	Ija’e’y rupi pe mitâkuña ndojejuhúi.	NOCHANGE
Ojejerurehápe, terã opa ary.	Ojejerurehápe, terã opa ary.	NOCHANGE
Che rasy amo ñemuha osapukái kuri	Ndacherásyi amo ñemuha nosapukái kuri	TYPE:NEG
Ha’e nombotujaimi che ogyke - ha’e ndombyaimi che ogyke che rasy	Ha’e ndombotujaikuri hina che ogyke - ha’e ndombyaikuri hina che ogyke che cherasy kuri	TENSE:PAS_REC
Umi mba’ekuera arekova apytepe iporãveva, arekogueteri ñe’ê nda’eíva araka’eve.	Umi mba’ekuera arekova apytepe iporãveva, arekogueteri ñe’ê nda’eíva araka’eve.	NOCHANGE
Ha’e nombotujaimi che ogyke - ha’e ndombyaimi che ogyke oipuru hikuái ka’a ha ho’u terere.	Ha’e ombotujáta che ogyke - ha’e ombyaíta che ogyke oipuruta hikuái ka’a ha ho’uta terere.	TENSE:FUT_SIM
Hose ndaikatúi ohupyty hogue ojapo hagua tupãsýme hogarãmi. upémarõjeko oñesũ	Hose ndaikatúi ohupyty hogue ojapo hagua tupãsýme hogarãmi. upémarõjeko oñesũ	NOCHANGE
Umi mba’e jahasáva rupive jahechakuaa	Umi mba’e jahasáva rupive jahechakuaa	NOCHANGE
Che mba’éma ko ykua amo ñemuha osapukái kuri	Ndachemba’ei ko ykua amo ñemuha nosapukái kuri	TYPE:NEG
Táva guasu argentino hesâi.	Táva guasu argentino hesâi.	NOCHANGE
Ha’ekuéra naiñemoñaréi kuri jaguarete katu itáicha okirirĩ.	Ha’ekuéra naiñemoñaréita jaguarete katu itáicha okirirĩta.	TENSE:FUT_SIM
Che mba’éma ko ykua che nañemoingeta	Nde mba’e ko ykua nde nareñemoingeta	PERSON:2_SI
Ama oikomi ka’aguy hovy’ûvare jaguarete katu itáicha okirirĩ.	Ama ndoikomi ka’aguy hovy’ûvare jaguarete katu itáicha ndokirirĩ.	TYPE:NEG
Apurahéi kuri oipuru hikuái ka’a ha ho’u terere.	Apurahéitta oipuruta hikuái ka’a ha ho’uta terere.	TENSE:FUT_SIM
Ko mombe’upy ohenduká kuri chéve che ru. nde reñembosarái hína	Ko mombe’upy ndohenduká kuri chéve che ru. nde nereñembosaráiri hína	TYPE:NEG
Mbyjajere itaembo ojeréva kuarahýre.	Mbyjajere itaembo ojeréva kuarahýre.	NOCHANGE
Ku mbói oñorairõ che rasy	Ku mbói oñorairõ hína che rasypota hina	ASPECT:IPFV
Upévare ára ha ára	Upévare ára ha ára	NOCHANGE
Ha’e ndombojaruita ijuru ñeimo’ã’ỹva ndojurata che aovevekuéra - ijuru ñeimo’ã’ỹva ndojuramo’ãi che aovevekuéra	Ha’e ombojaruita ijuru ñeimo’ã’ỹva ojurata che aovevekuéra	TYPE:AFF
Ha’e ombojára kuri mbovy apekuéra ha’e nombotujaimi che ogyke - ha’e ndombyaimi che ogyke	Ha’e ombojárata mbovy apekuéra ha’e ombotujáta che ogyke - ha’e ombyaíta che ogyke	TENSE:FUT_SIM
Hi’ánte chéve apay	Hi’ánte chéve apay	NOCHANGE
Che ajavými iñeikotevẽva akuápe ko po ojupi	Che ndajavýimi iñeikotevẽva akuápe ko po ndojupíri	TYPE:NEG
Ombohetia’éva	Ombohetia’éva	NOCHANGE
Peteĩ ára ko’ẽme che rupágui apu’ãvo	Peteĩ ára ko’ẽme che rupágui apu’ãvo	NOCHANGE
Okũmbymi hikuái mombe’ukuéra omboty kuri pende arete	Ndokũmbýimi hikuái mombe’ukuéra ndombotyi kuri pende arete	TYPE:NEG
Ha’ekuéra naiñemoñaréi kuri nde nderejapói	Ha’ekuéra oñemoñaréi kuri nde rejapo	TYPE:AFF
Yso. tr. ha’e ningo panambi térâ mberu ra’y osê ramóva tupi’águi ha okarúva ka’avóre oñembopepo mboyve.	Yso. tr. ha’e ningo panambi térâ mberu ra’y osê ramóva tupi’águi ha okarúva ka’avóre oñembopepo mboyve.	NOCHANGE
Mombe’ukuéra omboty kuri pende arete che rasy	Mombe’ukuéra omboty kuri hína pende arete che rasypota hina	ASPECT:IPFV
Ha’e ojupi kuri ha’e oguapy	Nde rejupi kuri nde reguapy	PERSON:2_SI
Nde nderemoheñói ijuru ñeimo’ã’ỹva ndojurata che aovevekuéra - ijuru ñeimo’ã’ỹva ndojuramo’ãi che aovevekuéra	Nde remoheñói ijuru ñeimo’ã’ỹva ojurata che aovevekuéra	TYPE:AFF
Hi’ãnte (chéve) oguahẽ ko’ãga.	Hi’ãnte (chéve) oguahẽ ko’ãga.	NOCHANGE
Ijuru ñeimo’ã’ỹva ndojurata che aovevekuéra - ijuru ñeimo’ã’ỹva ndojuramo’ãi che aovevekuéra che rasy	Ijuru ñeimo’ã’ỹva ndojurai kuri che aovevekuéra che cherasy kuri	TENSE:PAS_REC
Okũmbymi hikuái ha’e ojupi kuri	Che akũmbymi che ajupi kuri	PERSON:1_SI
Poguypópe oiko ko tetã.	Poguypópe oiko ko tetã.	NOCHANGE
Peẽ napejapómi ogyke pokã che mba’éma ko ykua	Nde nderejapómi ogyke pokã nde mba’e ko ykua	PERSON:2_SI
Mboriahúnte omyatãva ñane retã paraguái.	Mboriahúnte omyatãva ñane retã paraguái.	NOCHANGE
Pohanohára akãguapy ndombovuta peẽ napejapómi ogyke pokã	Pohanohárakuera akãguapy ndombovúita ha’ekuéra nojapómi ogyke pokã	PERSON:3_PL
Mávapa oimo’ãta oĩha ñande rapicha ohayhuasýva guaraní ñe’ẽ, ahendu he’ihikuái, ñane retã rembe’ýpe, omomba’eguasúvo umi nerembiapo.	Mávapa oimo’ãta oĩha ñande rapicha ohayhuasýva guaraní ñe’ẽ, ahendu he’ihikuái, ñane retã rembe’ýpe, omomba’eguasúvo umi nerembiapo.	NOCHANGE
Pyhare ha ára reñeha’ãva	Pyhare ha ára reñeha’ãva	NOCHANGE
Upéicha avei oiko umi teroja moteĩva techaukarã tovake’ỹguágui.	Upéicha avei oiko umi teroja moteĩva techaukarã tovake’ỹguágui.	NOCHANGE
Ñande jajapo ichupe.	Ñande jajapo ichupe.	NOCHANGE
Jaguarete katu itáicha okirirĩ. pakova roguépe omo’â hembi’ukuéra.	Jaguarete katu itáicha ndokirirĩ. pakova roguépe ndomo’âi hembi’ukuéra.	TYPE:NEG
Okũmbymi hikuái peẽ napejapómi ogyke pokã	Okũmby kuri hikuái. peẽ napejapói kuri ogyke pokã	TENSE:PAS_REC
Akóinte ipore’ỹ.	Akóinte ipore’ỹ.	NOCHANGE
Ha’e ombojára kuri mbovy apekuéra he’i ka’i ruvicha ta’ýra kuérape	Nde rembojára kuri mbovy apekuéra nde, ka’i ruvicha ere nde ta’yrakuérape	PERSON:2_SI
Ha’e oguapy ha’e ombojára kuri mbovy apekuéra	Ha’e oguapýta ha’e ombojárata mbovy apekuéra	TENSE:FUT_SIM
Ha’e ombojerekuri umi kutuhakuéra poro’o apurahéi kuri	Ha’e ndombojereikuri umi kutuhakuéra tuicháva ndapurahéi kuri	TYPE:NEG
Peẽ napejapómi ogyke pokã che rasy	Ñande najajapómi ogyke pokã ñande rasy	PERSON:1_PL_INC
Che nañemoingeta chéngo ndaikuaái upévape.	Nde nareñemoingeta ndéngo ndereikuaái upévape.	PERSON:2_SI
Ha’e ojupi kuri ha’e oguapy	Ha’e ojupita ha’e oguapýta	TENSE:FUT_SIM
Jaguarete katu itáicha okirirĩ. che rasy	Jaguarete katu itáicha ndokirirĩ. ndacherásyi	TYPE:NEG
Jaguarete katu itáicha okirirĩ. he’i ka’i ruvicha ta’ýra kuérape	Che katu itáicha akirirĩ. che, ka’i ruvicha, ha’e che ta’yrakuérape	PERSON:1_SI
Hikuái kokuépe. mandyju ha manduvi niko umi mba’e oñemitỹkakuaavéva, ohepyme’ẽ	Hikuái kokuépe. mandyju ha manduvi niko umi mba’e oñemitỹkakuaavéva, ohepyme’ẽ	NOCHANGE
Ñeha’ã tetã surasiático rehe	Ñeha’ã tetã surasiático rehe	NOCHANGE
Che ajavými iñeikotevẽva akuápe ku mbói oñorairõ	Che ajavýimi hína iñeikotevẽva akuápe ku mbói oñorairõ hína	ASPECT:IPFV
Amo ñemuha osapukái kuri ama oikomi ka’aguy hovy’ûvare	Amo ñemuha nosapukái kuri ama ndoikomi ka’aguy hovy’ûvare	TYPE:NEG
Che rasy ama oikomi ka’aguy hovy’ûvare	Ndacherásyi ama ndoikomi ka’aguy hovy’ûvare	TYPE:NEG
Peẽ napejapómi ogyke pokã apurahéi kuri	Ha’ekuéra nojapómi ogyke pokã ha’ekuéra opurahéikuri	PERSON:3_PL
Sãmbyhy nde’isei pu’aka, hákatu mboajekatu peteĩ tembiaporã	Sãmbyhy nde’isei pu’aka, hákatu mboajekatu peteĩ tembiaporã	NOCHANGE
Jepémo ha’ekuéra tekove ñandeichaguánte,	Jepémo ha’ekuéra tekove ñandeichaguánte,	NOCHANGE
Térã yvy puru’ã ru’ãre pyhare omburea,	Térã yvy puru’ã ru’ãre pyhare omburea,	NOCHANGE
Ama oikomi ka’aguy hovy’ûvare upérö (che) añani hína kuri	Ama oiko ka’aguy hovy’ûvare upérõ (che) añani hína	TENSE:PRE_SIM
Chéngo ndaikuaái upévape. ha’ekuéra naiñemoñaréi kuri	Chéngo aikuaá upévape. ha’ekuéra oñemoñaréi kuri	TYPE:AFF
Ñamoingovemínga ñande avañe’ê.	Ñamoingovemínga ñande avañe’ê.	NOCHANGE
Me (jaipurukuaáva ñe’ẽ tĩgua ndive)	Me (jaipurukuaáva ñe’ẽ tĩgua ndive)	NOCHANGE
Ko po ojupi temirendukuéra omongakuaa	Ko po ndojupíri temirendukuéra ndomongakuaai	TYPE:NEG
Ore temimbo’e tie’ỹ ojapopami ko po ojupi	Ore temimbo’e tie’ỹ ojapopata ko po ojupíta	TENSE:FUT_SIM
Ijuru ñeimo’ã’ỹva ndojurata che aovevekuéra - ijuru ñeimo’ã’ỹva ndojuramo’ãi che aovevekuéra ama oikomi ka’aguy hovy’ûvare	Ijuru ñeimo’ã’ỹva ndojurai che aovevekuéra ama oiko ka’aguy hovy’ûvare	TENSE:PRE_SIM
Ñande rekove	Ñande rekove	NOCHANGE
Hógape opyta itúva ha isy	Hógape opyta itúva ha isy	NOCHANGE
Oporomomembýva, oñembohérava partéra chae, oipytyvõva kuña hyeguasúvape imemby	Oporomomembýva, oñembohérava partéra chae, oipytyvõva kuña hyeguasúvape imemby	NOCHANGE
Ñane ava ñe’ẽ jaiporu jevy	Ñane ava ñe’ẽ jaiporu jevy	NOCHANGE
He’i ka’i ruvicha ta’ýra kuérape ha’e ndombojaruita	Che, ka’i ruvicha, ha’e che ta’yrakuérape che ndambojaruita	PERSON:1_SI
Amo ñemuha osapukái kuri okũmbymi hikuái	Amo ñemuha osapukáita okũmbyta hikuái.	TENSE:FUT_SIM
Peẽ napejapómi ogyke pokã ore temimbo’e tie’ỹ ojapopami	Ha’ekuéra nojapómi ogyke pokã ore temimbo’ekuéra tie’ỹ ojapopami	PERSON:3_PL
Nde reñembosarái hína upérö (che) añani hína kuri	Nde reñembosaráita hína upérõ (che) añanita hína	TENSE:FUT_SIM
Ore ndorokuave’ẽi umi tembi’ukuéra pytagua amo ñemuha osapukái kuri	Ore ndorokuave’ẽi hina umi tembi’ukuéra pytagua amo ñemuha osapukái kuri hína	ASPECT:IPFV
Ha’e nombotujaimi che ogyke - ha’e ndombyaimi che ogyke nde reñembosarái hína	Ha’e ombotujáta che ogyke - ha’e ombyaíta che ogyke nde reñembosaráita hína	TENSE:FUT_SIM
Omotenonde reve, kerãi tuichague ñemboriko sundaro	Omotenonde reve, kerãi tuichague ñemboriko sundaro	NOCHANGE
- che ndévente rohayhu che memby, ndaha’éi avavépe- he’i isy.-	- che ndévente rohayhu che memby, ndaha’éi avavépe- he’i isy.-	NOCHANGE
Nde reñembosarái hína ore ndorokuave’ẽi umi tembi’ukuéra pytagua	Nde reñembosarái ikóni ore ndorokuave’ẽi ikóni umi tembi’ukuéra pytagua	ASPECT:INM
Ore temimbo’e tie’ỹ ojapopami ijuru ñeimo’ã’ỹva ndojurata che aovevekuéra - ijuru ñeimo’ã’ỹva ndojuramo’ãi che aovevekuéra	Ore temimbo’e tie’ỹ ojapopa ijuru ñeimo’ã’ỹva ndojurai che aovevekuéra	TENSE:PRE_SIM
Ombohape va’erã pe tekopykuaa mba’e porã jejapo, ñemyasãi ha	Ombohape va’erã pe tekopykuaa mba’e porã jejapo, ñemyasãi ha	NOCHANGE
Ha’e ombojára kuri mbovy apekuéra he’i ka’i ruvicha ta’ýra kuérape	Che ambojára kuri mbovy apekuéra che, ka’i ruvicha, ha’e che ta’yrakuérape	PERSON:1_SI
Ha’ekuéra naiñemoñaréi kuri ha’e ombojára kuri mbovy apekuéra	Ha’ekuéra naiñemoñaréita ha’e ombojárata mbovy apekuéra	TENSE:FUT_SIM
Che ajavými iñeikotevẽva akuápe mombe’ukuéra omboty kuri pende arete	Che ajavýimi hína iñeikotevẽva akuápe mombe’ukuéra omboty kuri hína pende arete	ASPECT:IPFV
Oguãhẽ ára ajedekitávo nde rehe.	Oguãhẽ ára ajedekitávo nde rehe.	NOCHANGE
Voto añetegua ome’ẽ va’ekuégui.	Voto añetegua ome’ẽ va’ekuégui.	NOCHANGE
Ama oikomi ka’aguy hovy’ûvare che nañemoingeta	Nde reikomi ka’aguy hovy’ûvare nde nareñemoingeta	PERSON:2_SI
Ha’e ndombojaruita peẽ napejapómi ogyke pokã	Ha’e ombojaruita peẽ pejapomi ogyke pokã	TYPE:AFF
Ku mbói oñorairõ nde reñembosarái hína	Umi mbóikuera oñorairõ ha’ekuéra oñembosarái hína	PERSON:3_PL
Kane’õ reikuaa’ỹva	Kane’õ reikuaa’ỹva	NOCHANGE
Ha’e ombojerekuri umi kutuhakuéra poro’o ama oikomi ka’aguy hovy’ûvare	Ha’e ndombojereikuri umi kutuhakuéra tuicháva ama ndoikomi ka’aguy hovy’ûvare	TYPE:NEG
Ha’e ndombojaruita ama oikomi ka’aguy hovy’ûvare	Che ndambojaruita che aikomi ka’aguy hovy’ûvare	PERSON:1_SI
Aiko porã. mba’e rejapo.	Aiko porã. mba’e rejapo.	NOCHANGE
Che rasy ha’ekuéra naiñemoñaréi kuri	Peê penderasy peë naipeñemoñaréi kuri	PERSON:2_PL
Che rasy jaguarete katu itáicha okirirĩ.	Ndacherásyi jaguarete katu itáicha ndokirirĩ.	TYPE:NEG
Mombe’ukuéra omboty kuri pende arete che ajavými iñeikotevẽva akuápe	Mombe’ukuéra omboty kuri hína pende arete che ajavýimi hína iñeikotevẽva akuápe	ASPECT:IPFV
Ha py’ỹi yvate oma’ẽ	Ha py’ỹi yvate oma’ẽ	NOCHANGE
Jaguarete katu itáicha okirirĩ. pakova roguépe omo’â hembi’ukuéra.	Nde katu itáicha rekirirĩ. pakova roguépe remo’â nderembi’ukuéra.	PERSON:2_SI
Apurahéi kuri ko mombe’upy ohenduká kuri chéve che ru.	Ndapurahéi kuri ko mombe’upy ndohenduká kuri chéve che ru.	TYPE:NEG
Ipype omohe’õ	Ipype omohe’õ	NOCHANGE
Pũrũrũgui (tyapu oikóva ñande jurúpe ñamongu’írõ tembi’u atã).	Pũrũrũgui (tyapu oikóva ñande jurúpe ñamongu’írõ tembi’u atã).	NOCHANGE
Upérö (che) añani hína kuri chéngo ndaikuaái upévape.	Upérõ (nde) reñanihínakuri ndéngo ndereikuaái upévape.	PERSON:2_SI
Tembipu isâva, hi’ýva ha hete yvyráva, oñembopu haguâ ojeporu ñane kuâ.	Tembipu isâva, hi’ýva ha hete yvyráva, oñembopu haguâ ojeporu ñane kuâ.	NOCHANGE
Ha’e nombotujaimi che ogyke - ha’e ndombyaimi che ogyke ha’e oguapy	Nde nderembotujáimi che ogyke - nde nerembyaimi che ogyke nde reguapy	PERSON:2_SI
Káso ñemombe’u ha kavure, areguápe	Káso ñemombe’u ha kavure, areguápe	NOCHANGE
- itarovaitéko pe che rembireko, nome’ẽiko chéve piro’y, cheja’óvo oiko ha ko’ágã ndaje oipota viru ha oikose kuñakarai guasúrõ.	- itarovaitéko pe che rembireko, nome’ẽiko chéve piro’y, cheja’óvo oiko ha ko’ágã ndaje oipota viru ha oikose kuñakarai guasúrõ.	NOCHANGE
Ore temimbo’e tie’ỹ ojapopami nde reñembosarái hína	Ore temimbo’e tie’ỹ nojapopami nde nereñembosaráiri hína	TYPE:NEG
Jukyrýre osyrýva upépe ombe’úva ijapyra’ỹva ñande rekove	Jukyrýre osyrýva upépe ombe’úva ijapyra’ỹva ñande rekove	NOCHANGE
Ha’e ombojára kuri mbovy apekuéra pakova roguépe omo’â hembi’ukuéra.	Ha’e ndombojárai kuri mbovy apekuéra pakova roguépe ndomo’âi hembi’ukuéra.	TYPE:NEG
Nde rejavykýirö ñe’ëpotýpe	Nde rejavykýirö ñe’ëpotýpe	NOCHANGE
Che nañemoingeta nde nderejapói	Che añemoingeta nde rejapo	TYPE:AFF
Ore remikuave’êre, rohenói ára ha pyhare.	Ore remikuave’êre, rohenói ára ha pyhare.	NOCHANGE
Pohanohára akãguapy ndombovuta ha’e nombotujaimi che ogyke - ha’e ndombyaimi che ogyke	Pohanohára akãguapy ndombovúiva’ekue ha’e ndombotujáiva’ekue che ogyke - ha’e ndombyaiva’ekue che ogyke	TENSE:PAS_PLU
Ñane retã ipytuhê	Ñane retã ipytuhê	NOCHANGE
Che mba’éma ko ykua che rasy	Nde mba’e ko ykua nde nderasy	PERSON:2_SI
Che mba’éma ko ykua ore temimbo’e tie’ỹ ojapopami	Ndachemba’ei ko ykua ore temimbo’e tie’ỹ nojapopami	TYPE:NEG
Ñande jepokuaa ha ñane ñe’ënga	Ñande jepokuaa ha ñane ñe’ënga	NOCHANGE
Opavave mitãkuimba’e,mitãkuña ha ikakuavéva rehe oñeha’ãva	Opavave mitãkuimba’e,mitãkuña ha ikakuavéva rehe oñeha’ãva	NOCHANGE
Jaguarete katu itáicha okirirĩ. nde reñembosarái hína	Jaguarete katu itáicha okirirĩta. nde reñembosaráita hína	TENSE:FUT_SIM
Okũmbymi hikuái amo ñemuha osapukái kuri	Okũmbyta hikuái. amo ñemuha osapukáita	TENSE:FUT_SIM
Amo ñemuha osapukái kuri nde reñembosarái hína	Amo ñemuha nosapukái kuri nde nereñembosaráiri hína	TYPE:NEG
Ha’e ndombojaruita che rasy	Ha’e ndombojaruita hína che rasypota hina	ASPECT:IPFV
Tembiguái py’aro ombyaty	Tembiguái py’aro ombyaty	NOCHANGE
Ha’e oguapy che mba’éma ko ykua	Nde reguapy nde mba’e ko ykua	PERSON:2_SI
Che rasy che ajavými iñeikotevẽva akuápe	Ndacherásyi che ndajavýimi iñeikotevẽva akuápe	TYPE:NEG
Ha’e nombotujaimi che ogyke - ha’e ndombyaimi che ogyke che nañemoingeta	Nde nderembotujáimi che ogyke - nde nerembyaimi che ogyke nde nareñemoingeta	PERSON:2_SI
Ore ndorokuave’ẽi umi tembi’ukuéra pytagua ha’e ojupi kuri	Ñande ndañakuave’ẽi umi tembi’ukuéra pytagua ñande jajupi kuri	PERSON:1_PL_INC
Temirendukuéra omongakuaa ha’e oguapy	Temirendukuéra omongakuaata ha’e oguapýta	TENSE:FUT_SIM
Chéngo ndaikuaái upévape. ha’e ombojerekuri umi kutuhakuéra poro’o	Ndéngo ndereikuaái upévape. nde rembojerekuri umi kutuhakuéra tuicháva	PERSON:2_SI
Ha’e ombojára kuri mbovy apekuéra ha’e ndombojaruita	Nde rembojára kuri mbovy apekuéra nde nderembojarui mo’ãi	PERSON:2_SI
Akã jeremi ko tetãre.	Akã jeremi ko tetãre.	NOCHANGE
Upérö (che) añani hína kuri mombe’ukuéra omboty kuri pende arete	Upérõ (che) añanita hína mombe’ukuéra ombotyta pende arete	TENSE:FUT_SIM
Ha’e ombojerekuri umi kutuhakuéra poro’o pakova roguépe omo’â hembi’ukuéra.	Nde rembojerekuri umi kutuhakuéra tuicháva pakova roguépe remo’â nderembi’ukuéra.	PERSON:2_SI
Nde reñembosarái hína amo ñemuha osapukái kuri	Nde nereñembosaráiri hína amo ñemuha nosapukái kuri	TYPE:NEG
Che ñe’ë osëséva ombokua yvytu.	Che ñe’ë osëséva ombokua yvytu.	NOCHANGE
Ko mombe’upy ohenduká kuri chéve che ru. upérö (che) añani hína kuri	Ko mombe’upy emohenduká kuri chéve nde. upérõ (nde) reñanihínakuri	PERSON:2_SI
Nde nderemoheñói nde reñembosarái hína	Ha’ekuéra ndomoheñoi ha’ekuéra oñembosarái hína	PERSON:3_PL
Pakova roguépe omo’â hembi’ukuéra. jaguarete katu itáicha okirirĩ.	Pakova roguépe ndomo’âi hembi’ukuéra. jaguarete katu itáicha ndokirirĩ.	TYPE:NEG
Hi’ãma omyasãi ha tañahendu ñande tetãygua.	Hi’ãma omyasãi ha tañahendu ñande tetãygua.	NOCHANGE
Rehegua. mombyry chuguikuéra upe tekojoja. ha’ekuéra ndaha’eivoi tekove.	Rehegua. mombyry chuguikuéra upe tekojoja. ha’ekuéra ndaha’eivoi tekove.	NOCHANGE
Mombe’ukuéra omboty kuri pende arete temirendukuéra omongakuaa	Mombe’u omboty kuri pende arete temirendu omongakuaa	PERSON:3_SI
Upérö (che) añani hína kuri ha’e nombotujaimi che ogyke - ha’e ndombyaimi che ogyke	Upérõ (nde) reñanihínakuri nde nderembotujáimi che ogyke - nde nerembyaimi che ogyke	PERSON:2_SI
Ha’e ojupi kuri amo ñemuha osapukái kuri	Ha’e ojupi kuri hína amo ñemuha osapukái kuri hína	ASPECT:IPFV
Ha’e ojupi kuri pakova roguépe omo’â hembi’ukuéra.	Che ajupi kuri pakova roguépe amo’â cherembi’ukuéra.	PERSON:1_SI
Ijuru ñeimo’ã’ỹva ndojurata che aovevekuéra - ijuru ñeimo’ã’ỹva ndojuramo’ãi che aovevekuéra amo ñemuha osapukái kuri	Ijuru ñeimo’ã’ỹva ndojuraiva’ekue che aovevekuéra amo ñemuha osapukáiva’ekue	TENSE:PAS_PLU
Oñembosako’i guarani ñe’ẽaty, ñe’ẽasa ha ñe’ẽjere ára peteĩha	Oñembosako’i guarani ñe’ẽaty, ñe’ẽasa ha ñe’ẽjere ára peteĩha	NOCHANGE
Yvytuturusu pyatangy. che ha’e peteĩ yvyturusu.	Yvytuturusu pyatangy. che ha’e peteĩ yvyturusu.	NOCHANGE
Táva ñemohenda.	Táva ñemohenda.	NOCHANGE
Upérö (che) añani hína kuri che rasy	Upérõ (nde) reñanihínakuri nde nderasy	PERSON:2_SI
Peẽ napejapómi ogyke pokã ku mbói oñorairõ	Ha’ekuéra nojapómi ogyke pokã umi mbóikuera oñorairõ	PERSON:3_PL
Ñande kóga purahéi.	Ñande kóga purahéi.	NOCHANGE
He’i ka’i ruvicha ta’ýra kuérape ha’e ndombojaruita	Nde, ka’i ruvicha ere nde ta’yrakuérape nde nderembojarui mo’ãi	PERSON:2_SI
Mba’evete ndaha’éi,	Mba’evete ndaha’éi,	NOCHANGE
Ha’e oguapy apurahéi kuri	Ha’e oguapýta apurahéitta	TENSE:FUT_SIM
Nde nderemoheñói che rasy	Ñande ndañamoheñói ñande rasy	PERSON:1_PL_INC
Ñakyrã oreve opurahéi,	Ñakyrã oreve opurahéi,	NOCHANGE
Che nañemoingeta che ajavými iñeikotevẽva akuápe	Che nañemoingei che ajavy iñeikotevẽva akuápe	TENSE:PRE_SIM
Peteĩ yvypóra hemiandu pyahúva ha’e peteĩ tarova hemiandu ijyvytupeve	Peteĩ yvypóra hemiandu pyahúva ha’e peteĩ tarova hemiandu ijyvytupeve	NOCHANGE
Peẽ napejapómi ogyke pokã ko mombe’upy ohenduká kuri chéve che ru.	Peẽ napejapói ogyke pokã ko mombe’upy ohenduka chéve che ru.	TENSE:PRE_SIM
(aháma che chína)	(aháma che chína)	NOCHANGE
Ha’e ojupi kuri amo ñemuha osapukái kuri	Ha’e ojupita amo ñemuha osapukáita	TENSE:FUT_SIM
Ko po ojupi ha’ekuéra naiñemoñaréi kuri	Ko po ojupíta ha’ekuéra naiñemoñaréita	TENSE:FUT_SIM
Chéngo ndaikuaái upévape. ha’e ombojára kuri mbovy apekuéra	Ndéngo ndereikuaái upévape. nde rembojára kuri mbovy apekuéra	PERSON:2_SI
Aguyje, ndaikuaái kuri.	Aguyje, ndaikuaái kuri.	NOCHANGE
Ñe’ẽriregua -iñe’ẽpehẽtei ha iñe’ẽpehẽ’etáva- ojepuru ha ojehai jave, katuete ohova’erã peteĩ ñe’ẽ rire.	Ñe’ẽriregua -iñe’ẽpehẽtei ha iñe’ẽpehẽ’etáva- ojepuru ha ojehai jave, katuete ohova’erã peteĩ ñe’ẽ rire.	NOCHANGE
Umi terarãnguete teroñe’ẽramo oĩva, terarãnguete mba’eva ha terarãnguete kuaa’ỹva, ombojoapy sapy’apy’a ñe’ẽpehẽtai kokatuguigua.	Umi terarãnguete teroñe’ẽramo oĩva, terarãnguete mba’eva ha terarãnguete kuaa’ỹva, ombojoapy sapy’apy’a ñe’ẽpehẽtai kokatuguigua.	NOCHANGE
Che nañemoingeta nde nderemoheñói	Che añemoingeta nde remoheñói	TYPE:AFF
Pohanohára akãguapy ndombovuta che rasy	Pohanohára akãguapy ndombovúi kuri che cherasy kuri	TENSE:PAS_REC
Ku mbói oñorairõ nde nderejapói	Umi mbóikuera oñorairõ ha’ekuéra ndojapói	PERSON:3_PL
Temirendukuéra omongakuaa ha’ekuéra naiñemoñaréi kuri	Temirendukuéra omongakuaata ha’ekuéra naiñemoñaréita	TENSE:FUT_SIM
Je’ejey ojehu tekotevẽramo ojepurujeyjey peteĩ ñe’ẽ hesakaporãve hagua pe oje’eséva.	Je’ejey ojehu tekotevẽramo ojepurujeyjey peteĩ ñe’ẽ hesakaporãve hagua pe oje’eséva.	NOCHANGE
Amo ñemuha osapukái kuri mombe’ukuéra omboty kuri pende arete	Amo ñemuha osapukáiva’ekue mombe’ukuéra ombotyva’ekue pende arete	TENSE:PAS_PLU
Ha’e ojupi kuri ko po ojupi	Ha’e ndojupirí kuri ko po ndojupíri	TYPE:NEG
Ha mitã mimi opurahéi,	Ha mitã mimi opurahéi,	NOCHANGE
Peteĩ kavure guasu ho’a ñúhãme.	Peteĩ kavure guasu ho’a ñúhãme.	NOCHANGE
Pakova roguépe omo’â hembi’ukuéra. che ajavými iñeikotevẽva akuápe	Pakova roguépe pemo’â penderembi’ukuéra. nde rejavýimi iñeikotevẽva akuápe	PERSON:2_PL
Jaguarete katu itáicha okirirĩ. oipuru hikuái ka’a ha ho’u terere.	Jaguarete katu itáicha okirirĩta. oipuruta hikuái ka’a ha ho’uta terere.	TENSE:FUT_SIM
Ha’e ombojerekuri umi kutuhakuéra poro’o che nañemoingeta	Nde rembojerekuri umi kutuhakuéra tuicháva nde nareñemoingeta	PERSON:2_SI
Mokõivéva tetã ñe’ẽ tee ha upéichape	Mokõivéva tetã ñe’ẽ tee ha upéichape	NOCHANGE
Ndaikatúi ojepurumeme guarani ñe’ẽ	Ndaikatúi ojepurumeme guarani ñe’ẽ	NOCHANGE
Ary, akóinte oñemboyke guarani ñe’ẽ	Ary, akóinte oñemboyke guarani ñe’ẽ	NOCHANGE
Representante terã abogado de empresa reheguárõ, omba’apóva hepyrehe tetãguasu, tetãmini ha	Representante terã abogado de empresa reheguárõ, omba’apóva hepyrehe tetãguasu, tetãmini ha	NOCHANGE
Mombe’ukuéra omboty kuri pende arete apurahéi kuri	Mombe’ukuéra omboty kuri hína pende arete apurahéihina kuri	ASPECT:IPFV
Kuarahymimby ahecha ñe’êmbucu rape rupi.	Kuarahymimby ahecha ñe’êmbucu rape rupi.	NOCHANGE
Ha’e ojupi kuri jaguarete katu itáicha okirirĩ.	Nde rejupi kuri nde katu itáicha rekirirĩ.	PERSON:2_SI
Apurahéi kuri temirendukuéra omongakuaa	Apurahéihina kuri temirendukuéra omongakuaa hína	ASPECT:IPFV
Upérö (che) añani hína kuri che ajavými iñeikotevẽva akuápe	Upérõ (che) añanita hína che ajavýta iñeikotevẽva akuápe	TENSE:FUT_SIM
Ñane avañe’ë, ñande purahéi,	Ñane avañe’ë, ñande purahéi,	NOCHANGE
Jaguarete katu itáicha okirirĩ. ku mbói oñorairõ	Jaguarete katu itáicha ndokirirĩ. ku mbói noñorairõi	TYPE:NEG
Ore temimbo’e tie’ỹ ojapopami upérö (che) añani hína kuri	Ore temimbo’e tie’ỹ ojapopava’ekue upérõ (che) añanihínava’ekue	TENSE:PAS_PLU
Pe kerana jaipe’aha’ãva’erã ñandejehegui.	Pe kerana jaipe’aha’ãva’erã ñandejehegui.	NOCHANGE
Nde nderemoheñói ha’e ojupi kuri	Ñande ndañamoheñói ñande jajupi kuri	PERSON:1_PL_INC
Roguerohory. iporã chéve. hechapyrã.	Roguerohory. iporã chéve. hechapyrã.	NOCHANGE
Che ajavými iñeikotevẽva akuápe che rasy	Che ndajavýimi iñeikotevẽva akuápe ndacherásyi	TYPE:NEG
Pohanohára akãguapy ndombovuta ore temimbo’e tie’ỹ ojapopami	Pohanohára akãguapy ndombovúi ore temimbo’e tie’ỹ ojapopa	TENSE:PRE_SIM
Ore temimbo’e tie’ỹ ojapopami nde reñembosarái hína	Ore temimbo’e tie’ỹ ojapopata nde reñembosaráita hína	TENSE:FUT_SIM
Mokõi pu’ae atã ohóva ojoapykuéri ñe’ẽpehẽme, ara-ka’eve nomoheñóiva pukõi.	Mokõi pu’ae atã ohóva ojoapykuéri ñe’ẽpehẽme, ara-ka’eve nomoheñóiva pukõi.	NOCHANGE
Jaguarete katu itáicha okirirĩ. ama oikomi ka’aguy hovy’ûvare	Jaguarete katu itáicha ndokirirĩ. ama ndoikomi ka’aguy hovy’ûvare	TYPE:NEG
Nde reñembosarái hína ha’e ombojára kuri mbovy apekuéra	Nde reñembosaráita hína ha’e ombojárata mbovy apekuéra	TENSE:FUT_SIM
Ha’e ombojerekuri umi kutuhakuéra poro’o ha’e ombojára kuri mbovy apekuéra	Ha’e ndombojereikuri umi kutuhakuéra tuicháva ha’e ndombojárai kuri mbovy apekuéra	TYPE:NEG
Ama oikomi ka’aguy hovy’ûvare upérö (che) añani hína kuri	Nde reikomi ka’aguy hovy’ûvare upérõ (nde) reñanihínakuri	PERSON:2_SI
Che ajavými iñeikotevẽva akuápe ha’e oguapy	Che ndajavýimi iñeikotevẽva akuápe ha’e ndoguapýi	TYPE:NEG
Nde nderemoheñói ha’e nombotujaimi che ogyke - ha’e ndombyaimi che ogyke	Nde remoheñói ha’e ombotujaimi che ogyke - ha’e ombyaimi che ogyke	TYPE:AFF
Nde reñembosarái hína ha’ekuéra naiñemoñaréi kuri	Nde reñembosaráita hína ha’ekuéra naiñemoñaréita	TENSE:FUT_SIM
Rape guasu apytépe, ha imba’éva avei, umi ypa’ũ ñe’ẽ me’ẽ jehaipyre tetãguasu argentina	Rape guasu apytépe, ha imba’éva avei, umi ypa’ũ ñe’ẽ me’ẽ jehaipyre tetãguasu argentina	NOCHANGE
Ñembykuarahyresẽ asia	Ñembykuarahyresẽ asia	NOCHANGE
Yvypóra reko ha’e ha’ehaícha, noñeha’ãi oñemoambue, térã ijekuaa	Yvypóra reko ha’e ha’ehaícha, noñeha’ãi oñemoambue, térã ijekuaa	NOCHANGE
Ndaipórirõ sapy’ánte	Ndaipórirõ sapy’ánte	NOCHANGE
Ko aty ha’e upe ojehe’avéva ndaha’éiva heseguáre, ambue aty te’ỹi rehegua oikóva chaco yvytuaku gotyogua napéichai.	Ko aty ha’e upe ojehe’avéva ndaha’éiva heseguáre, ambue aty te’ỹi rehegua oikóva chaco yvytuaku gotyogua napéichai.	NOCHANGE
Okũmbymi hikuái che ajavými iñeikotevẽva akuápe	Ndokũmbýimi hikuái che ndajavýimi iñeikotevẽva akuápe	TYPE:NEG
Nde jyva oha’ãrõva eju haguã remopu’ã.	Nde jyva oha’ãrõva eju haguã remopu’ã.	NOCHANGE
Va’ekuépe guarã oiko rire guive ra’e upéicha.	Va’ekuépe guarã oiko rire guive ra’e upéicha.	NOCHANGE
Ojereraha tupão ka’akupépe. ko’ága peve pe ta’anga oime tupão ka’akupépe ha upepeve	Ojereraha tupão ka’akupépe. ko’ága peve pe ta’anga oime tupão ka’akupépe ha upepeve	NOCHANGE
Apurahéi kuri he’i ka’i ruvicha ta’ýra kuérape	Ndapurahéi kuri he’i ka’i ruvicha ita’ýrakuérape	TYPE:NEG
Nde poyvi araháta ko che pyti’ápe tomimbirei.	Nde poyvi araháta ko che pyti’ápe tomimbirei.	NOCHANGE
Oĩ oimeraẽ apỹinguéra kimi rehegua ojejuhúva tekoháre ha oĩ oimeraẽ ambuéva yvypórante ojapo.	Oĩ oimeraẽ apỹinguéra kimi rehegua ojejuhúva tekoháre ha oĩ oimeraẽ ambuéva yvypórante ojapo.	NOCHANGE
Jaguarete katu itáicha okirirĩ. mombe’ukuéra omboty kuri pende arete	Jaguarete katu itáicha okirirĩta. mombe’ukuéra ombotyta pende arete	TENSE:FUT_SIM
Ko’ã ñe’ẽriregua ojoaju’arã ñe’ẽ ijykereguáre.	Ko’ã ñe’ẽriregua ojoaju’arã ñe’ẽ ijykereguáre.	NOCHANGE
Oipuru hikuái ka’a ha ho’u terere. ha’e oguapy	Ndoipurui hikuái ka’a térã ho’u terere. ha’e ndoguapýi	TYPE:NEG
Ha’e ojupi kuri ore ndorokuave’ẽi umi tembi’ukuéra pytagua	Ñande jajupi kuri ñande ndañakuave’ẽi umi tembi’ukuéra pytagua	PERSON:1_PL_INC
Tesa’ỹi korápe ndapu’a rehóvo.	Tesa’ỹi korápe ndapu’a rehóvo.	NOCHANGE
Ko po ojupi apurahéi kuri	Ko po ndojupíri ndapurahéi kuri	TYPE:NEG
Ha’e nombotujaimi che ogyke - ha’e ndombyaimi che ogyke he’i ka’i ruvicha ta’ýra kuérape	Nde nderembotujáimi che ogyke - nde nerembyaimi che ogyke nde, ka’i ruvicha ere nde ta’yrakuérape	PERSON:2_SI
Temirendukuéra omongakuaa amo ñemuha osapukái kuri	Temirendukuéra ndomongakuaai amo ñemuha nosapukái kuri	TYPE:NEG
Mombe’ukuéra omboty kuri pende arete apurahéi kuri	Mombe’ukuéra ndombotyi kuri pende arete ndapurahéi kuri	TYPE:NEG
Ha oikytĩ ñande resa	Ha oikytĩ ñande resa	NOCHANGE
Okũmbymi hikuái che mba’éma ko ykua	Okũmbyta hikuái. che mba’éta ko ykua	TENSE:FUT_SIM
Amo ñemuha osapukái kuri ha’e oguapy	Amo ñemuha nosapukái kuri ha’e ndoguapýi	TYPE:NEG
Che rasy nde nderejapói	Ñande rasy ñande ndajajapói	PERSON:1_PL_INC
Temirendukuéra omongakuaa apurahéi kuri	Temirendukuéra ndomongakuaai ndapurahéi kuri	TYPE:NEG
Ko mombe’upy ohenduká kuri chéve che ru. amo ñemuha osapukái kuri	Ko mombe’upy ndohenduká kuri chéve che ru. amo ñemuha nosapukái kuri	TYPE:NEG
Che mba’éma ko ykua che ajavými iñeikotevẽva akuápe	Ndachemba’ei ko ykua che ndajavýimi iñeikotevẽva akuápe	TYPE:NEG
Jekupyty niko oĩ peteĩ pukavýpe,	Jekupyty niko oĩ peteĩ pukavýpe,	NOCHANGE
Ha’e oguapy che mba’éma ko ykua	Ha’e ndoguapýi ndachemba’ei ko ykua	TYPE:NEG
Okũmbymi hikuái ha’e ojupi kuri	Ñande ñakũmbýimi ñande jajupi kuri	PERSON:1_PL_INC
Ama oikomi ka’aguy hovy’ûvare he’i ka’i ruvicha ta’ýra kuérape	Nde reikomi ka’aguy hovy’ûvare nde, ka’i ruvicha ere nde ta’yrakuérape	PERSON:2_SI
Ha’e ojupi kuri ore temimbo’e tie’ỹ ojapopami	Ha’e ojupita ore temimbo’e tie’ỹ ojapopata	TENSE:FUT_SIM
Ama oikomi ka’aguy hovy’ûvare ko mombe’upy ohenduká kuri chéve che ru.	Ama oiko ka’aguy hovy’ûvare ko mombe’upy ohenduka chéve che ru.	TENSE:PRE_SIM
Amo ñemuha osapukái kuri ha’e nombotujaimi che ogyke - ha’e ndombyaimi che ogyke	Amo ñemuha osapukáiva’ekue ha’e ndombotujáiva’ekue che ogyke - ha’e ndombyaiva’ekue che ogyke	TENSE:PAS_PLU
Rayhupápe ñane retâ tuichakue javeve.	Rayhupápe ñane retâ tuichakue javeve.	NOCHANGE
Amo ñemuha osapukái kuri oipuru hikuái ka’a ha ho’u terere.	Amo ñemuha osapukáita oipuruta hikuái ka’a ha ho’uta terere.	TENSE:FUT_SIM
Che ajavými iñeikotevẽva akuápe ore ndorokuave’ẽi umi tembi’ukuéra pytagua	Che ajavýimi hína iñeikotevẽva akuápe ore ndorokuave’ẽi hina umi tembi’ukuéra pytagua	ASPECT:IPFV
Joyke’y paraguái, iporãma,	Joyke’y paraguái, iporãma,	NOCHANGE
Ha’e oguapy upérö (che) añani hína kuri	Ha’e oguapýva’ekue upérõ (che) añanihínava’ekue	TENSE:PAS_PLU
Ore ndorokuave’ẽi umi tembi’ukuéra pytagua ha’ekuéra naiñemoñaréi kuri	Ore rokuave’ẽ umi tembi’ukuéra pytagua ha’ekuéra oñemoñaréi kuri	TYPE:AFF
Maymáva aipota pe jehesarekomi sapy’aite	Maymáva aipota pe jehesarekomi sapy’aite	NOCHANGE
Ko po ojupi oipuru hikuái ka’a ha ho’u terere.	Ko po ndojupíri ndoipurui hikuái ka’a térã ho’u terere.	TYPE:NEG
Ndaipóri omo’ãva,	Ndaipóri omo’ãva,	NOCHANGE
Ijuru ñeimo’ã’ỹva ndojurata che aovevekuéra - ijuru ñeimo’ã’ỹva ndojuramo’ãi che aovevekuéra peẽ napejapómi ogyke pokã	Ijuru ñeimo’ã’ỹva ndojurai che aovevekuéra peẽ napejapói ogyke pokã	TENSE:PRE_SIM
Kuérape. ijapyte kuéra guágui ojeporavo va’erã peteĩ presidente, oñembopyahúva opa ary.	Kuérape. ijapyte kuéra guágui ojeporavo va’erã peteĩ presidente, oñembopyahúva opa ary.	NOCHANGE
Upérö (che) añani hína kuri nde nderemoheñói	Upérõ (ñande) ñañanihínakuri ñande ndañamoheñói	PERSON:1_PL_INC
Che ajavými iñeikotevẽva akuápe temirendukuéra omongakuaa	Che ndajavýimi iñeikotevẽva akuápe temirendukuéra ndomongakuaai	TYPE:NEG
Amo ñemuha osapukái kuri nde reñembosarái hína	Umíva ñemuhakuéra osapukái kuri ha’ekuéra oñembosarái hína	PERSON:3_PL
Pakova roguépe omo’â hembi’ukuéra. peẽ napejapómi ogyke pokã	Pakova roguépe remo’â nderembi’ukuéra. nde nderejapómi ogyke pokã	PERSON:2_SI
Peẽ napejapómi ogyke pokã ore ndorokuave’ẽi umi tembi’ukuéra pytagua	Peẽ pejapomi ogyke pokã ore rokuave’ẽ umi tembi’ukuéra pytagua	TYPE:AFF
Tembiguái ramo oiko	Tembiguái ramo oiko	NOCHANGE
Ha’e ombojára kuri mbovy apekuéra oipuru hikuái ka’a ha ho’u terere.	Ha’e ombojárata mbovy apekuéra oipuruta hikuái ka’a ha ho’uta terere.	TENSE:FUT_SIM
Che mba’éma ko ykua okũmbymi hikuái	Che mba’éta ko ykua okũmbyta hikuái.	TENSE:FUT_SIM
Nde reñembosarái hína pakova roguépe omo’â hembi’ukuéra.	Che añembosarái hína pakova roguépe amo’â cherembi’ukuéra.	PERSON:1_SI
Kuña porã resa para.	Kuña porã resa para.	NOCHANGE
Mombe’ukuéra omboty kuri pende arete ha’e ojupi kuri	Mombe’ukuéra omboty kuri hína pende arete ha’e ojupi kuri hína	ASPECT:IPFV
He’i ka’i ruvicha ta’ýra kuérape amo ñemuha osapukái kuri	He’i ka’i ruvicha ita’ýrakuérape amo ñemuha nosapukái kuri	TYPE:NEG
Okũmbymi hikuái upérö (che) añani hína kuri	Ñande ñakũmbýimi upérõ (ñande) ñañanihínakuri	PERSON:1_PL_INC
Ama oikomi ka’aguy hovy’ûvare ha’e nombotujaimi che ogyke - ha’e ndombyaimi che ogyke	Nde reikomi ka’aguy hovy’ûvare nde nderembotujáimi che ogyke - nde nerembyaimi che ogyke	PERSON:2_SI
Oipuru hikuái ka’a ha ho’u terere. ha’e oguapy	Nde reipuru ka’a ha re’u terere. nde reguapy	PERSON:2_SI
Ame’ẽ jave chupe opa mba’e	Ame’ẽ jave chupe opa mba’e	NOCHANGE
Ha ojejapóva oku’eva’erãha tetã ñe’ẽ	Ha ojejapóva oku’eva’erãha tetã ñe’ẽ	NOCHANGE
Peẽ napejapómi ogyke pokã che nañemoingeta	Nde nderejapómi ogyke pokã nde nareñemoingeta	PERSON:2_SI
Ha’e ojupi kuri ha’e ombojerekuri umi kutuhakuéra poro’o	Ha’e ndojupirí kuri ha’e ndombojereikuri umi kutuhakuéra tuicháva	TYPE:NEG
Nde reñembosarái hína pakova roguépe omo’â hembi’ukuéra.	Nde nereñembosaráiri hína pakova roguépe ndomo’âi hembi’ukuéra.	TYPE:NEG
Ñasaindy perepere pa’ũ rupi oñemboja mbeguekatu oúvo ava oguerúva poyvi pytã, morotĩ ha hovy ijapére.	Ñasaindy perepere pa’ũ rupi oñemboja mbeguekatu oúvo ava oguerúva poyvi pytã, morotĩ ha hovy ijapére.	NOCHANGE
Che mba’éma ko ykua ama oikomi ka’aguy hovy’ûvare	Nde mba’e ko ykua nde reikomi ka’aguy hovy’ûvare	PERSON:2_SI
Ko tekove ha’e peteĩ tasyo ha mayma hasývare oñembojara tembipotapy omoambuehaguã hupa	Ko tekove ha’e peteĩ tasyo ha mayma hasývare oñembojara tembipotapy omoambuehaguã hupa	NOCHANGE
Ha’ekuéra naiñemoñaréi kuri ha’e ndombojaruita	Ha’ekuéra oñemoñaréi kuri ha’e ombojaruita	TYPE:AFF
Ko mombe’upy ohenduká kuri chéve che ru. ha’e oguapy	Ko mombe’upy pemohenduká kuri chéve peê. peẽ peguapy	PERSON:2_PL
Ama oikomi ka’aguy hovy’ûvare ha’e ombojerekuri umi kutuhakuéra poro’o	Ama ndoikomi ka’aguy hovy’ûvare ha’e ndombojereikuri umi kutuhakuéra tuicháva	TYPE:NEG
Oipuru hikuái ka’a ha ho’u terere. okũmbymi hikuái	Ndoipurui hikuái ka’a térã ho’u terere. ndokũmbýimi hikuái	TYPE:NEG
Upérö (che) añani hína kuri oipuru hikuái ka’a ha ho’u terere.	Upérõ (nde) reñanihínakuri nde reipuru ka’a ha re’u terere.	PERSON:2_SI
Mitãkuña omoheñói peteĩ mitãkuña’íme ha omano. upe mitãkuña’i, hérava mani, ombovy’a kuri oĩháicha avakuérape.	Mitãkuña omoheñói peteĩ mitãkuña’íme ha omano. upe mitãkuña’i, hérava mani, ombovy’a kuri oĩháicha avakuérape.	NOCHANGE
Ha’e ojupi kuri ko mombe’upy ohenduká kuri chéve che ru.	Ha’e ojupita ko mombe’upy ohendukáta chéve che ru.	TENSE:FUT_SIM
Ko mombe’upy ohenduká kuri chéve che ru. ama oikomi ka’aguy hovy’ûvare	Ko mombe’upy ohenduka chéve che ru. ama oiko ka’aguy hovy’ûvare	TENSE:PRE_SIM
Peẽ napejapómi ogyke pokã che nañemoingeta	Peẽ napejapói ogyke pokã che nañemoingei	TENSE:PRE_SIM
Ha’e ojupi kuri temirendukuéra omongakuaa	Ha’e ojupi kuri hína temirendukuéra omongakuaa hína	ASPECT:IPFV
Ha’e ojupi kuri ha’e ndombojaruita	Che ajupi kuri che ndambojaruita	PERSON:1_SI
He’iséva moõ rupipa ojeguataha, tenda jeguataha.	He’iséva moõ rupipa ojeguataha, tenda jeguataha.	NOCHANGE
Che ñe’ẽmi kuatiápe	Che ñe’ẽmi kuatiápe	NOCHANGE
Mombe’ukuéra omboty kuri pende arete peẽ napejapómi ogyke pokã	Mombe’ukuéra omboty pende arete peẽ napejapói ogyke pokã	TENSE:PRE_SIM
Ku mbói oñorairõ ore ndorokuave’ẽi umi tembi’ukuéra pytagua	Ku mbói oñorairõmi ore ndorokuave’ẽimi umi tembi’ukuéra pytagua	TENSE:PAS_IMP
Ha’ekuéra he’i oĩha sa’ieterei pe ñana ndoguerekóiva pohã ha umívape ohenói ka’amarãmba’e.	Ha’ekuéra he’i oĩha sa’ieterei pe ñana ndoguerekóiva pohã ha umívape ohenói ka’amarãmba’e.	NOCHANGE
Amo ñemuha osapukái kuri temirendukuéra omongakuaa	Amo ñemuha nosapukái kuri temirendukuéra ndomongakuaai	TYPE:NEG
Ñane retã paraguay	Ñane retã paraguay	NOCHANGE
Apurahéi kuri che ajavými iñeikotevẽva akuápe	Apurahéitta che ajavýta iñeikotevẽva akuápe	TENSE:FUT_SIM
Mbo’eharakuéra ogueraha ñaneñe’ẽ panambi ha guyráicha	Mbo’eharakuéra ogueraha ñaneñe’ẽ panambi ha guyráicha	NOCHANGE
Ndikatúi va’erã oñembojo’a mokõi terã hetave tetãmini rehegua tembiapo ojepagáva,	Ndikatúi va’erã oñembojo’a mokõi terã hetave tetãmini rehegua tembiapo ojepagáva,	NOCHANGE
Pohanohára akãguapy ndombovuta upérö (che) añani hína kuri	Pohanohára akãguapy ndombovúiva’ekue upérõ (che) añanihínava’ekue	TENSE:PAS_PLU
Ko mombe’upy ohenduká kuri chéve che ru. ore temimbo’e tie’ỹ ojapopami	Ko mombe’upy ohenduka chéve che ru. ore temimbo’e tie’ỹ ojapopa	TENSE:PRE_SIM
Ko po ojupi ha’e ojupi kuri	Ko po ndojupíri ha’e ndojupirí kuri	TYPE:NEG
Chéngo ndaikuaái upévape. che mba’éma ko ykua	Ndéngo ndereikuaái upévape. nde mba’e ko ykua	PERSON:2_SI
Ha’e oguapy ama oikomi ka’aguy hovy’ûvare	Nde reguapy nde reikomi ka’aguy hovy’ûvare	PERSON:2_SI
Ore temimbo’e tie’ỹ ojapopami ku mbói oñorairõ	Ore temimbo’ekuéra tie’ỹ ojapopami umi mbóikuera oñorairõ	PERSON:3_PL
Ore ndorokuave’ẽi umi tembi’ukuéra pytagua nde nderejapói	Ñande ndañakuave’ẽi umi tembi’ukuéra pytagua ñande ndajajapói	PERSON:1_PL_INC
Ha’ekuéra ojekoha oñemiha	Ha’ekuéra ojekoha oñemiha	NOCHANGE
Ñe’ẽriregua jaipurukuaa opaichagua ñe’ẽ ndive ha omohesakã mba’éicha, araka’e, mamo, mba’ére ojehu ñe’ẽ ijykeregua omoandúva.	Ñe’ẽriregua jaipurukuaa opaichagua ñe’ẽ ndive ha omohesakã mba’éicha, araka’e, mamo, mba’ére ojehu ñe’ẽ ijykeregua omoandúva.	NOCHANGE
Oipuru hikuái ka’a ha ho’u terere. ama oikomi ka’aguy hovy’ûvare	Nde reipuru ka’a ha re’u terere. nde reikomi ka’aguy hovy’ûvare	PERSON:2_SI
Oveve ápe ha pépe	Oveve ápe ha pépe	NOCHANGE
Apurahéi kuri nde reñembosarái hína	Apurahéitta nde reñembosaráita hína	TENSE:FUT_SIM
Ore temimbo’e tie’ỹ ojapopami apurahéi kuri	Ore temimbo’ekuéra tie’ỹ ojapopami ha’ekuéra opurahéikuri	PERSON:3_PL
Ha’e oguapy nde reñembosarái hína	Ha’e oguapýkuri nde reñembosarái kuri hína	TENSE:PAS_REC
Nde nderemoheñói oipuru hikuái ka’a ha ho’u terere.	Ñande ndañamoheñói ñande jaipuru ka’a ha ja’u terere.	PERSON:1_PL_INC
Okũmbymi hikuái ore temimbo’e tie’ỹ ojapopami	Okũmbyta hikuái. ore temimbo’e tie’ỹ ojapopata	TENSE:FUT_SIM
Ha’e oguapy ku mbói oñorairõ	Hikuái oguapy umi mbóikuera oñorairõ	PERSON:3_PL
Chéngo ndaikuaái upévape. pohanohára akãguapy ndombovuta	Chéngo aikuaá upévape. pohanohára akãguapy ombovuta	TYPE:AFF
Ko po ojupi ama oikomi ka’aguy hovy’ûvare	Ko po ndojupíri ama ndoikomi ka’aguy hovy’ûvare	TYPE:NEG
Ha’e nombotujaimi che ogyke - ha’e ndombyaimi che ogyke nde reñembosarái hína	Ha’e ndombotujaikuri hina che ogyke - ha’e ndombyaikuri hina che ogyke nde reñembosarái kuri hína	TENSE:PAS_REC
Oguereko añetete ojekuaha va’erã opárupi, umi omba’apo haguépe ha ombopyhau va’erã opa ary.	Oguereko añetete ojekuaha va’erã opárupi, umi omba’apo haguépe ha ombopyhau va’erã opa ary.	NOCHANGE
Pakova roguépe omo’â hembi’ukuéra. ha’e ombojerekuri umi kutuhakuéra poro’o	Pakova roguépe remo’â nderembi’ukuéra. nde rembojerekuri umi kutuhakuéra tuicháva	PERSON:2_SI
Ha oguereko porundy ary.	Ha oguereko porundy ary.	NOCHANGE
Che ajavými iñeikotevẽva akuápe upérö (che) añani hína kuri	Che ajavy iñeikotevẽva akuápe upérõ (che) añani hína	TENSE:PRE_SIM
Nde nderejapói ijuru ñeimo’ã’ỹva ndojurata che aovevekuéra - ijuru ñeimo’ã’ỹva ndojuramo’ãi che aovevekuéra	Nde rejapo ijuru ñeimo’ã’ỹva ojurata che aovevekuéra	TYPE:AFF
Peteĩ karia’y marangatu	Peteĩ karia’y marangatu	NOCHANGE
Omoĩ ka’i ijyva guýpe ha oipykúi hóga rape.	Omoĩ ka’i ijyva guýpe ha oipykúi hóga rape.	NOCHANGE
Ha’ekuéra naiñemoñaréi kuri ha’e nombotujaimi che ogyke - ha’e ndombyaimi che ogyke	Ha’ekuéra naiñemoñaréita ha’e ombotujáta che ogyke - ha’e ombyaíta che ogyke	TENSE:FUT_SIM
Ha’e oguapy amo ñemuha osapukái kuri	Ha’e oguapýva’ekue amo ñemuha osapukáiva’ekue	TENSE:PAS_PLU
Che nañemoingeta chéngo ndaikuaái upévape.	Che añemoingeta chéngo aikuaá upévape.	TYPE:AFF
Ku mbói oñorairõ mombe’ukuéra omboty kuri pende arete	Ku mbói oñorairõ hína mombe’ukuéra omboty kuri hína pende arete	ASPECT:IPFV
Ha’e ombojára kuri mbovy apekuéra nde reñembosarái hína	Ha’e ndombojárai kuri mbovy apekuéra nde nereñembosaráiri hína	TYPE:NEG
Ha’e kuéra ndoikuaái.	Ha’e kuéra ndoikuaái.	NOCHANGE
Chéngo ndaikuaái upévape. ha’e ndombojaruita	Ndéngo ndereikuaái upévape. nde nderembojarui mo’ãi	PERSON:2_SI
Pakova roguépe omo’â hembi’ukuéra. che rasy	Pakova roguépe ndomo’âi hembi’ukuéra. ndacherásyi	TYPE:NEG
Investigaciones administrativas oñepyrũ va’erã omba’apo hembiapokuérape añetehápe, ha	Investigaciones administrativas oñepyrũ va’erã omba’apo hembiapokuérape añetehápe, ha	NOCHANGE
Ha’e oguapy peẽ napejapómi ogyke pokã	Nde reguapy nde nderejapómi ogyke pokã	PERSON:2_SI
Ha’e ombojára kuri mbovy apekuéra ha’e oguapy	Che ambojára kuri mbovy apekuéra che aguapy	PERSON:1_SI
Pakova roguépe omo’â hembi’ukuéra. ko mombe’upy ohenduká kuri chéve che ru.	Pakova roguépe pemo’â penderembi’ukuéra. ko mombe’upy pemohenduká kuri chéve peê.	PERSON:2_PL
Ñangarekoha rehegua.	Ñangarekoha rehegua.	NOCHANGE
Pende ru kokuépe ohova’erã	Pende ru kokuépe ohova’erã	NOCHANGE
Mombe’ukuéra omboty kuri pende arete okũmbymi hikuái	Mombe’ukuéra ndombotyi kuri pende arete ndokũmbýimi hikuái	TYPE:NEG
Temirendukuéra omongakuaa okũmbymi hikuái	Temirendukuéra ndomongakuaai ndokũmbýimi hikuái	TYPE:NEG
Ha’ekuéra naiñemoñaréi kuri oipuru hikuái ka’a ha ho’u terere.	Ha’ekuéra naiñemoñaréita oipuruta hikuái ka’a ha ho’uta terere.	TENSE:FUT_SIM
Ku mbói oñorairõ ha’e ndombojaruita	Ku mbói oñorairõ hína ha’e ndombojaruita hína	ASPECT:IPFV
Amo ñemuha osapukái kuri mombe’ukuéra omboty kuri pende arete	Amo ñemuha nosapukái kuri mombe’ukuéra ndombotyi kuri pende arete	TYPE:NEG
Ojeipe’a ichugui pe ikyrakue ha pe iso’okue hembývape oñemoĩ upe naranjahái rykue ha avei juky. kóva oñembojy jevy oreko sa’y pytãngy.	Ojeipe’a ichugui pe ikyrakue ha pe iso’okue hembývape oñemoĩ upe naranjahái rykue ha avei juky. kóva oñembojy jevy oreko sa’y pytãngy.	NOCHANGE
Upe tesorero ndopagái va’erã mba’eve, ndaha’éirõ contador oipota va’ekue	Upe tesorero ndopagái va’erã mba’eve, ndaha’éirõ contador oipota va’ekue	NOCHANGE
Amoñe’ẽ marandumbe’uha taryrýipe. pea añoite ha’e temiandugua’u ame’ẽva tapia che jupe	Amoñe’ẽ marandumbe’uha taryrýipe. pea añoite ha’e temiandugua’u ame’ẽva tapia che jupe	NOCHANGE
Hi’ãnte chéve ohendu	Hi’ãnte chéve ohendu	NOCHANGE
Ha’ekuéra naiñemoñaréi kuri pakova roguépe omo’â hembi’ukuéra.	Peë naipeñemoñaréi kuri pakova roguépe pemo’â penderembi’ukuéra.	PERSON:2_PL
Ore temimbo’e tie’ỹ ojapopami ama oikomi ka’aguy hovy’ûvare	Ore temimbo’e tie’ỹ nojapopami ama ndoikomi ka’aguy hovy’ûvare	TYPE:NEG
Ha’e oguapy ijuru ñeimo’ã’ỹva ndojurata che aovevekuéra - ijuru ñeimo’ã’ỹva ndojuramo’ãi che aovevekuéra	Ha’e oguapýva’ekue ijuru ñeimo’ã’ỹva ndojuraiva’ekue che aovevekuéra	TENSE:PAS_PLU
Amo ñemuha osapukái kuri apurahéi kuri	Amo ñemuha nosapukái kuri ndapurahéi kuri	TYPE:NEG
Jajapovaiva’ekue ha jajevy ñande jehe. mba’e tuichavéva ojejapova’ekue tekombo’épe	Jajapovaiva’ekue ha jajevy ñande jehe. mba’e tuichavéva ojejapova’ekue tekombo’épe	NOCHANGE
Ore ndorokuave’ẽi umi tembi’ukuéra pytagua apurahéi kuri	Ore ndorokuave’ẽi hina umi tembi’ukuéra pytagua apurahéihina kuri	ASPECT:IPFV
Maymáva rape.	Maymáva rape.	NOCHANGE
Ama oikomi ka’aguy hovy’ûvare ha’e oguapy	Nde reikomi ka’aguy hovy’ûvare nde reguapy	PERSON:2_SI
Ha’e nombotujaimi che ogyke - ha’e ndombyaimi che ogyke ku mbói oñorairõ	Ha’e ombotujáta che ogyke - ha’e ombyaíta che ogyke ku mbói oñorairõta	TENSE:FUT_SIM
Nde reñembosarái hína ha’e ombojerekuri umi kutuhakuéra poro’o	Nde nereñembosaráiri hína ha’e ndombojereikuri umi kutuhakuéra tuicháva	TYPE:NEG
Ha’e oguapy jaguarete katu itáicha okirirĩ.	Ha’e oguapýta jaguarete katu itáicha okirirĩta.	TENSE:FUT_SIM
Mombe’ukuéra omboty kuri pende arete pakova roguépe omo’â hembi’ukuéra.	Mombe’ukuéra ndombotyi kuri pende arete pakova roguépe ndomo’âi hembi’ukuéra.	TYPE:NEG
Ha’ekuéra naiñemoñaréi kuri upérö (che) añani hína kuri	Ha’ekuéra naiñemoñaréita upérõ (che) añanita hína	TENSE:FUT_SIM
Ha peteĩ rósape ijapaitérõ jasyrundy	Ha peteĩ rósape ijapaitérõ jasyrundy	NOCHANGE
Pohanohára akãguapy ndombovuta ama oikomi ka’aguy hovy’ûvare	Pohanohára akãguapy ndombovúi ama oiko ka’aguy hovy’ûvare	TENSE:PRE_SIM
Ko mombe’upy ohenduká kuri chéve che ru. ku mbói oñorairõ	Ko mombe’upy ohendukáta chéve che ru. ku mbói oñorairõta	TENSE:FUT_SIM
Nde reñembosarái hína apurahéi kuri	Nde reñembosaráita hína apurahéitta	TENSE:FUT_SIM
Ha’e ojupi kuri nde reñembosarái hína	Che ajupi kuri che añembosarái hína	PERSON:1_SI
Che rasy temirendukuéra omongakuaa	Ha’e hasy temirendu omongakuaa	PERSON:3_SI
Che nañemoingeta pakova roguépe omo’â hembi’ukuéra.	Nde nareñemoingeta pakova roguépe remo’â nderembi’ukuéra.	PERSON:2_SI
Ha’e ndombojaruita ore ndorokuave’ẽi umi tembi’ukuéra pytagua	Che ndambojaruita che ndaikuave’ẽi umi tembi’ukuéra pytagua	PERSON:1_SI
Añe’ẽse guaraní che mitãmi guive,	Añe’ẽse guaraní che mitãmi guive,	NOCHANGE
Ha’e oguapy pohanohára akãguapy ndombovuta	Ha’e oguapýva’ekue pohanohára akãguapy ndombovúiva’ekue	TENSE:PAS_PLU
Peẽ napejapómi ogyke pokã jaguarete katu itáicha okirirĩ.	Nde nderejapómi ogyke pokã nde katu itáicha rekirirĩ.	PERSON:2_SI
Amo ñemuha osapukái kuri ha’e oguapy	Umíva ñemuhakuéra osapukái kuri hikuái oguapy	PERSON:3_PL
Ore temimbo’e tie’ỹ ojapopami pakova roguépe omo’â hembi’ukuéra.	Ore temimbo’e tie’ỹ nojapopami pakova roguépe ndomo’âi hembi’ukuéra.	TYPE:NEG
Nde nderejapói ha’e ojupi kuri	Ñande ndajajapói ñande jajupi kuri	PERSON:1_PL_INC
Ita’ýrapema he’i	Ita’ýrapema he’i	NOCHANGE
Okũmbymi hikuái he’i ka’i ruvicha ta’ýra kuérape	Ndokũmbýimi hikuái he’i ka’i ruvicha ita’ýrakuérape	TYPE:NEG
Jesús ha itúva peteĩ persónante.	Jesús ha itúva peteĩ persónante.	NOCHANGE
Puerto montt táva	Puerto montt táva	NOCHANGE
Ha’e nombotujaimi che ogyke - ha’e ndombyaimi che ogyke nde nderejapói	Ñande ndañambotujáimi che ogyke - ñande ndañambyaimi che ogyke ñande ndajajapói	PERSON:1_PL_INC
Pakova roguépe omo’â hembi’ukuéra. okũmbymi hikuái	Pakova roguépe amo’â cherembi’ukuéra. che akũmbymi	PERSON:1_SI
Omba’apóvape, upéicharõ oñeme’ẽ va’erã oiporúvape tenonderãrupi, umi hembiapo minivévape ha	Omba’apóvape, upéicharõ oñeme’ẽ va’erã oiporúvape tenonderãrupi, umi hembiapo minivévape ha	NOCHANGE
Ko mombe’upy ohenduká kuri chéve che ru. ore temimbo’e tie’ỹ ojapopami	Ko mombe’upy ohendukáta chéve che ru. ore temimbo’e tie’ỹ ojapopata	TENSE:FUT_SIM
Che nañemoingeta pohanohára akãguapy ndombovuta	Che añemoingeta pohanohára akãguapy ombovuta	TYPE:AFF
Apurahéi kuri mombe’ukuéra omboty kuri pende arete	Apurahéi va’ekue mombe’ukuéra ombotyva’ekue pende arete	TENSE:PAS_PLU
Ha’e ndombojaruita ha’e nombotujaimi che ogyke - ha’e ndombyaimi che ogyke	Ha’e ndombojarui kuri ha’e ndombotujaikuri hina che ogyke - ha’e ndombyaikuri hina che ogyke	TENSE:PAS_REC
Mombe’ukuéra omboty kuri pende arete che ajavými iñeikotevẽva akuápe	Mombe’ukuéra ombotyta pende arete che ajavýta iñeikotevẽva akuápe	TENSE:FUT_SIM
Ko mombe’upy ohenduká kuri chéve che ru. ha’e ojupi kuri	Ko mombe’upy ndohenduká kuri chéve che ru. ha’e ndojupirí kuri	TYPE:NEG
Chéngo ndaikuaái upévape. ko mombe’upy ohenduká kuri chéve che ru.	Ndéngo ndereikuaái upévape. ko mombe’upy emohenduká kuri chéve nde.	PERSON:2_SI
Ko po ojupi nde reñembosarái hína	Ko po ojupíta nde reñembosaráita hína	TENSE:FUT_SIM
Nde nderejapói apurahéi kuri	Ha’ekuéra ndojapói ha’ekuéra opurahéikuri	PERSON:3_PL
Peẽ napejapómi ogyke pokã che rasy	Nde nderejapómi ogyke pokã nde nderasy	PERSON:2_SI
Mandi’o, avati, kurapepẽ ha karanda’y ru’ã omomimói ýrõ katu ombichy. mymba kamby ndo’úi, oimo’ãgui ovataha hesekuéra upe mymba reko.	Mandi’o, avati, kurapepẽ ha karanda’y ru’ã omomimói ýrõ katu ombichy. mymba kamby ndo’úi, oimo’ãgui ovataha hesekuéra upe mymba reko.	NOCHANGE
Ha’e ojupi kuri ku mbói oñorairõ	Ha’e ojupi kuri hína ku mbói oñorairõ hína	ASPECT:IPFV
Nde nderemoheñói ha’e ndombojaruita	Nde remoheñói ha’e ombojaruita	TYPE:AFF
Peẽ napejapómi ogyke pokã ha’ekuéra naiñemoñaréi kuri	Peẽ napejapói ogyke pokã ha’ekuéra ndoñemoñaréi	TENSE:PRE_SIM
Ha’e ombojerekuri umi kutuhakuéra poro’o nde reñembosarái hína	Ha’e ndombojereikuri umi kutuhakuéra tuicháva nde nereñembosaráiri hína	TYPE:NEG
Ko’ẽjúicha iporo’yva - chave upéichante hi’ãva	Ko’ẽjúicha iporo’yva - chave upéichante hi’ãva	NOCHANGE
Ku jepérõ oikotevẽ, ha’ekuérante oikuaáva	Ku jepérõ oikotevẽ, ha’ekuérante oikuaáva	NOCHANGE
Ha’e oguapy nde reñembosarái hína	Ha’e ndoguapýi nde nereñembosaráiri hína	TYPE:NEG
Ha’ekuéra naiñemoñaréi kuri temirendukuéra omongakuaa	Ha’ekuéra naiñemoñaréita temirendukuéra omongakuaata	TENSE:FUT_SIM
Ku avave oikuaa’ỹva	Ku avave oikuaa’ỹva	NOCHANGE
Peju mitã kuéra, peju pevy’a,	Peju mitã kuéra, peju pevy’a,	NOCHANGE
Mitã rehe’ỹ ndaikatúi jaiko	Mitã rehe’ỹ ndaikatúi jaiko	NOCHANGE
