Retãnguéra apytépe.	Retãnguéra apytépe.	NOCHANGE
Peteĩ mba’e okyhyjeitereíva ha’e yvy ñembyai, umi oikóva gueteri, oúvo pe amaguasu ha ojaho’ipa yvy, omanombáta, hete ha hi’ága avei.	Peteĩ mba’e okyhyjeitereíva ha’e yvy ñembyai, umi oikóva gueteri, oúvo pe amaguasu ha ojaho’ipa yvy, omanombáta, hete ha hi’ága avei.	NOCHANGE
Oñembokatupyryvéva ñane avañe’ême	Oñembokatupyryvéva ñane avañe’ême	NOCHANGE
Ohokuévo jaguakuéra oñarõmba hese	Ohokuévo jaguakuéra oñarõmba hese	NOCHANGE
Tape guasu táva mbukarétepe.	Tape guasu táva mbukarétepe.	NOCHANGE
Ha umi tapicha oipytyvõ mbaretevéva	Ha umi tapicha oipytyvõ mbaretevéva	NOCHANGE
Mbohovaikuéra iguapóva ha’e umi ombohapéva porandu pyahu	Mbohovaikuéra iguapóva ha’e umi ombohapéva porandu pyahu	NOCHANGE
Ohecha ha oñandu teko’asy ha poriahuverekópe ha péva omoheñói	Ohecha ha oñandu teko’asy ha poriahuverekópe ha péva omoheñói	NOCHANGE
Táva ñemohenda.	Táva ñemohenda.	NOCHANGE
- tavetã joaju pegua	- tavetã joaju pegua	NOCHANGE
Ñane ame hesaka ñandejára ñe’engue,	Ñane ame hesaka ñandejára ñe’engue,	NOCHANGE
Nde réra oikóva	Nde réra oikóva	NOCHANGE
Pyhare ha ára romoirũ haguã.	Pyhare ha ára romoirũ haguã.	NOCHANGE
Nde angaipa, nde angekói.	Nde angaipa, nde angekói.	NOCHANGE
Pyhare ha ára	Pyhare ha ára	NOCHANGE
Peteĩ ko’ẽme rejevy jeýrõ	Peteĩ ko’ẽme rejevy jeýrõ	NOCHANGE
Ãnduavy paha ha’e ñeimo’a ñehundi opáva ãnduavykuéra	Ãnduavy paha ha’e ñeimo’a ñehundi opáva ãnduavykuéra	NOCHANGE
( aguyje,aguyjevete,mba’etekópa,mba’éichapa nde ka’aru,asaje ,pyhareve ha pyhare,cheroryete rohechávo)	( aguyje,aguyjevete,mba’etekópa,mba’éichapa nde ka’aru,asaje ,pyhareve ha pyhare,cheroryete rohechávo)	NOCHANGE
Ipype omohe’õ	Ipype omohe’õ	NOCHANGE
Joyke’y paraguái, iporãma	Joyke’y paraguái, iporãma	NOCHANGE
Hi’ãnte oguãhẽvo ko’ẽju pytã	Hi’ãnte oguãhẽvo ko’ẽju pytã	NOCHANGE
Mitãnguéra osẽ oñembosarái.	Mitãnguéra osẽ oñembosarái.	NOCHANGE
Herakuâva pe távape umi karai poguasu.	Herakuâva pe távape umi karai poguasu.	NOCHANGE
Ñande jahypyiva’ekue ñamoirũva’ekue	Ñande jahypyiva’ekue ñamoirũva’ekue	NOCHANGE
Ha ñande resápe	Ha ñande resápe	NOCHANGE
Ojupi ha oguejy osapukái jeyjeývo chupe.	Ojupi ha oguejy osapukái jeyjeývo chupe.	NOCHANGE
Ojeguerekóva upérõ paraguaýpe (paraguaýpe) oipytyvõva ichupe ijeho	Ojeguerekóva upérõ paraguaýpe (paraguaýpe) oipytyvõva ichupe ijeho	NOCHANGE
Hembiapo ha’e oisãmbyhy avei ko kuatiahaipyre, upéi periódico	Hembiapo ha’e oisãmbyhy avei ko kuatiahaipyre, upéi periódico	NOCHANGE
Ndéngo avei táva ypykue ko ñane retâme ha	Ndéngo avei táva ypykue ko ñane retâme ha	NOCHANGE
Rapykuéri ojehecha mba’éichapa	Rapykuéri ojehecha mba’éichapa	NOCHANGE
Ko óga kóa chemba’e teete.	Ko óga kóa chemba’e teete.	NOCHANGE
Ha’ânga opaichaguáva.	Ha’ânga opaichaguáva.	NOCHANGE
Unidas (unesco), oñemboguapyva’ekue	Unidas (unesco), oñemboguapyva’ekue	NOCHANGE
Ojapo peteĩ kaguy, upevarã ombojehe’a yvope a, eíra, avati térã kurapepẽ ha oha’ãrõ hái.	Ojapo peteĩ kaguy, upevarã ombojehe’a yvope a, eíra, avati térã kurapepẽ ha oha’ãrõ hái.	NOCHANGE
Paraguái oñeha’ãva mboriahu reko’yre, techaukarã maymávape.	Paraguái oñeha’ãva mboriahu reko’yre, techaukarã maymávape.	NOCHANGE
Emba’apo ñaneñe’ẽre emopu’ã porãite.	Emba’apo ñaneñe’ẽre emopu’ã porãite.	NOCHANGE
Guasu óga kupépe oĩva rehe.	Guasu óga kupépe oĩva rehe.	NOCHANGE
Jeroky ñanemba’éva	Jeroky ñanemba’éva	NOCHANGE
Ha’ekuéra oiko porã	Ha’ekuéra oiko porã	NOCHANGE
Ñemoporãve tekoha rehegua.	Ñemoporãve tekoha rehegua.	NOCHANGE
Ha ñande katu iguýpe	Ha ñande katu iguýpe	NOCHANGE
Umi ndaikatuíva oje’e oñeguerokirirĩvaerã	Umi ndaikatuíva oje’e oñeguerokirirĩvaerã	NOCHANGE
Heñoihague peteĩ ára. hoky peteĩ ñande rapicha apytu’ũme (heñoisapy’a) ha péva	Heñoihague peteĩ ára. hoky peteĩ ñande rapicha apytu’ũme (heñoisapy’a) ha péva	NOCHANGE
Rembikoteve ha umi ñande ra’y, ra’y, ra’yre jey ohepyme’etava	Rembikoteve ha umi ñande ra’y, ra’y, ra’yre jey ohepyme’etava	NOCHANGE
Ñambotuichávo pe héra porã.	Ñambotuichávo pe héra porã.	NOCHANGE
Ko’ãga ojeitypa.	Ko’ãga ojeitypa.	NOCHANGE
Jekupyty niko ñande rekove sã.	Jekupyty niko ñande rekove sã.	NOCHANGE
Omba’apóvape, upéicharõ oñeme’ẽ va’erã oiporúvape tenonderãrupi, umi hembiapo minivévape ha	Omba’apóvape, upéicharõ oñeme’ẽ va’erã oiporúvape tenonderãrupi, umi hembiapo minivévape ha	NOCHANGE
Rembovy’áva che ko’ẽ	Rembovy’áva che ko’ẽ	NOCHANGE
Nañeha’ãva’erã niko ani ohasarei ko ára ha ñame’ẽ ojupe ñane mborayhu.	Nañeha’ãva’erã niko ani ohasarei ko ára ha ñame’ẽ ojupe ñane mborayhu.	NOCHANGE
Ñane retã rekove.	Ñane retã rekove.	NOCHANGE
Pe kyhyje opopo umi tuvicha korasõme. péicha rupi heta haihára oñemosẽ ñane retãgui.	Pe kyhyje opopo umi tuvicha korasõme. péicha rupi heta haihára oñemosẽ ñane retãgui.	NOCHANGE
Ha’e ohapyhína omboguehína	Ha’e ohapyhína omboguehína	NOCHANGE
Ha’ekuéra ojeruréva,	Ha’ekuéra ojeruréva,	NOCHANGE
Ombyaty hembi’urã.	Ombyaty hembi’urã.	NOCHANGE
Ha he’i guivepeẽme cheko kóva aipohanóta	Ha he’i guivepeẽme cheko kóva aipohanóta	NOCHANGE
Ko arapy kuápe.	Ko arapy kuápe.	NOCHANGE
Okakuaavévo oiko chugui kuña, kuñataĩ, ojapopaitéma tembiapo ogapýpegua, oipytyvõ isýpe.	Okakuaavévo oiko chugui kuña, kuñataĩ, ojapopaitéma tembiapo ogapýpegua, oipytyvõ isýpe.	NOCHANGE
Ha ára ha ára ojeruréva oréve	Ha ára ha ára ojeruréva oréve	NOCHANGE
- nde tuja pituva, sonseraiténgo peteĩ ña’ẽ pyahu, mba’eháiko nderejeruré pe pira’ípe ñande róga pyahurã.	- nde tuja pituva, sonseraiténgo peteĩ ña’ẽ pyahu, mba’eháiko nderejeruré pe pira’ípe ñande róga pyahurã.	NOCHANGE
Jekupyty niko oĩ ára ñande rapichápe ñame’ẽvape,	Jekupyty niko oĩ ára ñande rapichápe ñame’ẽvape,	NOCHANGE
Ñe’ẽkuéra oikoéva ha’e peteĩ taupaha heruguãkuéra tuichavéva	Ñe’ẽkuéra oikoéva ha’e peteĩ taupaha heruguãkuéra tuichavéva	NOCHANGE
(upe oñapymiva’ekue chugui ijyga, y porãhápe jepe oryrýi).	(upe oñapymiva’ekue chugui ijyga, y porãhápe jepe oryrýi).	NOCHANGE
Omba’apo tetãmini terã táva rembiapópe	Omba’apo tetãmini terã táva rembiapópe	NOCHANGE
Peteĩ karia’y marangatu	Peteĩ karia’y marangatu	NOCHANGE
Peteĩ ñe’ẽ ryru porã ha’e jehechaha mamo, rehekakuaaramo, retopa pe reimo’ãva	Peteĩ ñe’ẽ ryru porã ha’e jehechaha mamo, rehekakuaaramo, retopa pe reimo’ãva	NOCHANGE
Chae oipuru pohãrõ umi mba’e oguerekóva hekohápe. ndaipóri ha’ekuéraichagua	Chae oipuru pohãrõ umi mba’e oguerekóva hekohápe. ndaipóri ha’ekuéraichagua	NOCHANGE
(ojehechauka tembiapokuéra ka’a rehegua jovere távaygua kuéra pe)	(ojehechauka tembiapokuéra ka’a rehegua jovere távaygua kuéra pe)	NOCHANGE
Haperãme okúiva ára rekopýre ku ko’ẽ mboyve.	Haperãme okúiva ára rekopýre ku ko’ẽ mboyve.	NOCHANGE
Opakuévo ojehecha mboýpa oñemono’õ kuri viru.	Opakuévo ojehecha mboýpa oñemono’õ kuri viru.	NOCHANGE
Petei ka’arúpe huã oguata ohóvo ka’aguýre. ojesareko	Petei ka’arúpe huã oguata ohóvo ka’aguýre. ojesareko	NOCHANGE
Moõ rupipa oiko	Moõ rupipa oiko	NOCHANGE
Ohechaukáva yvyra ñemoingove ko tetãme ha ijyvyporápe.	Ohechaukáva yvyra ñemoingove ko tetãme ha ijyvyporápe.	NOCHANGE
Tapicha marina-guápe.	Tapicha marina-guápe.	NOCHANGE
Norohepyme’ẽi nde mba’ekuaarã ñandutiguávape jeike. kyta.	Norohepyme’ẽi nde mba’ekuaarã ñandutiguávape jeike. kyta.	NOCHANGE
Ombohory nde sýpe ne ñe’ê.	Ombohory nde sýpe ne ñe’ê.	NOCHANGE
Ñe’ẽrembyre ñe’ẽjopara	Ñe’ẽrembyre ñe’ẽjopara	NOCHANGE
Oñomongeta ñepyrũ.	Oñomongeta ñepyrũ.	NOCHANGE
Ha oipurúva chupekuéra hekoha ñembyaípe.	Ha oipurúva chupekuéra hekoha ñembyaípe.	NOCHANGE
Aguyjevete ndéve, teresa, maymáva ñane retãygua rérape.	Aguyjevete ndéve, teresa, maymáva ñane retãygua rérape.	NOCHANGE
Kamba paraguái, ava paraguái	Kamba paraguái, ava paraguái	NOCHANGE
Jagurete’i pire ojeguerohory tetã ambuépe ha oñembojegua pype óga iporãva.	Jagurete’i pire ojeguerohory tetã ambuépe ha oñembojegua pype óga iporãva.	NOCHANGE
Tavetã joaju pegua	Tavetã joaju pegua	NOCHANGE
Nemby, ñemby (paraguay).	Nemby, ñemby (paraguay).	NOCHANGE
Jekupyty niko oĩ mba’eme’ẽme ha ndaipóri tekorakate’ỹme,	Jekupyty niko oĩ mba’eme’ẽme ha ndaipóri tekorakate’ỹme,	NOCHANGE
Añónteva rehe ha iñe’ẽ ypykue ambuéva	Añónteva rehe ha iñe’ẽ ypykue ambuéva	NOCHANGE
Che táva guasu.	Che táva guasu.	NOCHANGE
Ñe’êpotymi, mba’e porâita	Ñe’êpotymi, mba’e porâita	NOCHANGE
(oñembohapejeýva pernambuco (tetãvore))	(oñembohapejeýva pernambuco (tetãvore))	NOCHANGE
Ha akói toiko porã.	Ha akói toiko porã.	NOCHANGE
Mba’éichapa pene ko’ë. ore rovy’a ikatu háre ko’apeve roguahë.	Mba’éichapa pene ko’ë. ore rovy’a ikatu háre ko’apeve roguahë.	NOCHANGE
Ha ombo’ypi omokã uhéi, kane’õ ñande rekove	Ha ombo’ypi omokã uhéi, kane’õ ñande rekove	NOCHANGE
Ha’ete mbyja	Ha’ete mbyja	NOCHANGE
Mbaraka purahéipe.	Mbaraka purahéipe.	NOCHANGE
Irundy ñe’ẽngue poravo atýra	Irundy ñe’ẽngue poravo atýra	NOCHANGE
Ñande ypy ñe’ê.	Ñande ypy ñe’ê.	NOCHANGE
Ko che purahéipe ha’éta ndéve	Ko che purahéipe ha’éta ndéve	NOCHANGE
Tavayguakuéra omba’apo mbarete ojapóvo tembiapo ñai’ũgui.	Tavayguakuéra omba’apo mbarete ojapóvo tembiapo ñai’ũgui.	NOCHANGE
Hyãsia ha tavetã joaju pegua	Hyãsia ha tavetã joaju pegua	NOCHANGE
Ha’ekuéra ndohechái nomondói	Ha’ekuéra ndohechái nomondói	NOCHANGE
Ñembosaraipavẽ atykatuete hetatetãgua	Ñembosaraipavẽ atykatuete hetatetãgua	NOCHANGE
Mitâ’ikuéra mbo’ehao marangatupegua	Mitâ’ikuéra mbo’ehao marangatupegua	NOCHANGE
Ko mba’e jehechaukarã ohupytyséva avei ha’e umi paraguaikuéra mba’ekuáa rehegua jehechauka ha avei ojekuaa ha oñemomba’eguasuhaguã.	Ko mba’e jehechaukarã ohupytyséva avei ha’e umi paraguaikuéra mba’ekuáa rehegua jehechauka ha avei ojekuaa ha oñemomba’eguasuhaguã.	NOCHANGE
Pe mba’e noñemohesakãiva ichupekuéra	Pe mba’e noñemohesakãiva ichupekuéra	NOCHANGE
Ko’ẽ ha jaikóva’erã mokõive pe kokuerére	Ko’ẽ ha jaikóva’erã mokõive pe kokuerére	NOCHANGE
Araíre pe nde pýre ojajái ñane retã.	Araíre pe nde pýre ojajái ñane retã.	NOCHANGE
Ñande rehe.	Ñande rehe.	NOCHANGE
Ani anga hesa’yju ovyvyha rupi opyta.	Ani anga hesa’yju ovyvyha rupi opyta.	NOCHANGE
So’o kangue ñemombo jaguape ndaha’ei porayhu. porayhu ha’e nde so’o kangue mboja’o nde rymba jagua ndíve nde vare’a jave ha’éichaite	So’o kangue ñemombo jaguape ndaha’ei porayhu. porayhu ha’e nde so’o kangue mboja’o nde rymba jagua ndíve nde vare’a jave ha’éichaite	NOCHANGE
Peteĩ ka’avo hérava aromita	Peteĩ ka’avo hérava aromita	NOCHANGE
Umi óga yvateite táva kuáite pegua.	Umi óga yvateite táva kuáite pegua.	NOCHANGE
Ha ome’ẽva chéve ko py’aguapy.	Ha ome’ẽva chéve ko py’aguapy.	NOCHANGE
Okakuaa porãramo avatity, oñemono’õ heta avati ra’ỹi	Okakuaa porãramo avatity, oñemono’õ heta avati ra’ỹi	NOCHANGE
Jepiguáicha pe nde áva, oguejývo nde ati’yre,	Jepiguáicha pe nde áva, oguejývo nde ati’yre,	NOCHANGE
Ha ikatuvéramo póra rehegua.	Ha ikatuvéramo póra rehegua.	NOCHANGE
Táva ndivei kuéra. péicharõ ndaha’evéima diputado, he’i rirérõ guive tenondérupi iñirũnguéra	Táva ndivei kuéra. péicharõ ndaha’evéima diputado, he’i rirérõ guive tenondérupi iñirũnguéra	NOCHANGE
Ha upéicha ohtirauka...	Ha upéicha ohtirauka...	NOCHANGE
Oñemongaraiva’ekue. ha’e ojapo ta’anga tupãope guarã. petei jey oho yvyra	Oñemongaraiva’ekue. ha’e ojapo ta’anga tupãope guarã. petei jey oho yvyra	NOCHANGE
Ikatúnte reporandu, oikuaa porã tupã.	Ikatúnte reporandu, oikuaa porã tupã.	NOCHANGE
Oje’e haguã oje’eséva ha ikatu haguã maymáva tetã oike pe arandu rekópe,	Oje’e haguã oje’eséva ha ikatu haguã maymáva tetã oike pe arandu rekópe,	NOCHANGE
Ha, upe ñambyasyvéva,	Ha, upe ñambyasyvéva,	NOCHANGE
Ndaha’éiva hesegua.	Ndaha’éiva hesegua.	NOCHANGE
Mbarete ha tembiasa arandu paraguái retã rehe ndorekíva editor,	Mbarete ha tembiasa arandu paraguái retã rehe ndorekíva editor,	NOCHANGE
Pe y rapére oiko umi mba’e ja’emava’ekue chagua, ndojepuruporãi rupi ka’aguy, tenda he’õha térã tujuguasu oĩva pe jerére rehegua.	Pe y rapére oiko umi mba’e ja’emava’ekue chagua, ndojepuruporãi rupi ka’aguy, tenda he’õha térã tujuguasu oĩva pe jerére rehegua.	NOCHANGE
Ko mymba oguereko peteĩ hatĩ guasu eteva itĩ ári, ikatu oreko peteĩ térã mokõi tĩ hatĩ.	Ko mymba oguereko peteĩ hatĩ guasu eteva itĩ ári, ikatu oreko peteĩ térã mokõi tĩ hatĩ.	NOCHANGE
Ndaikuaaivoínte ko chéve ojehúva	Ndaikuaaivoínte ko chéve ojehúva	NOCHANGE
Nde rejavykýirö ñe’ëpotýpe	Nde rejavykýirö ñe’ëpotýpe	NOCHANGE
Topyta ne akãme che ñe’ẽ,	Topyta ne akãme che ñe’ẽ,	NOCHANGE
Osyry hesay hetã pepo guýpe... ha okái.	Osyry hesay hetã pepo guýpe... ha okái.	NOCHANGE
He’ẽ asyvéva aipyte haguã.	He’ẽ asyvéva aipyte haguã.	NOCHANGE
Mbo’ehára ikatupyryveva’ekue	Mbo’ehára ikatupyryveva’ekue	NOCHANGE
Omimbi nomimbipáiva kuarahy rata omo’ã,	Omimbi nomimbipáiva kuarahy rata omo’ã,	NOCHANGE
Hasyhápe ñande pire ha oñepohano hagua tesa rasy.	Hasyhápe ñande pire ha oñepohano hagua tesa rasy.	NOCHANGE
Ndaipóri ko yvy ári	Ndaipóri ko yvy ári	NOCHANGE
Opavave ojepy’apy tĩatĩkuérare, avei kypekuéra opa ohóvo	Opavave ojepy’apy tĩatĩkuérare, avei kypekuéra opa ohóvo	NOCHANGE
Ojupi tuñe’ẽ karuguáre.	Ojupi tuñe’ẽ karuguáre.	NOCHANGE
Tavaguasu ojeaho’i reboso ñembyasýpe ha itindy, okirirĩ. ha’ete ku hasẽva kirirĩháme, tesay’ỹme. ikatu te’onguety voi ra’e.	Tavaguasu ojeaho’i reboso ñembyasýpe ha itindy, okirirĩ. ha’ete ku hasẽva kirirĩháme, tesay’ỹme. ikatu te’onguety voi ra’e.	NOCHANGE
Kóva ko ñe’ẽpoty	Kóva ko ñe’ẽpoty	NOCHANGE
Ko’â mitâ ho’u mba’e he’êmimi, jepémo ndahetái, ha’ekuéra ohecharamo	Ko’â mitâ ho’u mba’e he’êmimi, jepémo ndahetái, ha’ekuéra ohecharamo	NOCHANGE
Umi yrembe’ykuéra porã porã oñemyatyrõ kuri avei yguasu rembe’ýpe oñeñembosaraihagã opáichagua deporte ýpe oñeha’ãva.	Umi yrembe’ykuéra porã porã oñemyatyrõ kuri avei yguasu rembe’ýpe oñeñembosaraihagã opáichagua deporte ýpe oñeha’ãva.	NOCHANGE
Oñembohepypa umi so’o ko’aga.	Oñembohepypa umi so’o ko’aga.	NOCHANGE
Peguarãite, ha ojedecidi haguã añoite.	Peguarãite, ha ojedecidi haguã añoite.	NOCHANGE
Umi oguerekóva imombopyrã.	Umi oguerekóva imombopyrã.	NOCHANGE
Ñamopu’áke guarani ñe’ê	Ñamopu’áke guarani ñe’ê	NOCHANGE
Korea yvyapy jehecha guasu.	Korea yvyapy jehecha guasu.	NOCHANGE
Heñoi... sapy’a ñande ava ñe’ẽ purahéi joyvýpe	Heñoi... sapy’a ñande ava ñe’ẽ purahéi joyvýpe	NOCHANGE
Ndamáko henda porã.	Ndamáko henda porã.	NOCHANGE
Teroja tekome’ẽva katuetei ohova’erã tero rire.	Teroja tekome’ẽva katuetei ohova’erã tero rire.	NOCHANGE
Omoingove ha ombovy’áva	Omoingove ha ombovy’áva	NOCHANGE
Tetãmini ha táva mba’e.	Tetãmini ha táva mba’e.	NOCHANGE
Oúma opyta.	Oúma opyta.	NOCHANGE
Panambi rapykuéri.	Panambi rapykuéri.	NOCHANGE
Ha upéi tembiguái.	Ha upéi tembiguái.	NOCHANGE
Ñakyrã oreve opurahéi,	Ñakyrã oreve opurahéi,	NOCHANGE
Tetãyguakuérape prográma iñe’ẽ teépe.	Tetãyguakuérape prográma iñe’ẽ teépe.	NOCHANGE
Che jagua ovy’a ha omongu’e huguái ajapichyramo ichupe.	Che jagua ovy’a ha omongu’e huguái ajapichyramo ichupe.	NOCHANGE
Umi táva rehegua	Umi táva rehegua	NOCHANGE
Tekopykuaa apopýpe, ohupyty haguã ko’ã mba’e.	Tekopykuaa apopýpe, ohupyty haguã ko’ã mba’e.	NOCHANGE
Heñói, oñemboheko ha hoky pyahúva.	Heñói, oñemboheko ha hoky pyahúva.	NOCHANGE
Aipota ko’ãga rehechauka chéve	Aipota ko’ãga rehechauka chéve	NOCHANGE
Tuicha vy’ápe chavuku ou jevy yvy ape ári, upéicharõ jepe, maymávante oñani henonderãgui.	Tuicha vy’ápe chavuku ou jevy yvy ape ári, upéicharõ jepe, maymávante oñani henonderãgui.	NOCHANGE
Ohepyme’ẽkuri. heta pirapire ndaje oñeme’ẽkuri chupe. upégui ou rire,	Ohepyme’ẽkuri. heta pirapire ndaje oñeme’ẽkuri chupe. upégui ou rire,	NOCHANGE
Ñeembucú opyta ysyry paraná ha paraguái mbytépe.	Ñeembucú opyta ysyry paraná ha paraguái mbytépe.	NOCHANGE
Ojapóva yvy ha yvága.	Ojapóva yvy ha yvága.	NOCHANGE
Mitâ ha mitârusukuéra ogueromandu’ákuri upe ára guasuete opaite mbo’ehaópe. umi	Mitâ ha mitârusukuéra ogueromandu’ákuri upe ára guasuete opaite mbo’ehaópe. umi	NOCHANGE
Mbo’erã kapi’i guýpe	Mbo’erã kapi’i guýpe	NOCHANGE
- ko’ága guive oikóta ndehegui yvyra porupyrã.	- ko’ága guive oikóta ndehegui yvyra porupyrã.	NOCHANGE
Porã apo, ojapohápe tape okakuaa haguã, oñemomba’e haguã,	Porã apo, ojapohápe tape okakuaa haguã, oñemomba’e haguã,	NOCHANGE
Mba’eve ndajahechai	Mba’eve ndajahechai	NOCHANGE
Ko ñemohendápe oĩ óga yvateite táva paraguay pegua	Ko ñemohendápe oĩ óga yvateite táva paraguay pegua	NOCHANGE
Ojohayhúva ára	Ojohayhúva ára	NOCHANGE
Nde reikuaahaicha ymave guare,	Nde reikuaahaicha ymave guare,	NOCHANGE
Che ko hína chera’y	Che ko hína chera’y	NOCHANGE
Karai comi ohendu oñe’ëmondóramo chupe umi oka’úva ha ipochy.	Karai comi ohendu oñe’ëmondóramo chupe umi oka’úva ha ipochy.	NOCHANGE
Heta tapicha ijaty ha oñomongeta ypykuéra ñe’ẽ rehe amandaje guasúpe	Heta tapicha ijaty ha oñomongeta ypykuéra ñe’ẽ rehe amandaje guasúpe	NOCHANGE
Tekotevẽ ñamombareteve ha ñahendu avei umi ñe’ẽ poruharakuérape, ha ani ñande	Tekotevẽ ñamombareteve ha ñahendu avei umi ñe’ẽ poruharakuérape, ha ani ñande	NOCHANGE
Ko’ẽtĩ oñemboja	Ko’ẽtĩ oñemboja	NOCHANGE
Tetãmini yvy ojerereko va’erã distrito único-rõ ojeporavo haguã umi diputado ha senador	Tetãmini yvy ojerereko va’erã distrito único-rõ ojeporavo haguã umi diputado ha senador	NOCHANGE
Jepémo upéicha	Jepémo upéicha	NOCHANGE
Guyra ha yvytu oñesûpehêva	Guyra ha yvytu oñesûpehêva	NOCHANGE
Tenda ojehechaukahápe máva rembiapo ñeha’ãnga.	Tenda ojehechaukahápe máva rembiapo ñeha’ãnga.	NOCHANGE
Ku ára ha pyhare.	Ku ára ha pyhare.	NOCHANGE
Ha ombokuáva. (ju)	Ha ombokuáva. (ju)	NOCHANGE
Ñe’ẽndy óga rehegua	Ñe’ẽndy óga rehegua	NOCHANGE
Rehe gueteri ñe’ẽ ñane retãme.	Rehe gueteri ñe’ẽ ñane retãme.	NOCHANGE
Ñane ñe’ẽ guaraní yvytúre ojupi omyanyhẽ	Ñane ñe’ẽ guaraní yvytúre ojupi omyanyhẽ	NOCHANGE
Ha upépe reñemoĩ che ñe’ẽ nerehenduséiva	Ha upépe reñemoĩ che ñe’ẽ nerehenduséiva	NOCHANGE
Ha’ekuéra omba’apo, okaru ojuehe,	Ha’ekuéra omba’apo, okaru ojuehe,	NOCHANGE
(ohekýi ikyse ha ojoko chupe hikuái.)	(ohekýi ikyse ha ojoko chupe hikuái.)	NOCHANGE
Jajuayhu porã.	Jajuayhu porã.	NOCHANGE
Oikepaite mba’e tavarandugua oikóva mba’e apo rupive. heñói guive ava ojapo	Oikepaite mba’e tavarandugua oikóva mba’e apo rupive. heñói guive ava ojapo	NOCHANGE
He’isérõ ñekytỹ tetãmini yvy terã jurisdición jeheja, ha umíva nomomarãirõ upe oje’éva	He’isérõ ñekytỹ tetãmini yvy terã jurisdición jeheja, ha umíva nomomarãirõ upe oje’éva	NOCHANGE
Ha ichupe repurahéi.	Ha ichupe repurahéi.	NOCHANGE
Kóva ohechauka mávapa ñe’ẽtéva omoandúva apohare.	Kóva ohechauka mávapa ñe’ẽtéva omoandúva apohare.	NOCHANGE
Ko tetã pytuhẽ.	Ko tetã pytuhẽ.	NOCHANGE
Ha nde upépe ha’arõbo neypytu ha nde ko’ẽ.	Ha nde upépe ha’arõbo neypytu ha nde ko’ẽ.	NOCHANGE
Tetã andorra	Tetã andorra	NOCHANGE
Che ñe’ë osëséva ombokua yvytu.	Che ñe’ë osëséva ombokua yvytu.	NOCHANGE
Mitãnguéra oñemongeta mbo’ehára ndive.	Mitãnguéra oñemongeta mbo’ehára ndive.	NOCHANGE
-mba’ére peju péicha.oi orendive kuña ha mitá .pepytána ñañemongeta.	-mba’ére peju péicha.oi orendive kuña ha mitá .pepytána ñañemongeta.	NOCHANGE
Rajymi hasykatuetéva ndive, ha ha’e omonguerákuri ichupe. upéramo	Rajymi hasykatuetéva ndive, ha ha’e omonguerákuri ichupe. upéramo	NOCHANGE
Ha oñepyrũ oguata joa, oveve, osapukái	Ha oñepyrũ oguata joa, oveve, osapukái	NOCHANGE
Ñe’ê porãngue i jajeapysaka,	Ñe’ê porãngue i jajeapysaka,	NOCHANGE
Ko ñande yvy	Ko ñande yvy	NOCHANGE
Mayma yvypóra oguereko derecho ou ha oheovo tetãpyre ha oiporavóvo moõoikóta peteĩ tetã ryepype.	Mayma yvypóra oguereko derecho ou ha oheovo tetãpyre ha oiporavóvo moõoikóta peteĩ tetã ryepype.	NOCHANGE
Jahayhuva’erã ñande rapichápe	Jahayhuva’erã ñande rapichápe	NOCHANGE
Oñembojy aceite térã ñandýpe hakuporãvape. ha uperiremíntema oje’uva’erã.	Oñembojy aceite térã ñandýpe hakuporãvape. ha uperiremíntema oje’uva’erã.	NOCHANGE
Oikomi ñande apytépe karai aranduete.	Oikomi ñande apytépe karai aranduete.	NOCHANGE
A árape, ñande rekove	A árape, ñande rekove	NOCHANGE
Ha ipype omanóva.	Ha ipype omanóva.	NOCHANGE
Mitã ñembosaraipavẽ arahakúpe	Mitã ñembosaraipavẽ arahakúpe	NOCHANGE
Aipotaite ñaime oñondive, ñande rete ha ñande ánga,	Aipotaite ñaime oñondive, ñande rete ha ñande ánga,	NOCHANGE
Péicha che mopyahê.	Péicha che mopyahê.	NOCHANGE
Ame’ẽ ndéve aguyje	Ame’ẽ ndéve aguyje	NOCHANGE
Uperiremínte, ijasu gotyo oĩva, ojopy avei chupe peteĩ jyvaro’o.	Uperiremínte, ijasu gotyo oĩva, ojopy avei chupe peteĩ jyvaro’o.	NOCHANGE
Tupã ha yvypóra	Tupã ha yvypóra	NOCHANGE
Mba’e ipyahúva	Mba’e ipyahúva	NOCHANGE
Pyko’ẽ che ñe’ã kuápe.	Pyko’ẽ che ñe’ã kuápe.	NOCHANGE
Nde rekove ahayhúva.	Nde rekove ahayhúva.	NOCHANGE
Ju’i, kururu, karuguáre oñe’ê.	Ju’i, kururu, karuguáre oñe’ê.	NOCHANGE
Pikaia, peteĩ mymba sã atukupépe ymaguare.	Pikaia, peteĩ mymba sã atukupépe ymaguare.	NOCHANGE
Py’amokõi rovake, ñañembopy’apeteĩ hekojojáva rehe	Py’amokõi rovake, ñañembopy’apeteĩ hekojojáva rehe	NOCHANGE
Nde rekove hory ha ipotĩ	Nde rekove hory ha ipotĩ	NOCHANGE
Mborayhu tetãre ohasa tetãmbopy ári, ambuekuéra mba’e ári	Mborayhu tetãre ohasa tetãmbopy ári, ambuekuéra mba’e ári	NOCHANGE
Avañe’ẽ tahoky mayma angapýre tomokunu’ũ ko tetã	Avañe’ẽ tahoky mayma angapýre tomokunu’ũ ko tetã	NOCHANGE
Táva guasu argentino hesâi.	Táva guasu argentino hesâi.	NOCHANGE
Hesu ohovasa mitã-pe	Hesu ohovasa mitã-pe	NOCHANGE
Nde poty sa’yju oañuâmba ko ñane retâ	Nde poty sa’yju oañuâmba ko ñane retâ	NOCHANGE
Omba’apóva tekombo’e reheguápe, oipytyvõne ministerio hesegua rembiapópe, oĩva ñemyakã’i	Omba’apóva tekombo’e reheguápe, oipytyvõne ministerio hesegua rembiapópe, oĩva ñemyakã’i	NOCHANGE
Peteĩ mykũpopo ha imemby.	Peteĩ mykũpopo ha imemby.	NOCHANGE
(aty guasu rupive oñemba’apo arapytu rehe)	(aty guasu rupive oñemba’apo arapytu rehe)	NOCHANGE
Heta arandu porã, ijapytépe mba’e guasuha umi ñe’ê ojeguerováva ohóvo	Heta arandu porã, ijapytépe mba’e guasuha umi ñe’ê ojeguerováva ohóvo	NOCHANGE
Akã jeremi ko tetãre.	Akã jeremi ko tetãre.	NOCHANGE
Mba’éichapa ndepyhare	Mba’éichapa ndepyhare	NOCHANGE
. torypápe omboy’úva he’ẽvéva eirete.	. torypápe omboy’úva he’ẽvéva eirete.	NOCHANGE
Ko oikóva oiko peteĩ mboriahu ryguatã, okaraygua, róga guýpe. ojehecha opaichagua tembiporu. ka’arupytũ. arahaku.	Ko oikóva oiko peteĩ mboriahu ryguatã, okaraygua, róga guýpe. ojehecha opaichagua tembiporu. ka’arupytũ. arahaku.	NOCHANGE
Peteĩ vakara’y oroguigua	Peteĩ vakara’y oroguigua	NOCHANGE
Táva guasu irbid.	Táva guasu irbid.	NOCHANGE
Ñaimo’ã’ỹva’erã	Ñaimo’ã’ỹva’erã	NOCHANGE
Ndaha’ei mboriahu máva orekova sa’i mba’e, ha’e pe máva oipotava hetaiterei mba’e.	Ndaha’ei mboriahu máva orekova sa’i mba’e, ha’e pe máva oipotava hetaiterei mba’e.	NOCHANGE
Ko’ẽ rire ae osẽ oho mitãnguéra.	Ko’ẽ rire ae osẽ oho mitãnguéra.	NOCHANGE
Pe kerana jaipe’aha’ãva’erã ñandejehegui.	Pe kerana jaipe’aha’ãva’erã ñandejehegui.	NOCHANGE
Naiporãi eterei ko yvy ári ojepasáva,	Naiporãi eterei ko yvy ári ojepasáva,	NOCHANGE
Ome’ẽ permiso oñemoĩ haguã umi banco tetãguasu constitución-pe oĩháicha	Ome’ẽ permiso oñemoĩ haguã umi banco tetãguasu constitución-pe oĩháicha	NOCHANGE
Pe imba’ekuaa oikundaha ãngapýre	Pe imba’ekuaa oikundaha ãngapýre	NOCHANGE
Hi’upyra, upéicha nte avei.	Hi’upyra, upéicha nte avei.	NOCHANGE
Ojepyta ha mba’épepa ojeguevi	Ojepyta ha mba’épepa ojeguevi	NOCHANGE
Peteĩ tekoverana heraha topio oguerekóva ava japopyre arandu.	Peteĩ tekoverana heraha topio oguerekóva ava japopyre arandu.	NOCHANGE
Ava va’e ome’ẽ	Ava va’e ome’ẽ	NOCHANGE
Umi ipahápegua ndive.	Umi ipahápegua ndive.	NOCHANGE
Tetã ñembyatypyre	Tetã ñembyatypyre	NOCHANGE
Ko tembiapo rehegua	Ko tembiapo rehegua	NOCHANGE
Ñane ko’êmba peve.	Ñane ko’êmba peve.	NOCHANGE
Ha’éicha aturuñe’ẽ	Ha’éicha aturuñe’ẽ	NOCHANGE
Ha avei huekuéra ñane retãyguápe	Ha avei huekuéra ñane retãyguápe	NOCHANGE
... siémpre ojapo iporãva.	... siémpre ojapo iporãva.	NOCHANGE
He’iséva ava kuña hi’ary hetáva.	He’iséva ava kuña hi’ary hetáva.	NOCHANGE
Pe kosereva oñeñongatu areséramo oñemoĩva’erã pype, oñembosako’i aja, hetave asuka ha eira hũ.	Pe kosereva oñeñongatu areséramo oñemoĩva’erã pype, oñembosako’i aja, hetave asuka ha eira hũ.	NOCHANGE
Ombosa’ýva ko’ẽtĩ	Ombosa’ýva ko’ẽtĩ	NOCHANGE
Ñane rembi’u paraguái.	Ñane rembi’u paraguái.	NOCHANGE
Tetã amandaje	Tetã amandaje	NOCHANGE
Ne ma’ẽ rorýpe rembopiro’ỹvo ko che rekove	Ne ma’ẽ rorýpe rembopiro’ỹvo ko che rekove	NOCHANGE
Ñande rekove	Ñande rekove	NOCHANGE
Ko tembiesarái	Ko tembiesarái	NOCHANGE
Arovia, upéichane.	Arovia, upéichane.	NOCHANGE
Ñande, yvypóra,	Ñande, yvypóra,	NOCHANGE
Chavuku nomba’apóigui ndoguerekói hi’upyrã, upehaguére oñepyrũ omymbajukareipa, jepémo naiñembyahýi.	Chavuku nomba’apóigui ndoguerekói hi’upyrã, upehaguére oñepyrũ omymbajukareipa, jepémo naiñembyahýi.	NOCHANGE
Ñe’ẽndýi ñe’ẽteja ñe’ẽtéva teroja tero	Ñe’ẽndýi ñe’ẽteja ñe’ẽtéva teroja tero	NOCHANGE
Heñóivo ko’ẽ ñane retãpýre oikóma oguata,	Heñóivo ko’ẽ ñane retãpýre oikóma oguata,	NOCHANGE
Mávakuéra rovatavy ou pe ojeguerekogui mbohovái opa mba’epeguarã. mombe’uapy’ã arandu ou oguerekógui ñeporandu opa mba’epeguarã	Mávakuéra rovatavy ou pe ojeguerekogui mbohovái opa mba’epeguarã. mombe’uapy’ã arandu ou oguerekógui ñeporandu opa mba’epeguarã	NOCHANGE
Parana (tetãvore) táva	Parana (tetãvore) táva	NOCHANGE
Guarâ, oipe’a ñandehegui mba’e rasy, ombovevúi mba’e andu.	Guarâ, oipe’a ñandehegui mba’e rasy, ombovevúi mba’e andu.	NOCHANGE
Ha upéi ñande paraguái	Ha upéi ñande paraguái	NOCHANGE
Pehendumi oñe’ẽvo ko mbaraka che irũmi.	Pehendumi oñe’ẽvo ko mbaraka che irũmi.	NOCHANGE
Tetã paraguái (grn)	Tetã paraguái (grn)	NOCHANGE
He’i va’erã mba’éichapa ojeporúne terã oñevendéne yvy tetãmini mba’e.	He’i va’erã mba’éichapa ojeporúne terã oñevendéne yvy tetãmini mba’e.	NOCHANGE
Táva henda porã.	Táva henda porã.	NOCHANGE
Rehendu hi’ãva ñe’ẽ porãita,	Rehendu hi’ãva ñe’ẽ porãita,	NOCHANGE
Ñe’ẽtéva moambueha (accidentes)	Ñe’ẽtéva moambueha (accidentes)	NOCHANGE
Ñamoañetévo tuichaha umi ojejapóma va’ekue ha oñembohapéva pe	Ñamoañetévo tuichaha umi ojejapóma va’ekue ha oñembohapéva pe	NOCHANGE
Ha’ekuéra oryryietereirasa omomorãitereirasa	Ha’ekuéra oryryietereirasa omomorãitereirasa	NOCHANGE
Che mopotĩ haguã nde ruguy.	Che mopotĩ haguã nde ruguy.	NOCHANGE
Rehehápe ha hovy ojegueroayvúvo nane retâ rekosâso.	Rehehápe ha hovy ojegueroayvúvo nane retâ rekosâso.	NOCHANGE
Ñorãirõ ha’e umi ndoikuaaivapeguarã mba’e porãite	Ñorãirõ ha’e umi ndoikuaaivapeguarã mba’e porãite	NOCHANGE
Ha umi ambue kuéra vicho okyhyje voi guasúgui.	Ha umi ambue kuéra vicho okyhyje voi guasúgui.	NOCHANGE
Yvy marañe’ỹ.	Yvy marañe’ỹ.	NOCHANGE
Ambue mbya’atyrekokuéra omba’apóva orendive	Ambue mbya’atyrekokuéra omba’apóva orendive	NOCHANGE
Ku mitã kambúicha herekua ku’áre.	Ku mitã kambúicha herekua ku’áre.	NOCHANGE
Ohupytyha peve.	Ohupytyha peve.	NOCHANGE
Mitã ñembosarairã.	Mitã ñembosarairã.	NOCHANGE
Pota rupi. hákatu, ojepyso mbaretemi	Pota rupi. hákatu, ojepyso mbaretemi	NOCHANGE
Che ahesyva’erã amokãva’erã	Che ahesyva’erã amokãva’erã	NOCHANGE
Pehechápa umi guyrati’etã pe karugua jahasa ramo’ápe.	Pehechápa umi guyrati’etã pe karugua jahasa ramo’ápe.	NOCHANGE
Chéve ogueru nde kuatiañe’ẽ,	Chéve ogueru nde kuatiañe’ẽ,	NOCHANGE
Ndikatúi va’erã oñembojo’a mokõi terã hetave tetãmini rehegua tembiapo ojepagáva,	Ndikatúi va’erã oñembojo’a mokõi terã hetave tetãmini rehegua tembiapo ojepagáva,	NOCHANGE
Tavakuairetã chína momorãhéi	Tavakuairetã chína momorãhéi	NOCHANGE
Ohechaukahápe hikuái ijeroviakatu ñande	Ohechaukahápe hikuái ijeroviakatu ñande	NOCHANGE
Ipukuvéva ha oñemyatyrõ va’ekue reheve, terã opyta upe oñepyrũ haguéicha, ndaha’éirõ umi	Ipukuvéva ha oñemyatyrõ va’ekue reheve, terã opyta upe oñepyrũ haguéicha, ndaha’éirõ umi	NOCHANGE
Ñ- ñemby (paraguay)	Ñ- ñemby (paraguay)	NOCHANGE
Ñande jaguata ñande ñamba’apo	Ñande jaguata ñande ñamba’apo	NOCHANGE
Ha ojejapóva oku’eva’erãha tetã ñe’ẽ	Ha ojejapóva oku’eva’erãha tetã ñe’ẽ	NOCHANGE
Ko tendápe oñembohysýi kuatiañe’ê iguerekopýpe ndaipórivape mba’eve guarani ñe’ê rehegua.	Ko tendápe oñembohysýi kuatiañe’ê iguerekopýpe ndaipórivape mba’eve guarani ñe’ê rehegua.	NOCHANGE
Tetã joaju pavẽ ñe’ẽ oguenohẽva ñande ypykuéra direito rehegua.	Tetã joaju pavẽ ñe’ẽ oguenohẽva ñande ypykuéra direito rehegua.	NOCHANGE
Mahe’ẽ, mba’e he’ẽ - coisa doce.	Mahe’ẽ, mba’e he’ẽ - coisa doce.	NOCHANGE
Itajeresoha yvyty ombojeréva, hyãsia retãme.	Itajeresoha yvyty ombojeréva, hyãsia retãme.	NOCHANGE
Mavavépe omba’apóva tetãmini rehegua tembiapópe ta ha’e ha’éva, omba’apo aja ndikatúi	Mavavépe omba’apóva tetãmini rehegua tembiapópe ta ha’e ha’éva, omba’apo aja ndikatúi	NOCHANGE
Ahendu javérõ ñande purahéi.	Ahendu javérõ ñande purahéi.	NOCHANGE
Mburuvicha tee pyvéipe, to ñehendu he’iva ha’ekuéra, sapy’a peteĩ decisión ohupytýrõ ha	Mburuvicha tee pyvéipe, to ñehendu he’iva ha’ekuéra, sapy’a peteĩ decisión ohupytýrõ ha	NOCHANGE
- cheropehyive mbarakaja iko’ẽ va’ekue poste akã árigui.	- cheropehyive mbarakaja iko’ẽ va’ekue poste akã árigui.	NOCHANGE
Ko hyse haimbe ombosa’i porã so’o.	Ko hyse haimbe ombosa’i porã so’o.	NOCHANGE
Pũrũrũgui (tyapu oikóva ñande jurúpe ñamongu’írõ tembi’u atã).	Pũrũrũgui (tyapu oikóva ñande jurúpe ñamongu’írõ tembi’u atã).	NOCHANGE
Toiko ku mba’e iporãva ha nde terehecha’ỹ.	Toiko ku mba’e iporãva ha nde terehecha’ỹ.	NOCHANGE
Hetaitéma ko tetãre, oikóva okaru rei.	Hetaitéma ko tetãre, oikóva okaru rei.	NOCHANGE
Umíva niko ohuguy’o ha ombopy’aropu ohóvo ko ñande yvy guasuetépe. ndoúi ha	Umíva niko ohuguy’o ha ombopy’aropu ohóvo ko ñande yvy guasuetépe. ndoúi ha	NOCHANGE
Ha mitã mimi opurahéi,	Ha mitã mimi opurahéi,	NOCHANGE
Itáva ha itáva rembiasakue mbo’ehára	Itáva ha itáva rembiasakue mbo’ehára	NOCHANGE
Avevúi nde ysyrýre che ñe’ã ojahu	Avevúi nde ysyrýre che ñe’ã ojahu	NOCHANGE
Ãngapyhy ome’ẽva kuatia ñe’ẽ tuja moñe’ẽ ha’e jeikuaa noikoteveĩha mbohovai	Ãngapyhy ome’ẽva kuatia ñe’ẽ tuja moñe’ẽ ha’e jeikuaa noikoteveĩha mbohovai	NOCHANGE
Oho chaco ñorãirõhápe, oipysyrõvo ñane retã.	Oho chaco ñorãirõhápe, oipysyrõvo ñane retã.	NOCHANGE
Ojehechakuaa pe tekopykuaa tuicha mba’eha oñemombarete haguã	Ojehechakuaa pe tekopykuaa tuicha mba’eha oñemombarete haguã	NOCHANGE
Iporãmínte ha nde.	Iporãmínte ha nde.	NOCHANGE
Tetã(nguéra)	Tetã(nguéra)	NOCHANGE
Mokõive ndaje imandu’ákuri upérõ umi hogaykeregua ñe’ẽnguére. ha’ekuéra niko	Mokõive ndaje imandu’ákuri upérõ umi hogaykeregua ñe’ẽnguére. ha’ekuéra niko	NOCHANGE
Ahechárõ jasy ahecha ipype nde rova	Ahechárõ jasy ahecha ipype nde rova	NOCHANGE
Upégui mbohapy ko’ëme oje’ói jey hikuái. mba’eve nombopúi.	Upégui mbohapy ko’ëme oje’ói jey hikuái. mba’eve nombopúi.	NOCHANGE
Ijatyguasu jepivegua ojejapova’ekue paraguaýpe,	Ijatyguasu jepivegua ojejapova’ekue paraguaýpe,	NOCHANGE
Ñemenda akointerâme upe imbo’epy omohu’âvare ndive, ha’e	Ñemenda akointerâme upe imbo’epy omohu’âvare ndive, ha’e	NOCHANGE
Mbo’ehao - kuatiañe’ẽ -jasyteĩ -arateĩ	Mbo’ehao - kuatiañe’ẽ -jasyteĩ -arateĩ	NOCHANGE
Umi mba’asy tekove rasẽ ñe’ẽ	Umi mba’asy tekove rasẽ ñe’ẽ	NOCHANGE
Upéicha avei,	Upéicha avei,	NOCHANGE
Che sy porã yvoty	Che sy porã yvoty	NOCHANGE
Peteĩ tuguaipopo ojejuhúva heta.	Peteĩ tuguaipopo ojejuhúva heta.	NOCHANGE
Ñe’ẽ ha tekotee ñemboyke.	Ñe’ẽ ha tekotee ñemboyke.	NOCHANGE
Mymbakuéra vare’águi ndaikatúi oñani.	Mymbakuéra vare’águi ndaikatúi oñani.	NOCHANGE
Ñahenduramo oñe’ẽ	Ñahenduramo oñe’ẽ	NOCHANGE
Mbo’ehára pyahu ikatupyryvéva	Mbo’ehára pyahu ikatupyryvéva	NOCHANGE
Ha ojekuaa mba’éichapa	Ha ojekuaa mba’éichapa	NOCHANGE
Oyvárapy mba’ekuaágui	Oyvárapy mba’ekuaágui	NOCHANGE
Ñemiháme. oikóje ohapera’arõ mitãkuña osẽva asajerei hógagui,	Ñemiháme. oikóje ohapera’arõ mitãkuña osẽva asajerei hógagui,	NOCHANGE
Jekupyty niko oĩ peteĩ pukavýpe,	Jekupyty niko oĩ peteĩ pukavýpe,	NOCHANGE
Paraguaigua oguereko gueteri pe sasõ ypykue rehegua. isasõ guive hyepýpe oĩporãma.	Paraguaigua oguereko gueteri pe sasõ ypykue rehegua. isasõ guive hyepýpe oĩporãma.	NOCHANGE
Tape guasu táva mbisáu-pe.	Tape guasu táva mbisáu-pe.	NOCHANGE
Ojejohéi jey umi yva y ro’ysãme, ojejopy vevuimiva’erã pevarã peteĩteĩ ha ojeity jey y ro’ysã upe mboyve oñemoĩ haguépema eira hũ.	Ojejohéi jey umi yva y ro’ysãme, ojejopy vevuimiva’erã pevarã peteĩteĩ ha ojeity jey y ro’ysã upe mboyve oñemoĩ haguépema eira hũ.	NOCHANGE
Ojeporekarõguare, mba’éichapa	Ojeporekarõguare, mba’éichapa	NOCHANGE
Tetãguasu rehegua jeporu, avei umi garantía ha derecho oĩva mokõivépe.	Tetãguasu rehegua jeporu, avei umi garantía ha derecho oĩva mokõivépe.	NOCHANGE
He’iséva ñe’êpehê upéigua paha.	He’iséva ñe’êpehê upéigua paha.	NOCHANGE
Ha yvytúre amyasãi...	Ha yvytúre amyasãi...	NOCHANGE
Kuña sarigue oikomava’ekue ko’ápe ha pépe	Kuña sarigue oikomava’ekue ko’ápe ha pépe	NOCHANGE
Aikuaa ñe’ẽ poty itekotevẽteha, hákatu nda’ekuaai mba’erãpa	Aikuaa ñe’ẽ poty itekotevẽteha, hákatu nda’ekuaai mba’erãpa	NOCHANGE
Sapy’arãichante gua’u	Sapy’arãichante gua’u	NOCHANGE
Jha avei py’a porã ñajha-ã ñambopoty.	Jha avei py’a porã ñajha-ã ñambopoty.	NOCHANGE
Mba’ekuaarã ñemiguáva rehegua	Mba’ekuaarã ñemiguáva rehegua	NOCHANGE
Ñambosako’i haguâ té, ndojeporu va’erâi araka’eve tembiporu iñerrúmbeva. upéichante avei ñambosako’ívo yva ha ka’avoguigua.	Ñambosako’i haguâ té, ndojeporu va’erâi araka’eve tembiporu iñerrúmbeva. upéichante avei ñambosako’ívo yva ha ka’avoguigua.	NOCHANGE
Ñande jajatygua’u ñambopugua’u	Ñande jajatygua’u ñambopugua’u	NOCHANGE
(torýpe ojejapo aty guasu guyra yjere rehegua)	(torýpe ojejapo aty guasu guyra yjere rehegua)	NOCHANGE
Reikuaaporã ramo temiandu’yta ñe’ẽkuéra osẽ ha’ẽño	Reikuaaporã ramo temiandu’yta ñe’ẽkuéra osẽ ha’ẽño	NOCHANGE
. ñe’ẽ yvoty guaraní	. ñe’ẽ yvoty guaraní	NOCHANGE
Oipurukuaaha umi ñe’ë ombojoajúva ijeheguivoi.	Oipurukuaaha umi ñe’ë ombojoajúva ijeheguivoi.	NOCHANGE
Pytãgua kuéra poguýpe.	Pytãgua kuéra poguýpe.	NOCHANGE
Ñane ñe’ã rupipávo herekua ára pytu	Ñane ñe’ã rupipávo herekua ára pytu	NOCHANGE
Ojapo yvy ñemboja’o oñemba’apo porãve haguã administración-pe.	Ojapo yvy ñemboja’o oñemba’apo porãve haguã administración-pe.	NOCHANGE
Ñe’ẽteéramo mamo oñemba’apohápe.	Ñe’ẽteéramo mamo oñemba’apohápe.	NOCHANGE
Anichéne opuka guaikuru ñande rehe.	Anichéne opuka guaikuru ñande rehe.	NOCHANGE
. mbarete ha porãnga, purahéi, pire porã,	. mbarete ha porãnga, purahéi, pire porã,	NOCHANGE
. jahechava’erã upérõ hetaite mba’eiporãva	. jahechava’erã upérõ hetaite mba’eiporãva	NOCHANGE
Rayhupápe ñane retâ tuichakue javeve.	Rayhupápe ñane retâ tuichakue javeve.	NOCHANGE
Guaraniñe’ẽ chemopu’ãjey va’erã che ñe’ẽteete,	Guaraniñe’ẽ chemopu’ãjey va’erã che ñe’ẽteete,	NOCHANGE
Tetãnguéra rysýi ava hetakuére	Tetãnguéra rysýi ava hetakuére	NOCHANGE
Ijaruru, ñeimo’ã ambu’a.	Ijaruru, ñeimo’ã ambu’a.	NOCHANGE
Nde rehe ama’ẽrõ chemo’ãngaipáva,	Nde rehe ama’ẽrõ chemo’ãngaipáva,	NOCHANGE
Heta te’ỹi oiko ápe ha pe rupi, ojejapohápe imba’erepy guive tenda ñemuha meve.	Heta te’ỹi oiko ápe ha pe rupi, ojejapohápe imba’erepy guive tenda ñemuha meve.	NOCHANGE
Ko yvy tuichakue javeve	Ko yvy tuichakue javeve	NOCHANGE
Ñe’ê pu porã	Ñe’ê pu porã	NOCHANGE
Akóinte nereñoijeyva’erâ opaite mba’erasy rehasava’ekuégui ha emombaretévo jerovia ndejehe remokechêta taha’eha’éva mba’evaípe	Akóinte nereñoijeyva’erâ opaite mba’erasy rehasava’ekuégui ha emombaretévo jerovia ndejehe remokechêta taha’eha’éva mba’evaípe	NOCHANGE
Topytánte ha’ekuéra	Topytánte ha’ekuéra	NOCHANGE
Ha sapy’ánte tesaýpe,	Ha sapy’ánte tesaýpe,	NOCHANGE
Mbo’ehaópe avañe’ẽre mborayhu ipotypa jahechakuaa	Mbo’ehaópe avañe’ẽre mborayhu ipotypa jahechakuaa	NOCHANGE
Heta mba’yruguata oguereko ko tavaguasu ogueraháva avakuéra imba’apohápe. ko tavaguasu oñembojoaju paraguýre.	Heta mba’yruguata oguereko ko tavaguasu ogueraháva avakuéra imba’apohápe. ko tavaguasu oñembojoaju paraguýre.	NOCHANGE
Porãguerojerápe hasy oje’ehaguã peteĩ mba’e iporãitéva oje’e’ỹramo háicha mba’eve	Porãguerojerápe hasy oje’ehaguã peteĩ mba’e iporãitéva oje’e’ỹramo háicha mba’eve	NOCHANGE
Avei oñembokuatiávo iñe’ẽ teépe.	Avei oñembokuatiávo iñe’ẽ teépe.	NOCHANGE
Oikuaauka va’erã	Oikuaauka va’erã	NOCHANGE
Ndaha’éi che ha’ehaguére. mba’e rechaharekuéra he’ihaguére katu.	Ndaha’éi che ha’ehaguére. mba’e rechaharekuéra he’ihaguére katu.	NOCHANGE
Ani nde resarái che ñe’ẽgui,	Ani nde resarái che ñe’ẽgui,	NOCHANGE
Ha avy’avaha ahechárõ ñeha’ãme	Ha avy’avaha ahechárõ ñeha’ãme	NOCHANGE
Pukavy ha tetia’épe	Pukavy ha tetia’épe	NOCHANGE
Tekotevẽ oñembo’e tekoha reheguáre opárupi ha opaichave.	Tekotevẽ oñembo’e tekoha reheguáre opárupi ha opaichave.	NOCHANGE
Amoite ahecha kuimba’ekuéra, che rapicha	Amoite ahecha kuimba’ekuéra, che rapicha	NOCHANGE
Mba’e vai jajapóva ndoguerui py’aro ha a’e’ỹ ogueruhaícha ñande rembiapo porã	Mba’e vai jajapóva ndoguerui py’aro ha a’e’ỹ ogueruhaícha ñande rembiapo porã	NOCHANGE
Upémarõ oñembojave ha ojapysaka hesekuéra, ohendupaite he’íva hikuái.	Upémarõ oñembojave ha ojapysaka hesekuéra, ohendupaite he’íva hikuái.	NOCHANGE
Ha’e oĩkuri avei umi omoheñoiva’ekue autores paraguayos	Ha’e oĩkuri avei umi omoheñoiva’ekue autores paraguayos	NOCHANGE
Oiko opaichagua mymba sã atukupépe, ha oikove opa rendápe, ikatu oĩme ýre térã yvýre.	Oiko opaichagua mymba sã atukupépe, ha oikove opa rendápe, ikatu oĩme ýre térã yvýre.	NOCHANGE
Hógape kuéra peve.	Hógape kuéra peve.	NOCHANGE
Ha nde nereñói chepype.	Ha nde nereñói chepype.	NOCHANGE
Ndaikuaái mba’épa ajapóta	Ndaikuaái mba’épa ajapóta	NOCHANGE
Umi ikatupyryvéva omyasãi ñe’ẽ guaraní iporãveháicha	Umi ikatupyryvéva omyasãi ñe’ẽ guaraní iporãveháicha	NOCHANGE
Oñembohãimbiti ha oisu’úvo ichupe opyta omanórõ guáicha.	Oñembohãimbiti ha oisu’úvo ichupe opyta omanórõ guáicha.	NOCHANGE
Aháta mante ajeheka ambue tetãme. ape ndaipóri mba’eve.	Aháta mante ajeheka ambue tetãme. ape ndaipóri mba’eve.	NOCHANGE
Hikuái hi’ãnguápe tata kirirĩngue, pe purahéipe.	Hikuái hi’ãnguápe tata kirirĩngue, pe purahéipe.	NOCHANGE
. rehóva’erã katuete	. rehóva’erã katuete	NOCHANGE
Guyra ñe’ẽ hetahápe	Guyra ñe’ẽ hetahápe	NOCHANGE
Iporã nde rembiapo.	Iporã nde rembiapo.	NOCHANGE
Ñe’ ẽkuéra oguereko tepy ome’ẽva ichupe pe ohendúva	Ñe’ ẽkuéra oguereko tepy ome’ẽva ichupe pe ohendúva	NOCHANGE
Ñane retãpýre omyanyhẽ umi mbo’ehao iporãrasáva	Ñane retãpýre omyanyhẽ umi mbo’ehao iporãrasáva	NOCHANGE
Ojapajeréi te’ongue ári, upévare hesa’yju ha ine. oĩramo kuña	Ojapajeréi te’ongue ári, upévare hesa’yju ha ine. oĩramo kuña	NOCHANGE
Ha mitãnguéra oma’ẽ.	Ha mitãnguéra oma’ẽ.	NOCHANGE
Umi rupi ojehúva.	Umi rupi ojehúva.	NOCHANGE
Ha ndojokói chupe ára haku,	Ha ndojokói chupe ára haku,	NOCHANGE
Ndaiporichene ko yvy ape ári	Ndaiporichene ko yvy ape ári	NOCHANGE
A purahéi mbegue.	A purahéi mbegue.	NOCHANGE
Ñande jahesyva’erã ñamokãva’erã	Ñande jahesyva’erã ñamokãva’erã	NOCHANGE
Upéagui orojapo retomada pyahu. péa ko ore rekonte voi. ore oroguata va’erã tekotevẽ ramo, oroikove haguã.	Upéagui orojapo retomada pyahu. péa ko ore rekonte voi. ore oroguata va’erã tekotevẽ ramo, oroikove haguã.	NOCHANGE
Hesaka opytávo, ivevúi, ipotĩ, ha katu ikanguekuete.	Hesaka opytávo, ivevúi, ipotĩ, ha katu ikanguekuete.	NOCHANGE
Hesekuéra rehehápe napenekangýiva’erã	Hesekuéra rehehápe napenekangýiva’erã	NOCHANGE
Ndajuhúi ko arapýpe.	Ndajuhúi ko arapýpe.	NOCHANGE
Nde py’a karãi ramo sapy’ánte	Nde py’a karãi ramo sapy’ánte	NOCHANGE
Estuvieron ñe’ê renda y ñande pãi tavyterã ñande para-	Estuvieron ñe’ê renda y ñande pãi tavyterã ñande para-	NOCHANGE
Pe yvyramáta ojepe’áma tapegui.	Pe yvyramáta ojepe’áma tapegui.	NOCHANGE
Omoinge kóva ryepýpe heta ñe’ẽ pyahu mitã oipurúva mbo’ehaópe.	Omoinge kóva ryepýpe heta ñe’ẽ pyahu mitã oipurúva mbo’ehaópe.	NOCHANGE
Ñe’ẽndýi ñe’ẽtéva terarãnguete	Ñe’ẽndýi ñe’ẽtéva terarãnguete	NOCHANGE
Tavýgui ha umi ñañágui, ndojehechakuaáiva’ekue mangorépe umi hembiapokatu.	Tavýgui ha umi ñañágui, ndojehechakuaáiva’ekue mangorépe umi hembiapokatu.	NOCHANGE
. tesaýpe amoñe’ẽ	. tesaýpe amoñe’ẽ	NOCHANGE
Upe mba’e guasuete, ojejuhúkuri avei ñande ypykue rapykuere. umíva katu	Upe mba’e guasuete, ojejuhúkuri avei ñande ypykue rapykuere. umíva katu	NOCHANGE
Michĩ aja ojehero mitãkuña, mitãkuña’i. oiko ituvakuéra ndive, oñeñangarekóva hese.	Michĩ aja ojehero mitãkuña, mitãkuña’i. oiko ituvakuéra ndive, oñeñangarekóva hese.	NOCHANGE
Ko arapýpe ndojejuhúi ha’eichagua ikatupyrýva pumbasy apópe. iporã ha iporãvéva ojapo, ohupi yvateve pumbasy oikotevẽva mbarakakatepu.	Ko arapýpe ndojejuhúi ha’eichagua ikatupyrýva pumbasy apópe. iporã ha iporãvéva ojapo, ohupi yvateve pumbasy oikotevẽva mbarakakatepu.	NOCHANGE
Avave ndojapresái va’erã ndopagái haguére hembijogua.	Avave ndojapresái va’erã ndopagái haguére hembijogua.	NOCHANGE
Mbyja rerakuéra, yva he’êvéva,	Mbyja rerakuéra, yva he’êvéva,	NOCHANGE
Tee peteĩva.	Tee peteĩva.	NOCHANGE
Ha iñemoñare kuéra ndive avei.	Ha iñemoñare kuéra ndive avei.	NOCHANGE
Po’a imarangatúva toiko nde rapykuéri,	Po’a imarangatúva toiko nde rapykuéri,	NOCHANGE
Ojeporavóva corte-pe guarã	Ojeporavóva corte-pe guarã	NOCHANGE
A’aguyjeveme’ê ñanderuvusukuérape taha’eha’éva	A’aguyjeveme’ê ñanderuvusukuérape taha’eha’éva	NOCHANGE
Guámpa ro’ysã ka’aguy mbyaipyrépe...	Guámpa ro’ysã ka’aguy mbyaipyrépe...	NOCHANGE
Táva paraguaýpe	Táva paraguaýpe	NOCHANGE
Jesús ha itúva peteĩ persónante.	Jesús ha itúva peteĩ persónante.	NOCHANGE
Tape ári ha ojerévo ojesareko porã hagua hese oikarãi	Tape ári ha ojerévo ojesareko porã hagua hese oikarãi	NOCHANGE
Ikatu hupytyrã ndaha’ei ko’árape jeikua mba’epa ñande, hákatu ñembotove pe ñande ha’eva	Ikatu hupytyrã ndaha’ei ko’árape jeikua mba’epa ñande, hákatu ñembotove pe ñande ha’eva	NOCHANGE
Ka’aguy porã	Ka’aguy porã	NOCHANGE
Ha yvy reheja.	Ha yvy reheja.	NOCHANGE
(uicn tembiapohára paraguaigua omba’apo ñane retãme)	(uicn tembiapohára paraguaigua omba’apo ñane retãme)	NOCHANGE
Ahendúva osyry mba’e porâita pa’ûme	Ahendúva osyry mba’e porâita pa’ûme	NOCHANGE
Pe potapyrãreko iporãite, oguahevo añetegua ypype oiko chugui mba’e imorãngeva	Pe potapyrãreko iporãite, oguahevo añetegua ypype oiko chugui mba’e imorãngeva	NOCHANGE
Ñande reko,	Ñande reko,	NOCHANGE
Iporã ojegueromandu’a tetãyguakuéra	Iporã ojegueromandu’a tetãyguakuéra	NOCHANGE
Opamba’e rãicha upe pyharépe	Opamba’e rãicha upe pyharépe	NOCHANGE
Jave oñemoñe’ẽkõi añete. kóva ryepýpe	Jave oñemoñe’ẽkõi añete. kóva ryepýpe	NOCHANGE
. akóinte oiko che ñe’ã karãi pe techaga’u	. akóinte oiko che ñe’ã karãi pe techaga’u	NOCHANGE
Ka pa-u a-ku pe-pa,	Ka pa-u a-ku pe-pa,	NOCHANGE
Ndaikatupyrymo’ãiha hetã ñe’ẽ tee	Ndaikatupyrymo’ãiha hetã ñe’ẽ tee	NOCHANGE
Nati ohenói isýpe ohechaga’úgui chupe	Nati ohenói isýpe ohechaga’úgui chupe	NOCHANGE
Ha upe ára guive	Ha upe ára guive	NOCHANGE
Nde syva ry’ái rupi ruhupytýta ne rembi’urã ára ha ára.	Nde syva ry’ái rupi ruhupytýta ne rembi’urã ára ha ára.	NOCHANGE
Ha katu oime heta ñemity pora che kokuépe,	Ha katu oime heta ñemity pora che kokuépe,	NOCHANGE
Nemoirûvo guarani ñe’ê yvytúre akói toveve,	Nemoirûvo guarani ñe’ê yvytúre akói toveve,	NOCHANGE
Mba’éicha rupípa ko che mitãhápe aiko añembyasy	Mba’éicha rupípa ko che mitãhápe aiko añembyasy	NOCHANGE
Ñambyaty viru, ñe’ã tahory,	Ñambyaty viru, ñe’ã tahory,	NOCHANGE
Ndaipóri omo’ãva,	Ndaipóri omo’ãva,	NOCHANGE
Rogue kuéra opyta haguãicha porã.	Rogue kuéra opyta haguãicha porã.	NOCHANGE
Umi pohâ ñana ñamone’ê va’ekue ko kuatiápe, oñemohenda según mba’e mba’asýpepa ouporâ,	Umi pohâ ñana ñamone’ê va’ekue ko kuatiápe, oñemohenda según mba’e mba’asýpepa ouporâ,	NOCHANGE
Karai kuéra imba’eporãva jepe ou oma’ẽ mimi ore rehe ha oike imba’eyrúpy ha oho jey. noha’arõ rañẽi ore oroñe’ẽ.	Karai kuéra imba’eporãva jepe ou oma’ẽ mimi ore rehe ha oike imba’eyrúpy ha oho jey. noha’arõ rañẽi ore oroñe’ẽ.	NOCHANGE
Ne ñe’ẽ ahendu rupi	Ne ñe’ẽ ahendu rupi	NOCHANGE
Apopy, oñeme’ê ha oñemyasãi jojahápe pe tekopykuaa jopara he’iséva	Apopy, oñeme’ê ha oñemyasãi jojahápe pe tekopykuaa jopara he’iséva	NOCHANGE
Aipóva hína peteĩ ña’ẽ henyhẽva tekokatúgui.	Aipóva hína peteĩ ña’ẽ henyhẽva tekokatúgui.	NOCHANGE
Upéva rehe.	Upéva rehe.	NOCHANGE
Opavo ñorairõ ojevy hógape hikuéi ha ojo’óvo upe tenda ohejahaguépe ta’anga, oñemopu’ã jey oratorio.	Opavo ñorairõ ojevy hógape hikuéi ha ojo’óvo upe tenda ohejahaguépe ta’anga, oñemopu’ã jey oratorio.	NOCHANGE
. oĩmérõ iporãva ko yvy apére	. oĩmérõ iporãva ko yvy apére	NOCHANGE
Oseháicha purahéi ko’ã che pógui	Oseháicha purahéi ko’ã che pógui	NOCHANGE
Ñe’ẽysajakuaa, ha	Ñe’ẽysajakuaa, ha	NOCHANGE
Jahechahápe umi ñe’êmboguapy osê va’ekue ministro tekopykuaa	Jahechahápe umi ñe’êmboguapy osê va’ekue ministro tekopykuaa	NOCHANGE
Katuete peteĩ ára	Katuete peteĩ ára	NOCHANGE
Ava kuéra ohóta oñe’ê tendota ndive	Ava kuéra ohóta oñe’ê tendota ndive	NOCHANGE
Añemoñesũ avati ra’ỹi ári añe’ẽ avañe’ẽ,	Añemoñesũ avati ra’ỹi ári añe’ẽ avañe’ẽ,	NOCHANGE
Mbytépe oñepyrũ umi apañuãi ñande py’araháva ikatúva sapy’ante opa porã térã ombotyaive umi oikóva ipype.	Mbytépe oñepyrũ umi apañuãi ñande py’araháva ikatúva sapy’ante opa porã térã ombotyaive umi oikóva ipype.	NOCHANGE
Ñe’ẽ ha rekotee oñemombareteve	Ñe’ẽ ha rekotee oñemombareteve	NOCHANGE
Re oma’ẽ rã imbo’y oĩ ramo.	Re oma’ẽ rã imbo’y oĩ ramo.	NOCHANGE
Tavakuairetã mburuvicharapépe ndorekóiva aty ojokuaikuaáva	Tavakuairetã mburuvicharapépe ndorekóiva aty ojokuaikuaáva	NOCHANGE
Oñembojoja haguã umi área protegida-pe táva kuéra ha umi yvýrupi oikóva, oñomongeta va’erã	Oñembojoja haguã umi área protegida-pe táva kuéra ha umi yvýrupi oikóva, oñomongeta va’erã	NOCHANGE
Okáguio ojeporu kangue rasýpe guarâ ha mba’asykuéra ñande pire reheguápe.	Okáguio ojeporu kangue rasýpe guarâ ha mba’asykuéra ñande pire reheguápe.	NOCHANGE
Ñe’ẽpaparakuéra ityarõ’ỹ va oporohekora’ã, ñe’ẽpaparakuéra ityarõva katu omonda	Ñe’ẽpaparakuéra ityarõ’ỹ va oporohekora’ã, ñe’ẽpaparakuéra ityarõva katu omonda	NOCHANGE
Hakã ru’ãre otitihápe guyra yuhéi.	Hakã ru’ãre otitihápe guyra yuhéi.	NOCHANGE
Rehe hesekuéra iñe’ẽteépe oikotevẽ jave,	Rehe hesekuéra iñe’ẽteépe oikotevẽ jave,	NOCHANGE
Ombohory ñane ñe’ã	Ombohory ñane ñe’ã	NOCHANGE
Oiméva yvypóra ha’e ohesape,	Oiméva yvypóra ha’e ohesape,	NOCHANGE
Nde juru pytã	Nde juru pytã	NOCHANGE
Anichéne niko che memby ojapo, ko ouva’ekue omombe’u chéve ha upéi oñeno oke ko’ëmbaite peve.	Anichéne niko che memby ojapo, ko ouva’ekue omombe’u chéve ha upéi oñeno oke ko’ëmbaite peve.	NOCHANGE
Ko jehaipyre ndahekopyahuvéima, upévare hetepy ikatu ndoikovéima.	Ko jehaipyre ndahekopyahuvéima, upévare hetepy ikatu ndoikovéima.	NOCHANGE
Ha’érõ jepe jeporavopyre peteĩete rehegua, jepérõ peteĩ tetãmini ha ambue tetãguasu rehegua,	Ha’érõ jepe jeporavopyre peteĩete rehegua, jepérõ peteĩ tetãmini ha ambue tetãguasu rehegua,	NOCHANGE
Ára ha’e apoha iporãvéva, akóinte otopa paha iporã jepéva	Ára ha’e apoha iporãvéva, akóinte otopa paha iporã jepéva	NOCHANGE
Pe korea yvyapy, oguerekóva ipype umi mokõi tetã.	Pe korea yvyapy, oguerekóva ipype umi mokõi tetã.	NOCHANGE
Pa’ikuéra tupâópe	Pa’ikuéra tupâópe	NOCHANGE
-oñembojoajukuaáva ko’ápe	-oñembojoajukuaáva ko’ápe	NOCHANGE
Tetã ñe’ẽngu oipotágui.	Tetã ñe’ẽngu oipotágui.	NOCHANGE
Ha’e rire maje omoĩ porã ko’ẽ rã ho’u aguã. ha’e rire maje oo ka’aguy re. ovaẽ	Ha’e rire maje omoĩ porã ko’ẽ rã ho’u aguã. ha’e rire maje oo ka’aguy re. ovaẽ	NOCHANGE
Tetãvore oruro	Tetãvore oruro	NOCHANGE
Temimbo’e ikatupyryveva’ekue	Temimbo’e ikatupyryveva’ekue	NOCHANGE
Tyekue ha py’a mba’asykuéra. ojepuru sevo’i oñepohano hagua. okáguio ojepuru oñepohano hagua	Tyekue ha py’a mba’asykuéra. ojepuru sevo’i oñepohano hagua. okáguio ojepuru oñepohano hagua	NOCHANGE
Oñe’ême’êháme, ore rupive, omoañetetaha ha oykekotaha ko tembipota,	Oñe’ême’êháme, ore rupive, omoañetetaha ha oykekotaha ko tembipota,	NOCHANGE
Jukyry osyrýva ha upépe ombe’úva ijapyra’ỹva ñande rekove	Jukyry osyrýva ha upépe ombe’úva ijapyra’ỹva ñande rekove	NOCHANGE
Paraguáype hetaiteve oĩ tapicha hasykatu jave oñepohãnoukáva pohãnohára chaépe	Paraguáype hetaiteve oĩ tapicha hasykatu jave oñepohãnoukáva pohãnohára chaépe	NOCHANGE
Guive iñe’ẽ ypykuépe, isy ñe’ẽme ha	Guive iñe’ẽ ypykuépe, isy ñe’ẽme ha	NOCHANGE
Upépe ñembo’yhápe	Upépe ñembo’yhápe	NOCHANGE
Hekoverã árapýpe omotenondeva’erã, omotenondeva’erã	Hekoverã árapýpe omotenondeva’erã, omotenondeva’erã	NOCHANGE
Ñañangarekova’erã ñande chamame, ñande rapo ha ñane guarani ñe’êre	Ñañangarekova’erã ñande chamame, ñande rapo ha ñane guarani ñe’êre	NOCHANGE
Akóinte ipore’ỹ.	Akóinte ipore’ỹ.	NOCHANGE
Ñande róga jepeve ha’ete ku oikuaáva	Ñande róga jepeve ha’ete ku oikuaáva	NOCHANGE
Tekovekuaaty ñemohenda.	Tekovekuaaty ñemohenda.	NOCHANGE
Jevágui, tetã ryepýpe ha tetã ambuérupi, umi táva guasu okakuaágui, pe	Jevágui, tetã ryepýpe ha tetã ambuérupi, umi táva guasu okakuaágui, pe	NOCHANGE
Ha tuicha rire ndahuguáiri.	Ha tuicha rire ndahuguáiri.	NOCHANGE
Yvy apére yma.	Yvy apére yma.	NOCHANGE
Ñe’ẽ jepuru, he’isevahína oguatakarẽha	Ñe’ẽ jepuru, he’isevahína oguatakarẽha	NOCHANGE
Moroti ha oñepyru oipyaha. ojapo upéicha petei mba’e neporãmbajepéva, ka’aguy	Moroti ha oñepyru oipyaha. ojapo upéicha petei mba’e neporãmbajepéva, ka’aguy	NOCHANGE
Ñemyasãime, ñemongu’épe, ha ñemboguapyhápe tembiaporã hendápegua,	Ñemyasãime, ñemongu’épe, ha ñemboguapyhápe tembiaporã hendápegua,	NOCHANGE
Avei, upe amandajépe, ojehechaukáta ñande jeroky ha oñehendúta ñande purahéi ha ñane ñe’êpoty, ñamomba’eguasúvo ñane retâ mba’e teéva.	Avei, upe amandajépe, ojehechaukáta ñande jeroky ha oñehendúta ñande purahéi ha ñane ñe’êpoty, ñamomba’eguasúvo ñane retâ mba’e teéva.	NOCHANGE
Omyesakãgui ñandéve mba’éichapa ñaha’ãva’erã	Omyesakãgui ñandéve mba’éichapa ñaha’ãva’erã	NOCHANGE
Nañandúiva araka’eve péicha nde popo	Nañandúiva araka’eve péicha nde popo	NOCHANGE
Reikoha che ñe’âitépe mbyja ko’ê kypy’y.	Reikoha che ñe’âitépe mbyja ko’ê kypy’y.	NOCHANGE
Rehegua he’íva.	Rehegua he’íva.	NOCHANGE
Peteĩ mburuvicha.	Peteĩ mburuvicha.	NOCHANGE
Nde japu hína.	Nde japu hína.	NOCHANGE
Mburuvichakuéra omohembi’u umi tapichakuérape opytava’ekue óga’yre.	Mburuvichakuéra omohembi’u umi tapichakuérape opytava’ekue óga’yre.	NOCHANGE
Che sýpente ndaipotái remombe’u pa’i.	Che sýpente ndaipotái remombe’u pa’i.	NOCHANGE
Máva noikuaaíva ñe’ẽ pytaguakuéra ndoikuaai mba’eve iñe’ẽteegui	Máva noikuaaíva ñe’ẽ pytaguakuéra ndoikuaai mba’eve iñe’ẽteegui	NOCHANGE
Omoiruvo chupe, omanoite peve...he’i maymávape araka’evéma ndoumo’ãiha upégui.	Omoiruvo chupe, omanoite peve...he’i maymávape araka’evéma ndoumo’ãiha upégui.	NOCHANGE
Haguã, ha hembiapo kuéra ombohape mbareteha opa yvypóra yvy ape ári	Haguã, ha hembiapo kuéra ombohape mbareteha opa yvypóra yvy ape ári	NOCHANGE
Guarani ñe’ẽ hembiapo, ko’ẽrei omyasãiva	Guarani ñe’ẽ hembiapo, ko’ẽrei omyasãiva	NOCHANGE
Tape ojeapa apa yvy’ã kupere yvate peve a’eva’e rovai re amboae yvy rami.	Tape ojeapa apa yvy’ã kupere yvate peve a’eva’e rovai re amboae yvy rami.	NOCHANGE
Peteĩ mba’e neporãva ojejapóva ha’e	Peteĩ mba’e neporãva ojejapóva ha’e	NOCHANGE
. mba’erepy ko’ẽrõ guarã vevépema rembyaty	. mba’erepy ko’ẽrõ guarã vevépema rembyaty	NOCHANGE
Jepémo oikove hikuái ñande apytépe,	Jepémo oikove hikuái ñande apytépe,	NOCHANGE
Nerakãnguéra ñembo’y	Nerakãnguéra ñembo’y	NOCHANGE
Ha’eva’erãmo’ãkuri peteĩ katupyry mbarete	Ha’eva’erãmo’ãkuri peteĩ katupyry mbarete	NOCHANGE
Pukukue javeve.	Pukukue javeve.	NOCHANGE
Peteĩ ’árape, ha mavave mburuvicha ndikatúi ojoko	Peteĩ ’árape, ha mavave mburuvicha ndikatúi ojoko	NOCHANGE
Concepción rape aikundaháma che ñe’ẽ che ma’ẽme aipota	Concepción rape aikundaháma che ñe’ẽ che ma’ẽme aipota	NOCHANGE
Che mbo’ehára porãite	Che mbo’ehára porãite	NOCHANGE
- ma’ẽrã. -ojehesa popira ha oma’ẽva.	- ma’ẽrã. -ojehesa popira ha oma’ẽva.	NOCHANGE
Umi tapicha oñemoaranduva’ekue	Umi tapicha oñemoaranduva’ekue	NOCHANGE
Tembiguái ndaha’eichéne	Tembiguái ndaha’eichéne	NOCHANGE
Ko karai imitã guive ojehecharamo ikatupyrýre ha akóinte pukahápe oikógui.	Ko karai imitã guive ojehecharamo ikatupyrýre ha akóinte pukahápe oikógui.	NOCHANGE
Upe guive, ha’ekuérantema angirũ ojohayhúva.	Upe guive, ha’ekuérantema angirũ ojohayhúva.	NOCHANGE
Ka’aguype heñói	Ka’aguype heñói	NOCHANGE
Ha’e oikuaa mba’épa upépe ajuhu va’ekue	Ha’e oikuaa mba’épa upépe ajuhu va’ekue	NOCHANGE
Che apysa ohendúva ñe’ê pu rory	Che apysa ohendúva ñe’ê pu rory	NOCHANGE
Ñembyahýi, sogue, tyre’ỹ,	Ñembyahýi, sogue, tyre’ỹ,	NOCHANGE
Ñemuha guasu mombása pegua.	Ñemuha guasu mombása pegua.	NOCHANGE
Topu’ãke ñane retã.	Topu’ãke ñane retã.	NOCHANGE
Tapichakuéra oikóva	Tapichakuéra oikóva	NOCHANGE
Upéicha sa’i sa’ípe	Upéicha sa’i sa’ípe	NOCHANGE
Tambo kurupa’y, ha’e tenda ojepytu’úha, ñembosarái ha tetia’e deporte-pe ha ojeguata haguã sãsõ ha py’aguapýpe.	Tambo kurupa’y, ha’e tenda ojepytu’úha, ñembosarái ha tetia’e deporte-pe ha ojeguata haguã sãsõ ha py’aguapýpe.	NOCHANGE
Táva aregua motenondehára, hembireko ha ambue mburuvichakuéra	Táva aregua motenondehára, hembireko ha ambue mburuvichakuéra	NOCHANGE
Ñembo’e rangua.	Ñembo’e rangua.	NOCHANGE
Ñanduti mba’epyahu	Ñanduti mba’epyahu	NOCHANGE
Anicheva’erã voi, guarani ñande rekópe	Anicheva’erã voi, guarani ñande rekópe	NOCHANGE
Ñane ãnga memby ñane ñe’ẽ ha’e ñane korasõ ñe’ẽma	Ñane ãnga memby ñane ñe’ẽ ha’e ñane korasõ ñe’ẽma	NOCHANGE
Ajeverõ péicha oñe’ẽ ñemi	Ajeverõ péicha oñe’ẽ ñemi	NOCHANGE
Tavetã joaju-pegua	Tavetã joaju-pegua	NOCHANGE
Hemimo’ã, ha oipyguara mburuvicha rekove, jepérõ ndikatúi ojapo sarambi isã sógui.	Hemimo’ã, ha oipyguara mburuvicha rekove, jepérõ ndikatúi ojapo sarambi isã sógui.	NOCHANGE
Ha’ekuéra oguata ha’ekuéra omba’apo	Ha’ekuéra oguata ha’ekuéra omba’apo	NOCHANGE
Ija’e’y rupi pe mitâkuña ndojejuhúi.	Ija’e’y rupi pe mitâkuña ndojejuhúi.	NOCHANGE
Kuéra he’iháicha inciso tenondegua.	Kuéra he’iháicha inciso tenondegua.	NOCHANGE
Ndajehe’ái voi che hesekuéra, ojejapógui hikuái.	Ndajehe’ái voi che hesekuéra, ojejapógui hikuái.	NOCHANGE
Ha’ekuéra ojesarekomante oguahẽmante	Ha’ekuéra ojesarekomante oguahẽmante	NOCHANGE
Hecha yvate para hũ pegua.	Hecha yvate para hũ pegua.	NOCHANGE
Ñaimo’ã ka’a porã	Ñaimo’ã ka’a porã	NOCHANGE
Ha’e ñe’êjoajuita joajupyre omohendáva mba’éichapa	Ha’e ñe’êjoajuita joajupyre omohendáva mba’éichapa	NOCHANGE
Tetãvore paraguarí	Tetãvore paraguarí	NOCHANGE
Kuarahy ha pirapire rehe ndaipóri yvypóra omaña aréva.	Kuarahy ha pirapire rehe ndaipóri yvypóra omaña aréva.	NOCHANGE
Upevakuére oiko hi’otĩ. upéicharõ jepe, oñangarekokuaámante ijehe. osẽta jave	Upevakuére oiko hi’otĩ. upéicharõ jepe, oñangarekokuaámante ijehe. osẽta jave	NOCHANGE
Tapére oñemboyke oguata vevúi ñembotavy ha oñeha’ã,	Tapére oñemboyke oguata vevúi ñembotavy ha oñeha’ã,	NOCHANGE
Tuvakuéra ha tyvyrakuéra oikové paraguaýpe.	Tuvakuéra ha tyvyrakuéra oikové paraguaýpe.	NOCHANGE
Ombohape va’erã pe tekopykuaa mba’e porã jejapo, ñemyasãi ha	Ombohape va’erã pe tekopykuaa mba’e porã jejapo, ñemyasãi ha	NOCHANGE
Topytamíkena(ha’ekuéra) tombyatymíkena(ha’ekuéra)	Topytamíkena(ha’ekuéra) tombyatymíkena(ha’ekuéra)	NOCHANGE
He’iháicha, ha oñemomboka va’erã ojerurérõ umi mburuvichaitéva, mante ndoikói péicha	He’iháicha, ha oñemomboka va’erã ojerurérõ umi mburuvichaitéva, mante ndoikói péicha	NOCHANGE
- ndachepy’aguapýi niko, ipochy chendive che rembireko. chembou ajerurévo ndeve peteĩ ña’ẽ pyahu imba’erã.	- ndachepy’aguapýi niko, ipochy chendive che rembireko. chembou ajerurévo ndeve peteĩ ña’ẽ pyahu imba’erã.	NOCHANGE
Pe yvyra ho’áva hapyta porã.	Pe yvyra ho’áva hapyta porã.	NOCHANGE
Oĩme mba’épa che resaráiva, ndajapóiva,	Oĩme mba’épa che resaráiva, ndajapóiva,	NOCHANGE
Ñe’ê porãngue i	Ñe’ê porãngue i	NOCHANGE
Che, mburuvicha, ahy’okatupyrýpe amoñe’ê kuatiahaipyre atyguasúgui, táva guasu	Che, mburuvicha, ahy’okatupyrýpe amoñe’ê kuatiahaipyre atyguasúgui, táva guasu	NOCHANGE
Ojepaga ojeporu va’ekue.	Ojepaga ojeporu va’ekue.	NOCHANGE
Hembiguáiramo jaikóne, mba’apo ha ñorairõme	Hembiguáiramo jaikóne, mba’apo ha ñorairõme	NOCHANGE
Hetaite mba’e iporãva	Hetaite mba’e iporãva	NOCHANGE
Ñemitỹme ha mymbakuéra ñemongakuaápe omba’apo kyre’ỹ tavayguakuéra.	Ñemitỹme ha mymbakuéra ñemongakuaápe omba’apo kyre’ỹ tavayguakuéra.	NOCHANGE
Mborayhu ha vy’a upépe heñói	Mborayhu ha vy’a upépe heñói	NOCHANGE
Kunumi, guáina, ha okakuaháva rehegua, ha umi katuete ikatúva oñepysanga. omboí va’erã opa	Kunumi, guáina, ha okakuaháva rehegua, ha umi katuete ikatúva oñepysanga. omboí va’erã opa	NOCHANGE
Poguypópe oiko ko tetã	Poguypópe oiko ko tetã	NOCHANGE
Ha pévape ohechakuaávo -ijoyke’ykuéra ndive-	Ha pévape ohechakuaávo -ijoyke’ykuéra ndive-	NOCHANGE
Ñane avañe’ë, ñande purahéi,	Ñane avañe’ë, ñande purahéi,	NOCHANGE
Y oveve ñe’ẽicha ome’ẽ tekove	Y oveve ñe’ẽicha ome’ẽ tekove	NOCHANGE
Hesukrísto tupao marangatukuéra arapahapegua	Hesukrísto tupao marangatukuéra arapahapegua	NOCHANGE
Tetã paraguáipe	Tetã paraguáipe	NOCHANGE
Táva méhiko	Táva méhiko	NOCHANGE
Omohesakãvaerã chupe tape porãme.	Omohesakãvaerã chupe tape porãme.	NOCHANGE
Tojeity ñemba’apópe avei ñande jave	Tojeity ñemba’apópe avei ñande jave	NOCHANGE
Peteĩ kuña oporomomembýva.	Peteĩ kuña oporomomembýva.	NOCHANGE
He’iséva. mymba okambúva, oikóva so’óre, ipyapê ha hâi mbaretéva.	He’iséva. mymba okambúva, oikóva so’óre, ipyapê ha hâi mbaretéva.	NOCHANGE
Pohã ñana ñemitỹ.	Pohã ñana ñemitỹ.	NOCHANGE
Ko’ãga mombyry	Ko’ãga mombyry	NOCHANGE
Ñane mba’e teete	Ñane mba’e teete	NOCHANGE
Ñemitỹ opu’ã	Ñemitỹ opu’ã	NOCHANGE
Oñemongeta mba’apo tekotevê rehegua ha hembýva hína ñangareko	Oñemongeta mba’apo tekotevê rehegua ha hembýva hína ñangareko	NOCHANGE
Ñemby - paraguay.	Ñemby - paraguay.	NOCHANGE
Che ñe’â omyenyhêva	Che ñe’â omyenyhêva	NOCHANGE
Ome’ê chéve pyhare potýicha,	Ome’ê chéve pyhare potýicha,	NOCHANGE
Toĩmba tembi’urã	Toĩmba tembi’urã	NOCHANGE
Mbyjajere ojeréva kuarahýre peteĩ arýpe, ñande rekoha.	Mbyjajere ojeréva kuarahýre peteĩ arýpe, ñande rekoha.	NOCHANGE
Méhiko pyahu, tetãvore joapykuéra	Méhiko pyahu, tetãvore joapykuéra	NOCHANGE
Ko’ẽju sakãvo ñapu’ã varã	Ko’ẽju sakãvo ñapu’ã varã	NOCHANGE
Misiones tetãvore argentina-pe. itavusu hérava posadas.	Misiones tetãvore argentina-pe. itavusu hérava posadas.	NOCHANGE
Paraguái ñe’ẽ.	Paraguái ñe’ẽ.	NOCHANGE
Ñandéko jaiko ñarokirirĩ opaite mba’e	Ñandéko jaiko ñarokirirĩ opaite mba’e	NOCHANGE
Jahava’erã jajogua ka’a ha juky ñemuhágui.	Jahava’erã jajogua ka’a ha juky ñemuhágui.	NOCHANGE
Nañañandúi mba’eve.	Nañañandúi mba’eve.	NOCHANGE
Ha upéva, upéva oĩ porã.	Ha upéva, upéva oĩ porã.	NOCHANGE
Congreso de paraguái	Congreso de paraguái	NOCHANGE
Oñemyasãi haguã arandu, teko ojehechauka ha oñemopu’ã haguã, ha	Oñemyasãi haguã arandu, teko ojehechauka ha oñemopu’ã haguã, ha	NOCHANGE
Tetã rayhupápe kane’õ ha y’uhéi	Tetã rayhupápe kane’õ ha y’uhéi	NOCHANGE
Ojejapova’ekue ndive ambue médio	Ojejapova’ekue ndive ambue médio	NOCHANGE
Opyta ipotĩ upe acusado. ko’ãva ojerereko va’erã ’ára ojoakykueriguárõ, omba’aporõ cámara de	Opyta ipotĩ upe acusado. ko’ãva ojerereko va’erã ’ára ojoakykueriguárõ, omba’aporõ cámara de	NOCHANGE
Privada ombyaíva terã ikatúva ombyai tekoha ha oike va’erã omba’apo ojejapohápe tekoha	Privada ombyaíva terã ikatúva ombyai tekoha ha oike va’erã omba’apo ojejapohápe tekoha	NOCHANGE
Pyhare, ku ijapyra’ỹva	Pyhare, ku ijapyra’ỹva	NOCHANGE
Ha’ekuéra ápe oiko	Ha’ekuéra ápe oiko	NOCHANGE
Ha ombopotyva tetã.	Ha ombopotyva tetã.	NOCHANGE
Kuimba’e ha kuña ojapokuaáva paje. oĩ oipurúva imba’ekuaa oharu, ojahéi térã ombyai	Kuimba’e ha kuña ojapokuaáva paje. oĩ oipurúva imba’ekuaa oharu, ojahéi térã ombyai	NOCHANGE
Hesu hete joja asy, ipire morotĩ, iñakãrague apopẽ hũ ha ityvyta po’i. pe hesa mimi, opukavýramo oñemboyvotývaicha hopea hũ puku ipytépe.	Hesu hete joja asy, ipire morotĩ, iñakãrague apopẽ hũ ha ityvyta po’i. pe hesa mimi, opukavýramo oñemboyvotývaicha hopea hũ puku ipytépe.	NOCHANGE
Mba’asykuérape guarâ.	Mba’asykuérape guarâ.	NOCHANGE
Oiko asy ha oñembyasy,	Oiko asy ha oñembyasy,	NOCHANGE
Tetãmini mburuvicha oñangareko va’erã opaite yjyvýre.	Tetãmini mburuvicha oñangareko va’erã opaite yjyvýre.	NOCHANGE
Upérõ oikovéne purahéi ava ñe’ê, ha oguéne chokokue y’uhéi.	Upérõ oikovéne purahéi ava ñe’ê, ha oguéne chokokue y’uhéi.	NOCHANGE
Ñamongu’i porã ko aramirõ ha ñamoĩ pe mba’e apopyrépe heta porã imbaretemí meve. upéi ñambojehe’a upe masa hu’ũ porã meve.	Ñamongu’i porã ko aramirõ ha ñamoĩ pe mba’e apopyrépe heta porã imbaretemí meve. upéi ñambojehe’a upe masa hu’ũ porã meve.	NOCHANGE
Ore remikuave’êre, rohenói ára ha pyhare.	Ore remikuave’êre, rohenói ára ha pyhare.	NOCHANGE
Tekove ñemoambue	Tekove ñemoambue	NOCHANGE
Nderejumivéiva remyasãindymi ko che rekove.	Nderejumivéiva remyasãindymi ko che rekove.	NOCHANGE
Ha tahendu yvytu jurúpe ñe’ẽ ñane mondýiva.	Ha tahendu yvytu jurúpe ñe’ẽ ñane mondýiva.	NOCHANGE
Peregrinos kuéra oñembyaty tupão renondépe.	Peregrinos kuéra oñembyaty tupão renondépe.	NOCHANGE
Mayma tekove, táva ha tetâ.	Mayma tekove, táva ha tetâ.	NOCHANGE
Mbo’ehára ha temimbo’ekuéra ndive	Mbo’ehára ha temimbo’ekuéra ndive	NOCHANGE
Ko che purahéipe tamoherakuã.	Ko che purahéipe tamoherakuã.	NOCHANGE
Mba’aporasýpe tape rehe’ỹme hetave mbykýpe ndaipo’iete.	Mba’aporasýpe tape rehe’ỹme hetave mbykýpe ndaipo’iete.	NOCHANGE
Tuichaitéva umi táva rehe,	Tuichaitéva umi táva rehe,	NOCHANGE
Ogapy térã mba’apohápe oiko terere jere.	Ogapy térã mba’apohápe oiko terere jere.	NOCHANGE
. ha piko oĩméne ko yvy ky’ápe	. ha piko oĩméne ko yvy ky’ápe	NOCHANGE
Hóga jerére, juky mante ojuhu. oñemondýivoi ha’ekuéra. oñembo’e avei, ha upéi	Hóga jerére, juky mante ojuhu. oñemondýivoi ha’ekuéra. oñembo’e avei, ha upéi	NOCHANGE
Oñembovai ha ojejaheiha hese opaicharei ñane retãygua apytépe, ha	Oñembovai ha ojejaheiha hese opaicharei ñane retãygua apytépe, ha	NOCHANGE
Ko mba’e yuhéi arekóva	Ko mba’e yuhéi arekóva	NOCHANGE
Ñe’ẽtéva tero	Ñe’ẽtéva tero	NOCHANGE
-aipórõ piko mokõive ojoja imbaretekuépe -he’i upe oñe’ẽva- upéicharõ nenupãjeyva’erã hikuái jahechávo mávapa oinupã hatãve.	-aipórõ piko mokõive ojoja imbaretekuépe -he’i upe oñe’ẽva- upéicharõ nenupãjeyva’erã hikuái jahechávo mávapa oinupã hatãve.	NOCHANGE
Ha ko’ẽrõ joayhupápe	Ha ko’ẽrõ joayhupápe	NOCHANGE
Umi mitã ikatupyry ñe’ẽme ojehechakuaa	Umi mitã ikatupyry ñe’ẽme ojehechakuaa	NOCHANGE
Ha’ekuéra ojovahéi orambosa	Ha’ekuéra ojovahéi orambosa	NOCHANGE
Ajépango ñambyasy mba’e vaiete ojehúva	Ajépango ñambyasy mba’e vaiete ojehúva	NOCHANGE
Ñaimo’ã ku tyre’ỹ,	Ñaimo’ã ku tyre’ỹ,	NOCHANGE
Ha’ete pejave ho’ytáva vy’ápe ñande rekove.	Ha’ete pejave ho’ytáva vy’ápe ñande rekove.	NOCHANGE
Mburuvicha aja ha’ekuéra.	Mburuvicha aja ha’ekuéra.	NOCHANGE
Ñe’ẽme, tekotevẽ ohechauka ohayhuha	Ñe’ẽme, tekotevẽ ohechauka ohayhuha	NOCHANGE
P. táva ava kuéra tetãvore	P. táva ava kuéra tetãvore	NOCHANGE
Umi norma convención ome’ẽva ojekuahauka va’erã uperirete, ha ojererekóne ko constitucón	Umi norma convención ome’ẽva ojekuahauka va’erã uperirete, ha ojererekóne ko constitucón	NOCHANGE
- nde ñembyahýi pa.	- nde ñembyahýi pa.	NOCHANGE
Ñembyasy amono’õ,	Ñembyasy amono’õ,	NOCHANGE
Nde ha’éva tekove ipy’aporã ha hekopotĩva	Nde ha’éva tekove ipy’aporã ha hekopotĩva	NOCHANGE
Hagua hapichakuéra ndive. iñembo’ejeroky	Hagua hapichakuéra ndive. iñembo’ejeroky	NOCHANGE
Katu ja’emanteva’erã araka’eve	Katu ja’emanteva’erã araka’eve	NOCHANGE
Kuarahy resê guive roheka py’aguapy yvóra tuichakuépe.	Kuarahy resê guive roheka py’aguapy yvóra tuichakuépe.	NOCHANGE
Ñane abá ñe’ë.	Ñane abá ñe’ë.	NOCHANGE
Ja’e ichupekuéra pe tavy tuichágui	Ja’e ichupekuéra pe tavy tuichágui	NOCHANGE
Oñemoañete maymávape iderécho oñeme’êvo chupe marandu añeteguáva ha hendápe porâ oje’éva.	Oñemoañete maymávape iderécho oñeme’êvo chupe marandu añeteguáva ha hendápe porâ oje’éva.	NOCHANGE
Hose ndaikatúi ohupyty hogue ojapo hagua tupãsýme hogarãmi. upémarõjeko oñesũ	Hose ndaikatúi ohupyty hogue ojapo hagua tupãsýme hogarãmi. upémarõjeko oñesũ	NOCHANGE
Amandajerape ombohovái mburuvicharape rekóre.	Amandajerape ombohovái mburuvicharape rekóre.	NOCHANGE
Ko’ẽ soróvo resẽ,	Ko’ẽ soróvo resẽ,	NOCHANGE
Topa mboriahu ko yvy ári.	Topa mboriahu ko yvy ári.	NOCHANGE
Imba’e porãite, ñande mbovy’ase	Imba’e porãite, ñande mbovy’ase	NOCHANGE
Opa hendápe, paraguay ha	Opa hendápe, paraguay ha	NOCHANGE
Ko ñane retã rembe’ýre ohendu heta mba’eporã avei ohecháva	Ko ñane retã rembe’ýre ohendu heta mba’eporã avei ohecháva	NOCHANGE
Pa’i omokañy ichumbe ojapomboyve misa.	Pa’i omokañy ichumbe ojapomboyve misa.	NOCHANGE
Rehe añetépa umi umba’e he’íva ohóvo parteguakuéra peteĩva.	Rehe añetépa umi umba’e he’íva ohóvo parteguakuéra peteĩva.	NOCHANGE
Tetãvore joapykuéra pegua	Tetãvore joapykuéra pegua	NOCHANGE
Ome’ẽ ojupe kyre’ỹ pokatu porã omyasãi techapyrã	Ome’ẽ ojupe kyre’ỹ pokatu porã omyasãi techapyrã	NOCHANGE
Ñembyasy ha vy’ápe ñaime oñondive	Ñembyasy ha vy’ápe ñaime oñondive	NOCHANGE
Taha’e arandukuaa terã tekombo’e rehegua, ojehechahápe umi apohára	Taha’e arandukuaa terã tekombo’e rehegua, ojehechahápe umi apohára	NOCHANGE
Ka’aguy opytáva	Ka’aguy opytáva	NOCHANGE
Tembiapo jajaposéva jajapo jave vy’a ñaneañuãmba	Tembiapo jajaposéva jajapo jave vy’a ñaneañuãmba	NOCHANGE
Ñandekuéra paraguáy hese ñanemandu’a	Ñandekuéra paraguáy hese ñanemandu’a	NOCHANGE
Ñemby, paraguay	Ñemby, paraguay	NOCHANGE
Oiko ijeheguiete opa ambue poder-gui, ko constitución, ha umi carta orgánica táva reheguápe	Oiko ijeheguiete opa ambue poder-gui, ko constitución, ha umi carta orgánica táva reheguápe	NOCHANGE
Ñandypa ha guaviju, kuruguái ha’e	Ñandypa ha guaviju, kuruguái ha’e	NOCHANGE
Oguãhẽ, oheka tukumbo ha oñapytĩ ka’ípe yvyra po-	Oguãhẽ, oheka tukumbo ha oñapytĩ ka’ípe yvyra po-	NOCHANGE
Oĩramo tekotevê tuichava, oĩ tapicha ogueroviahãguaicha opa mba’e	Oĩramo tekotevê tuichava, oĩ tapicha ogueroviahãguaicha opa mba’e	NOCHANGE
Opyta oguereko opaite mb’ae aporã reheve.	Opyta oguereko opaite mb’ae aporã reheve.	NOCHANGE
Oime ñembyasy oikove.	Oime ñembyasy oikove.	NOCHANGE
Ojopy ñande rekove.	Ojopy ñande rekove.	NOCHANGE
Maravichu, kujererâ ha ambue ñembosarái rupi,	Maravichu, kujererâ ha ambue ñembosarái rupi,	NOCHANGE
Mba’egui piko ndohayhu mo’ãi jepe ñande’ỹva	Mba’egui piko ndohayhu mo’ãi jepe ñande’ỹva	NOCHANGE
Peteĩ ára ko’ẽme che rupágui apu’ãvo	Peteĩ ára ko’ẽme che rupágui apu’ãvo	NOCHANGE
Mbo’eharakuéra ateneoguápe aheja che ñe’ãpoty morotĩva	Mbo’eharakuéra ateneoguápe aheja che ñe’ãpoty morotĩva	NOCHANGE
Taipoty ñane ñe’âme	Taipoty ñane ñe’âme	NOCHANGE
Ñande rendonderãgui pe mba’e iporãvéva ningo ha’e iñeguahe ára ha ára	Ñande rendonderãgui pe mba’e iporãvéva ningo ha’e iñeguahe ára ha ára	NOCHANGE
Temimbo’ekuéra táva ka’aguasupegua	Temimbo’ekuéra táva ka’aguasupegua	NOCHANGE
Anive peipykua ñe’ẽ	Anive peipykua ñe’ẽ	NOCHANGE
Ñande rekoha tuicha mba’e	Ñande rekoha tuicha mba’e	NOCHANGE
Upéicha avei	Upéicha avei	NOCHANGE
Mba’éichapa imbarete	Mba’éichapa imbarete	NOCHANGE
Ndaipukúi upe che mbo’epy amoñe’êtava.	Ndaipukúi upe che mbo’epy amoñe’êtava.	NOCHANGE
Tohekýimba’e (ha’ekuéra) tomoĩmba’e (ha’ekuéra)	Tohekýimba’e (ha’ekuéra) tomoĩmba’e (ha’ekuéra)	NOCHANGE
Añónte gueteri. upéicha avei, umi indigenakuéra	Añónte gueteri. upéicha avei, umi indigenakuéra	NOCHANGE
Heñóima ko’ãga ñande apytépe mborayhu jekopyty	Heñóima ko’ãga ñande apytépe mborayhu jekopyty	NOCHANGE
Pehechaukáramo peikotevẽha oimeraẽ mba’e, noñeme’ẽmo’ai peẽme mba’eve. jejapohaguã pirapire heta ñeikotevẽ pejejapo iviruhetávaramo	Pehechaukáramo peikotevẽha oimeraẽ mba’e, noñeme’ẽmo’ai peẽme mba’eve. jejapohaguã pirapire heta ñeikotevẽ pejejapo iviruhetávaramo	NOCHANGE
Purahéi jeroky,	Purahéi jeroky,	NOCHANGE
Ko’ã kirito ñe’ẽ	Ko’ã kirito ñe’ẽ	NOCHANGE
Ñandypa ha guaviju, kuruguái ha’e yvahái	Ñandypa ha guaviju, kuruguái ha’e yvahái	NOCHANGE
Va’ekuépe guarã oiko rire guive ra’e upéicha.	Va’ekuépe guarã oiko rire guive ra’e upéicha.	NOCHANGE
Tapichakuéra ha’e toryja oipotavo térã ojejapórõ pe ndaha’eíva	Tapichakuéra ha’e toryja oipotavo térã ojejapórõ pe ndaha’eíva	NOCHANGE
(ikatúma jahecha mba’eichapa oiko guyra kuéra ko yvy ape’ari)	(ikatúma jahecha mba’eichapa oiko guyra kuéra ko yvy ape’ari)	NOCHANGE
Ñaimo’ã ndéve guarãnte ñandejára oity ko’ẽ.	Ñaimo’ã ndéve guarãnte ñandejára oity ko’ẽ.	NOCHANGE
. ku merõ aju porã ñahetũ ápe ha pépe	. ku merõ aju porã ñahetũ ápe ha pépe	NOCHANGE
Ha che pyhy hetaiterei jey, ha iporãitéva juayhúpe	Ha che pyhy hetaiterei jey, ha iporãitéva juayhúpe	NOCHANGE
Te’ỹ oñemboape ha ohasa.	Te’ỹ oñemboape ha ohasa.	NOCHANGE
Oñepyrûkuri oikuaa porâ ha omomba’eguasu -ijoyke’ykuéra ndive-	Oñepyrûkuri oikuaa porâ ha omomba’eguasu -ijoyke’ykuéra ndive-	NOCHANGE
Omoha’angaporãitereígui, ojehechakuaa mymbakuéra rague ha mba’e.	Omoha’angaporãitereígui, ojehechakuaa mymbakuéra rague ha mba’e.	NOCHANGE
Ko kuñakarai ipytuho heta hasyete rire.	Ko kuñakarai ipytuho heta hasyete rire.	NOCHANGE
Peẽ mbo’eharakuéra	Peẽ mbo’eharakuéra	NOCHANGE
Ombokua ramo yvága hovy.	Ombokua ramo yvága hovy.	NOCHANGE
Rupi, katu kóva sa’i gueteri jahecháramo	Rupi, katu kóva sa’i gueteri jahecháramo	NOCHANGE
Ñane retã porãite.	Ñane retã porãite.	NOCHANGE
Araka’eve nãcherembiapo hetavei ndarekoiháicha jave mba’eve ajapovaerã	Araka’eve nãcherembiapo hetavei ndarekoiháicha jave mba’eve ajapovaerã	NOCHANGE
Tosopa anga ko che mbyay’uhéi, ka’aguy poty.	Tosopa anga ko che mbyay’uhéi, ka’aguy poty.	NOCHANGE
(oñembohapejeýva maya-kuéra)	(oñembohapejeýva maya-kuéra)	NOCHANGE
Oñeñomongetáta ypykuéra ñe’ẽ ha tetã remimoĩmby rembiapo rehe	Oñeñomongetáta ypykuéra ñe’ẽ ha tetã remimoĩmby rembiapo rehe	NOCHANGE
Tesa’ỹi korápe ndapu’a rehóvo.	Tesa’ỹi korápe ndapu’a rehóvo.	NOCHANGE
Ha’e umi mba’e ombojeguapáva	Ha’e umi mba’e ombojeguapáva	NOCHANGE
Nemba’eporãiteha.	Nemba’eporãiteha.	NOCHANGE
Mandi’o potĩ jepe ja’u ha javy’a, jajuayhúma guive.	Mandi’o potĩ jepe ja’u ha javy’a, jajuayhúma guive.	NOCHANGE
Pe óga vaikuépe oñembyaty umi mondaha’i.	Pe óga vaikuépe oñembyaty umi mondaha’i.	NOCHANGE
Moõpa oime nderayhúva’erã	Moõpa oime nderayhúva’erã	NOCHANGE
Ha jaiko porã jey.	Ha jaiko porã jey.	NOCHANGE
Opa mba’e ñame’êva	Opa mba’e ñame’êva	NOCHANGE
Tavakuairetã kóngo	Tavakuairetã kóngo	NOCHANGE
Ha mbaretépe, ñamotenondevévo ichupe ko arapýpe.	Ha mbaretépe, ñamotenondevévo ichupe ko arapýpe.	NOCHANGE
Upe rire ojehecha mokõi ta’angamýi ohechaukáva paraguái ñe’ẽ ha reko jopara ha avei mba’épa he’ise peteĩ ñe’ẽ oguéramo.	Upe rire ojehecha mokõi ta’angamýi ohechaukáva paraguái ñe’ẽ ha reko jopara ha avei mba’épa he’ise peteĩ ñe’ẽ oguéramo.	NOCHANGE
Tembi’u paraguái	Tembi’u paraguái	NOCHANGE
Jagua ha paraguái itínova.	Jagua ha paraguái itínova.	NOCHANGE
Ndaikuaái araka’épa amanota	Ndaikuaái araka’épa amanota	NOCHANGE
Avañe’ë ryapu jojápe omombe’u ñandéve hembiecha ha hembiasakue, ohechaukapotávo ñane ñe’ëtépe ikatuha japurahéi puku avei.	Avañe’ë ryapu jojápe omombe’u ñandéve hembiecha ha hembiasakue, ohechaukapotávo ñane ñe’ëtépe ikatuha japurahéi puku avei.	NOCHANGE
Mba’eguasuete ojapova’ekue	Mba’eguasuete ojapova’ekue	NOCHANGE
Ha nde avei rejuhúma	Ha nde avei rejuhúma	NOCHANGE
Ñane tĩko’õ oúvo yvytúre	Ñane tĩko’õ oúvo yvytúre	NOCHANGE
Chemoĩ nde pyti’áre	Chemoĩ nde pyti’áre	NOCHANGE
Mormon kuatiañe’ẽ	Mormon kuatiañe’ẽ	NOCHANGE
Tavy, tyre’ỹ, poriahu, ñembyahýi pepo guýpe.	Tavy, tyre’ỹ, poriahu, ñembyahýi pepo guýpe.	NOCHANGE
Péicha, ñande rekópe,	Péicha, ñande rekópe,	NOCHANGE
Pane porã ha’e pe ñemoñare’ỹ	Pane porã ha’e pe ñemoñare’ỹ	NOCHANGE
Oje’e ñe’ëmbeguépe hasy vaiha pe mitã.	Oje’e ñe’ëmbeguépe hasy vaiha pe mitã.	NOCHANGE
Mba’e vai térã ombohekokatujeýva tapicha ojeharuva’ekuépe, ha ko’ãvape	Mba’e vai térã ombohekokatujeýva tapicha ojeharuva’ekuépe, ha ko’ãvape	NOCHANGE
Monambipyre ñorairohápegua ha’e pe oha’ãva ndejuka haguã ha ojavy, ha upei ojerure ndeve aníhaguã ejuka chupe.	Monambipyre ñorairohápegua ha’e pe oha’ãva ndejuka haguã ha ojavy, ha upei ojerure ndeve aníhaguã ejuka chupe.	NOCHANGE
Ndaikatúi oiko.	Ndaikatúi oiko.	NOCHANGE
Umi heñói ha omanúva apytépe na iñambueguasúi ko’árupi ko’ã ára rupi.	Umi heñói ha omanúva apytépe na iñambueguasúi ko’árupi ko’ã ára rupi.	NOCHANGE
Tembi’ukuéra	Tembi’ukuéra	NOCHANGE
Tetã guasu ymaguare.	Tetã guasu ymaguare.	NOCHANGE
Ko yvy hekópe ojere,	Ko yvy hekópe ojere,	NOCHANGE
Mba’éicha ikatu reikuaa ñandejára ojeruréva	Mba’éicha ikatu reikuaa ñandejára ojeruréva	NOCHANGE
Ichupekuéra guarã.	Ichupekuéra guarã.	NOCHANGE
Ãga ha ára romanohápe.	Ãga ha ára romanohápe.	NOCHANGE
Ha umi kaysã ruguáre ñahendu guyra ñe’ẽ.	Ha umi kaysã ruguáre ñahendu guyra ñe’ẽ.	NOCHANGE
- tojepy’amongeta pypukuve, toñemokyre’ỹ ha hesuita kuéra rembiapo paraguai retãme.	- tojepy’amongeta pypukuve, toñemokyre’ỹ ha hesuita kuéra rembiapo paraguai retãme.	NOCHANGE
. térã yvyra guýpe mymba apytépe	. térã yvyra guýpe mymba apytépe	NOCHANGE
Hi’ãma omyasãi ha tañahendu ñande tetãygua.	Hi’ãma omyasãi ha tañahendu ñande tetãygua.	NOCHANGE
Tetepýre ha ñande ro’o ñemongu’e.	Tetepýre ha ñande ro’o ñemongu’e.	NOCHANGE
A yvy ryvycói.	A yvy ryvycói.	NOCHANGE
Ha apurahéi.	Ha apurahéi.	NOCHANGE
Omonguoeéva tetãygua voi ha ijahápe maymáva,	Omonguoeéva tetãygua voi ha ijahápe maymáva,	NOCHANGE
Mitã, mitãrusu ha hogayguakuéra,	Mitã, mitãrusu ha hogayguakuéra,	NOCHANGE
Ñane retã purahéi guasu	Ñane retã purahéi guasu	NOCHANGE
Ha ohecharamo porâreko oguerekóva opaite mba’e.	Ha ohecharamo porâreko oguerekóva opaite mba’e.	NOCHANGE
Ñambyasy ko’â mba’e	Ñambyasy ko’â mba’e	NOCHANGE
Mbo’eharakuéra katupyry	Mbo’eharakuéra katupyry	NOCHANGE
Ko oportunida porãite.	Ko oportunida porãite.	NOCHANGE
Hi’ánga ijaperekuéra	Hi’ánga ijaperekuéra	NOCHANGE
Nde syry sarakípe hakuéte jave.	Nde syry sarakípe hakuéte jave.	NOCHANGE
Aranduka ha’e peteĩ mba’e ikatúva ojapo ñande vy’apavẽ	Aranduka ha’e peteĩ mba’e ikatúva ojapo ñande vy’apavẽ	NOCHANGE
Ko tenda ojehecha porãve	Ko tenda ojehecha porãve	NOCHANGE
Ñane apytĩva voi.	Ñane apytĩva voi.	NOCHANGE
Ko yvy apére	Ko yvy apére	NOCHANGE
Opyta aja chéve mba’e ajapovaerã, ndajapoĩnera’e mba’eve.	Opyta aja chéve mba’e ajapovaerã, ndajapoĩnera’e mba’eve.	NOCHANGE
Oikove ñúre, opaite yvóra renda. ko mymba aty ohaitypo guasuhápe. haity guasu apopyre yvyra, ita, ha ambueva.	Oikove ñúre, opaite yvóra renda. ko mymba aty ohaitypo guasuhápe. haity guasu apopyre yvyra, ita, ha ambueva.	NOCHANGE
Ha upéirõ ñembyasy hoy’u.	Ha upéirõ ñembyasy hoy’u.	NOCHANGE
Péicha oñemoherakuâ oparupiete ko mba’e guasuete ojehuramoitéva ñane retâme	Péicha oñemoherakuâ oparupiete ko mba’e guasuete ojehuramoitéva ñane retâme	NOCHANGE
Iporâitepa ko ára tupa heñoi rehegua.	Iporâitepa ko ára tupa heñoi rehegua.	NOCHANGE
Avave ndohechakuaaséi upe mba’e chupekuéra	Avave ndohechakuaaséi upe mba’e chupekuéra	NOCHANGE
Opa pe ñemenda. ha ovy’apahikuái. ha ojehomimíma.	Opa pe ñemenda. ha ovy’apahikuái. ha ojehomimíma.	NOCHANGE
Ha’ekuéra ojahu pokã ndahetái rupi y, sapy’ante ipukueterei rupi kyve’ỹ. ijahoja ky’ava’erã ojehecha chupekuéra.	Ha’ekuéra ojahu pokã ndahetái rupi y, sapy’ante ipukueterei rupi kyve’ỹ. ijahoja ky’ava’erã ojehecha chupekuéra.	NOCHANGE
Ndavy’ainte ha anohéva ahetũ ha amoñe’ẽ	Ndavy’ainte ha anohéva ahetũ ha amoñe’ẽ	NOCHANGE
Ñe’ẽpyahu ñemohenda	Ñe’ẽpyahu ñemohenda	NOCHANGE
Mba’apo ñanemohesâi	Mba’apo ñanemohesâi	NOCHANGE
Ñane retã porãite	Ñane retã porãite	NOCHANGE
Nañaromandu’ái arakuéra, ñaromandu’a sapy’aguakuéra	Nañaromandu’ái arakuéra, ñaromandu’a sapy’aguakuéra	NOCHANGE
Upévare kéra ha’e peteĩ tembiapo ojeguerokuhyjéva.	Upévare kéra ha’e peteĩ tembiapo ojeguerokuhyjéva.	NOCHANGE
Ha’ekuéra ojapouka onohẽuka	Ha’ekuéra ojapouka onohẽuka	NOCHANGE
Upe mba’eguasuete	Upe mba’eguasuete	NOCHANGE
Noñemomba’eveihápe ñe’ẽnguéra derécho.	Noñemomba’eveihápe ñe’ẽnguéra derécho.	NOCHANGE
Oñangareko ménare osẽvove guatahápe, ogueraha tembipurukuéra ha membykuéra.	Oñangareko ménare osẽvove guatahápe, ogueraha tembipurukuéra ha membykuéra.	NOCHANGE
Pe guyra hérava gua’a ha ohendúvo gua’a ñe’ë, gua’i osë he’i chupe,	Pe guyra hérava gua’a ha ohendúvo gua’a ñe’ë, gua’i osë he’i chupe,	NOCHANGE
Tetã paraguái (guarani)	Tetã paraguái (guarani)	NOCHANGE
Kóva ha’e pe mandi’o ko’êngue oñembichýva tatapỹi ári.	Kóva ha’e pe mandi’o ko’êngue oñembichýva tatapỹi ári.	NOCHANGE
Ha upéicha katu peteĩ ára	Ha upéicha katu peteĩ ára	NOCHANGE
Upéicha che ra’y, ha opaite mba’e rechaharekuéra avei.	Upéicha che ra’y, ha opaite mba’e rechaharekuéra avei.	NOCHANGE
Tesarái mboyve.	Tesarái mboyve.	NOCHANGE
Peteĩ mitã pyahu.	Peteĩ mitã pyahu.	NOCHANGE
Nde rehaiguýva hese.	Nde rehaiguýva hese.	NOCHANGE
Hepyve, tembiapo guasu pyvéi.	Hepyve, tembiapo guasu pyvéi.	NOCHANGE
Ha’e ningo nohendúiva isy ñe’ê	Ha’e ningo nohendúiva isy ñe’ê	NOCHANGE
Ko ñe’ã yvyra nde perẽrĩva	Ko ñe’ã yvyra nde perẽrĩva	NOCHANGE
Ñemiháme. oikóje ohapera’arõ mitãkuña osẽva asajerei hógagui, kurupi ojuráne katuete ha ogueraha	Ñemiháme. oikóje ohapera’arõ mitãkuña osẽva asajerei hógagui, kurupi ojuráne katuete ha ogueraha	NOCHANGE
Upepeténtevoi omopu’ã tapyi’imi ha oiko ipype ha’eño petei. arañavõ omomorã imemby	Upepeténtevoi omopu’ã tapyi’imi ha oiko ipype ha’eño petei. arañavõ omomorã imemby	NOCHANGE
Che sy omombe’uhaguéicha chéve	Che sy omombe’uhaguéicha chéve	NOCHANGE
Peikuaa haguã ha’éva.	Peikuaa haguã ha’éva.	NOCHANGE
. iporã angáma tapykuépe oiko.	. iporã angáma tapykuépe oiko.	NOCHANGE
Che rete remóimba, ndaikuaái mba’épa upéva.	Che rete remóimba, ndaikuaái mba’épa upéva.	NOCHANGE
Ha’ekuéra oguerúta tembi’u.	Ha’ekuéra oguerúta tembi’u.	NOCHANGE
Mba’e ku tesaraipýpe	Mba’e ku tesaraipýpe	NOCHANGE
Ñande akãvai vaerã akointe. upeváre araka’eve nañamendaivaramo’ã	Ñande akãvai vaerã akointe. upeváre araka’eve nañamendaivaramo’ã	NOCHANGE
. taropurahéi nde juru mboypýri nde ratypykua.	. taropurahéi nde juru mboypýri nde ratypykua.	NOCHANGE
Che korapýpe oĩ yvyrã ha’eño.	Che korapýpe oĩ yvyrã ha’eño.	NOCHANGE
V mba’éichapa héra nde taita	V mba’éichapa héra nde taita	NOCHANGE
Che ndaha’ei oipotáva moñera’ỹnte. che ha’e oipotáva moñera’ỹ ikyre’ỹva. aĩ añeha’ã haguãícha py’aguapyre	Che ndaha’ei oipotáva moñera’ỹnte. che ha’e oipotáva moñera’ỹ ikyre’ỹva. aĩ añeha’ã haguãícha py’aguapyre	NOCHANGE
Ha ombohetia’ére	Ha ombohetia’ére	NOCHANGE
Ñorãirõ oñesẽvaíva ha’e pe ojehejareíva	Ñorãirõ oñesẽvaíva ha’e pe ojehejareíva	NOCHANGE
Ombyapyte mborayhúva umi mbo’epy mba’ekuaa.	Ombyapyte mborayhúva umi mbo’epy mba’ekuaa.	NOCHANGE
Mitã ñande rekove sã	Mitã ñande rekove sã	NOCHANGE
Ha’ekuéra ojahe’óraka’e ombovóraka’e	Ha’ekuéra ojahe’óraka’e ombovóraka’e	NOCHANGE
Ñandu renimbóre japeposu’u.	Ñandu renimbóre japeposu’u.	NOCHANGE
Eme’ẽ opa erekóva	Eme’ẽ opa erekóva	NOCHANGE
Oguahẽma pytu’u ichupe.	Oguahẽma pytu’u ichupe.	NOCHANGE
Omohu’û pire ha pirekyrýu (mucosas), ojoko tuguy ñehê.	Omohu’û pire ha pirekyrýu (mucosas), ojoko tuguy ñehê.	NOCHANGE
Nde juru mbytégui amo che ñe’âkuápe	Nde juru mbytégui amo che ñe’âkuápe	NOCHANGE
Ta’angaryrýi) guarani ñe’ême ha guarani arandupy ha ambue avakuéra reko rehegua.	Ta’angaryrýi) guarani ñe’ême ha guarani arandupy ha ambue avakuéra reko rehegua.	NOCHANGE
Oiko sapy’a peteĩ karai vosa	Oiko sapy’a peteĩ karai vosa	NOCHANGE
Ituja heko asyvéva, ha ojeheja va’ekue ha’eñõme, upévarã ha’eite terã ambue pyvéi	Ituja heko asyvéva, ha ojeheja va’ekue ha’eñõme, upévarã ha’eite terã ambue pyvéi	NOCHANGE
Rehe, imbovyvéva paraguáipe.	Rehe, imbovyvéva paraguáipe.	NOCHANGE
Ñande jajerokymo’ã ñamondoromo’ã	Ñande jajerokymo’ã ñamondoromo’ã	NOCHANGE
Ha upéicha reikovéva tyre’ỹ.	Ha upéicha reikovéva tyre’ỹ.	NOCHANGE
Kokue akãme henói heta ka’arë ra’ýi.	Kokue akãme henói heta ka’arë ra’ýi.	NOCHANGE
Oñemba’apo kangy gueteriha, upéicha	Oñemba’apo kangy gueteriha, upéicha	NOCHANGE
Oreko’ẽmba,	Oreko’ẽmba,	NOCHANGE
Ijapytepekuéra oĩ mombe’urã ha mombe’upy oñemono’õva ishir-kuéragui, ha ojehecha oĩha jepokuaa he’ẽasýva ko atýpe.	Ijapytepekuéra oĩ mombe’urã ha mombe’upy oñemono’õva ishir-kuéragui, ha ojehecha oĩha jepokuaa he’ẽasýva ko atýpe.	NOCHANGE
Mbeguekatúpe ojepysyrõva hasypeve ñane retã ijojaha’ỹva	Mbeguekatúpe ojepysyrõva hasypeve ñane retã ijojaha’ỹva	NOCHANGE
Osẽ porã joaite.	Osẽ porã joaite.	NOCHANGE
Ñande poyvi joguaha.	Ñande poyvi joguaha.	NOCHANGE
Mba’éichapa heñói mymbakuéra	Mba’éichapa heñói mymbakuéra	NOCHANGE
Petei mba’e porã ogueruva’erã jahechápa nomopy’akyryiri pe imborayhúpe.	Petei mba’e porã ogueruva’erã jahechápa nomopy’akyryiri pe imborayhúpe.	NOCHANGE
Upéicha avei ñande	Upéicha avei ñande	NOCHANGE
Ivaivévare, kuñataĩ porã, ñande kichiha, róga rekávo.	Ivaivévare, kuñataĩ porã, ñande kichiha, róga rekávo.	NOCHANGE
Ha yvytu vevúi ku ko’ẽ oguerúva	Ha yvytu vevúi ku ko’ẽ oguerúva	NOCHANGE
Ko yvy ári ndaje oĩ	Ko yvy ári ndaje oĩ	NOCHANGE
Jehechauka oñembohetia’e va’erã.	Jehechauka oñembohetia’e va’erã.	NOCHANGE
Karai mba’e guasuetente oguerekova.	Karai mba’e guasuetente oguerekova.	NOCHANGE
Peva ha’e che mbo’ehára	Peva ha’e che mbo’ehára	NOCHANGE
Mbo’ekuaahára ikatupyryveva’ekue	Mbo’ekuaahára ikatupyryveva’ekue	NOCHANGE
Nemandu’ápa yvyraty oñongatúva ñane mba’epota ha...	Nemandu’ápa yvyraty oñongatúva ñane mba’epota ha...	NOCHANGE
Kuéra ojeruréva, mba’eveichavérõ ndikatúi oñenega ichupekuéra.	Kuéra ojeruréva, mba’eveichavérõ ndikatúi oñenega ichupekuéra.	NOCHANGE
Ohai ñe’ẽpoty peteĩ	Ohai ñe’ẽpoty peteĩ	NOCHANGE
Ko’ápe mba’ejararaẽ oje’e ha ojehai ha upei ae mba’eguerekopy.	Ko’ápe mba’ejararaẽ oje’e ha ojehai ha upei ae mba’eguerekopy.	NOCHANGE
Ta’ãnga, marangatukuéra ra’ãnga, kurusu, y karaipyre, juky, akãrague, kangue,	Ta’ãnga, marangatukuéra ra’ãnga, kurusu, y karaipyre, juky, akãrague, kangue,	NOCHANGE
Karia’y, kuñatãi, mitã rusu ha kakuaa,	Karia’y, kuñatãi, mitã rusu ha kakuaa,	NOCHANGE
Mymba kuéra	Mymba kuéra	NOCHANGE
Mbo’ehára pyahu ikatupyryveva’ekue oñe’êkuri iñirûnguéra rérape	Mbo’ehára pyahu ikatupyryveva’ekue oñe’êkuri iñirûnguéra rérape	NOCHANGE
Iñe’ẽ ha heko tee ryepýpe, upéichape	Iñe’ẽ ha heko tee ryepýpe, upéichape	NOCHANGE
Maymáva paraguái,	Maymáva paraguái,	NOCHANGE
Jepe, upe ára guive nosẽporãvei mba’eve chupekuéra. ña carmen jeko oúkuri	Jepe, upe ára guive nosẽporãvei mba’eve chupekuéra. ña carmen jeko oúkuri	NOCHANGE
Guarani tetã paraguái paraguái	Guarani tetã paraguái paraguái	NOCHANGE
Umi mba’e mante ahecha.	Umi mba’e mante ahecha.	NOCHANGE
Mba’e porã ikatu oñemyatã me’ẽmby, mba’e vai nahániri	Mba’e porã ikatu oñemyatã me’ẽmby, mba’e vai nahániri	NOCHANGE
Ha peteĩ rósape ijapaitérõ jasyrundy	Ha peteĩ rósape ijapaitérõ jasyrundy	NOCHANGE
Ne ñe’ã ruguápe.	Ne ñe’ã ruguápe.	NOCHANGE
Ñane ñe’ëratarendy ñe’ëpoty	Ñane ñe’ëratarendy ñe’ëpoty	NOCHANGE
Térã yvy puru’ã ru’ãre pyhare omburea,	Térã yvy puru’ã ru’ãre pyhare omburea,	NOCHANGE
Rapaikuéra jepe omochamame ñane mba’éva ijapytepekuéra	Rapaikuéra jepe omochamame ñane mba’éva ijapytepekuéra	NOCHANGE
Yvága ha yvy,	Yvága ha yvy,	NOCHANGE
Añetehápe, oĩ oporomongueráva yvy, y térã katu oporopohãnóva ñembo’e rupive.	Añetehápe, oĩ oporomongueráva yvy, y térã katu oporopohãnóva ñembo’e rupive.	NOCHANGE
Ha ohasáva umi ára	Ha ohasáva umi ára	NOCHANGE
Upéicha jagueroviáva.	Upéicha jagueroviáva.	NOCHANGE
Kóicha heñói’ypýkuri peteĩ ñe’ẽtekuaa ñanepytyvõkuaáva ñe’ẽjoaju apópe. ko ñe’ẽtekuaa pyahu oñembohéra ñe’ẽtekuaa ñemoñangatúva.	Kóicha heñói’ypýkuri peteĩ ñe’ẽtekuaa ñanepytyvõkuaáva ñe’ẽjoaju apópe. ko ñe’ẽtekuaa pyahu oñembohéra ñe’ẽtekuaa ñemoñangatúva.	NOCHANGE
Mba’asy, jejuka, ñemonda ha	Mba’asy, jejuka, ñemonda ha	NOCHANGE
Ohai ñe’ẽpoty peteĩteĩ	Ohai ñe’ẽpoty peteĩteĩ	NOCHANGE
Pe ijuru pukavymi nombotuichái mba’eve	Pe ijuru pukavymi nombotuichái mba’eve	NOCHANGE
Ko pyharépe aháta nde rógape.	Ko pyharépe aháta nde rógape.	NOCHANGE
-nahániri, che ruvicha- he’i tembiguái.	-nahániri, che ruvicha- he’i tembiguái.	NOCHANGE
Yvyra karẽ araka’eve ndopái.	Yvyra karẽ araka’eve ndopái.	NOCHANGE
O ñembosarái hese.	O ñembosarái hese.	NOCHANGE
Ñande rape pyahurã.	Ñande rape pyahurã.	NOCHANGE
Jajuhu ógape, ka’aguýre, ýpe ha mba’e.	Jajuhu ógape, ka’aguýre, ýpe ha mba’e.	NOCHANGE
A moingatu purahéi.	A moingatu purahéi.	NOCHANGE
Pejamína ko che ypýpe pehendumi che ñe’ê	Pejamína ko che ypýpe pehendumi che ñe’ê	NOCHANGE
Mba’ejegua ha tembi’u ñanemba’éva	Mba’ejegua ha tembi’u ñanemba’éva	NOCHANGE
Táva guasu argentino hesãi.	Táva guasu argentino hesãi.	NOCHANGE
Ne’ĩraha ko ñe’ẽ oho omanóvo.	Ne’ĩraha ko ñe’ẽ oho omanóvo.	NOCHANGE
Peru oguata térã oñani.	Peru oguata térã oñani.	NOCHANGE
Ojeroviaiteva’ekue ijehe, oñepyrũ okyhyje ha ipy’aragẽ. ojepoi upémarõ henda árigui ha ho’a pe tuju rapépe.	Ojeroviaiteva’ekue ijehe, oñepyrũ okyhyje ha ipy’aragẽ. ojepoi upémarõ henda árigui ha ho’a pe tuju rapépe.	NOCHANGE
Peteĩ mitã’i iporãitéva	Peteĩ mitã’i iporãitéva	NOCHANGE
Arapoteĩ marangatu	Arapoteĩ marangatu	NOCHANGE
Kame oho ojogua hagua peteĩ jopói	Kame oho ojogua hagua peteĩ jopói	NOCHANGE
Ñande jakay’u’arã ñamohenda’arã	Ñande jakay’u’arã ñamohenda’arã	NOCHANGE
Ta’ãngahai techapyrã	Ta’ãngahai techapyrã	NOCHANGE
Upe guarini hekomarãvape oñotỹ hikuái peteĩ ka’aguy mombyrýva upégui ha jatápe katu oñotỹ hikuái peteĩ ysyry iporãva rembe’ýpe.	Upe guarini hekomarãvape oñotỹ hikuái peteĩ ka’aguy mombyrýva upégui ha jatápe katu oñotỹ hikuái peteĩ ysyry iporãva rembe’ýpe.	NOCHANGE
Ko’emba jave ojehekýi che jarýi porãite.	Ko’emba jave ojehekýi che jarýi porãite.	NOCHANGE
Ha yvýgui tapicha hesekuéra oma’ê,	Ha yvýgui tapicha hesekuéra oma’ê,	NOCHANGE
Upéva aja ndikatúi omba’apo ambue, terã to jepaga ichupekuéra tetãguasu terã tetãminígui.	Upéva aja ndikatúi omba’apo ambue, terã to jepaga ichupekuéra tetãguasu terã tetãminígui.	NOCHANGE
Tetã ambuére purahéi apoi,	Tetã ambuére purahéi apoi,	NOCHANGE
Hi’arikuéra ho’a	Hi’arikuéra ho’a	NOCHANGE
Ko ñane retã yvýpe	Ko ñane retã yvýpe	NOCHANGE
. ñane ãngapyhy pe ko’ẽ mbyju	. ñane ãngapyhy pe ko’ẽ mbyju	NOCHANGE
Reheve, kuña kuéra	Reheve, kuña kuéra	NOCHANGE
Opytáne upérõ umi mokõi candato oguereko va’ekue hetave voto tenonderãme ha sapy’a	Opytáne upérõ umi mokõi candato oguereko va’ekue hetave voto tenonderãme ha sapy’a	NOCHANGE
Oguahê tape ka’aguýre, mba’éichapa oñemoi omaña hagua	Oguahê tape ka’aguýre, mba’éichapa oñemoi omaña hagua	NOCHANGE
Ohóva tetã ambuére oguerekóva, opaite ojehechaukaháicha, tuichamba’e	Ohóva tetã ambuére oguerekóva, opaite ojehechaukaháicha, tuichamba’e	NOCHANGE
Pópe oiporavóvo mávapa upe ñe’ẽ	Pópe oiporavóvo mávapa upe ñe’ẽ	NOCHANGE
Ha rehorõ sapy’ante hendive reñe’ẽse	Ha rehorõ sapy’ante hendive reñe’ẽse	NOCHANGE
Sapy’ánte, japáy ñapu’ãvo,	Sapy’ánte, japáy ñapu’ãvo,	NOCHANGE
Mba’éichapa che akãhata	Mba’éichapa che akãhata	NOCHANGE
- che ndévente rohayhu che memby, ndaha’éi avavépe- he’i isy.-	- che ndévente rohayhu che memby, ndaha’éi avavépe- he’i isy.-	NOCHANGE
Ndaikuaái ojehúva chéve, che ko’ênte sapy’a	Ndaikuaái ojehúva chéve, che ko’ênte sapy’a	NOCHANGE
Ñande akã hechaukaha.	Ñande akã hechaukaha.	NOCHANGE
China - chína tekoha tetã	China - chína tekoha tetã	NOCHANGE
A’aguyjeveme’ẽ ñanderuvusukuérape taha’eha’éva	A’aguyjeveme’ẽ ñanderuvusukuérape taha’eha’éva	NOCHANGE
Peteĩ jey amoñe’ẽ ñe’ẽndy ipygui iñakãpeve, ha’etevaekue cheve ñe’ẽpoty porã opa mba’e rehegua	Peteĩ jey amoñe’ẽ ñe’ẽndy ipygui iñakãpeve, ha’etevaekue cheve ñe’ẽpoty porã opa mba’e rehegua	NOCHANGE
Upe ára pukukue mymba kuera isaraki,	Upe ára pukukue mymba kuera isaraki,	NOCHANGE
. ikatuve’ỹva máramo hesãi roheja guive.	. ikatuve’ỹva máramo hesãi roheja guive.	NOCHANGE
Jorge costa - tetãvore joapykuéra-pe guarã	Jorge costa - tetãvore joapykuéra-pe guarã	NOCHANGE
Porãitére. ha’ekuéra ojokakuaairu. hetaiterei oiko upérupi karia’y	Porãitére. ha’ekuéra ojokakuaairu. hetaiterei oiko upérupi karia’y	NOCHANGE
Mayma yvypóra oguereko derecho osẽvo oimeraẽva tetãgui, taha e jepe hetãtee, ha upéi ou jevyo hetãme.	Mayma yvypóra oguereko derecho osẽvo oimeraẽva tetãgui, taha e jepe hetãtee, ha upéi ou jevyo hetãme.	NOCHANGE
Rosa iporãva nde joguaha.	Rosa iporãva nde joguaha.	NOCHANGE
Kachíke ha mba’yrumýi puku - o caipira e o trem.	Kachíke ha mba’yrumýi puku - o caipira e o trem.	NOCHANGE
Kuiba’e ñande rayhúgui, peteĩ koe’ẽ porãme,	Kuiba’e ñande rayhúgui, peteĩ koe’ẽ porãme,	NOCHANGE
Ojepuru oñepohano hagua tuguy kangy (sa’yju) ha py’a ndoiko porâiva (tye,	Ojepuru oñepohano hagua tuguy kangy (sa’yju) ha py’a ndoiko porâiva (tye,	NOCHANGE
Ñanduti veve ha ñe’ẽmondo	Ñanduti veve ha ñe’ẽmondo	NOCHANGE
Oúma temimbo’ekuéra	Oúma temimbo’ekuéra	NOCHANGE
Iporãiteva’erã ipukuverõ	Iporãiteva’erã ipukuverõ	NOCHANGE
Ñembo’e jeroky	Ñembo’e jeroky	NOCHANGE
Katupyrýpe mbo’ehaópe	Katupyrýpe mbo’ehaópe	NOCHANGE
Opa mba’e rerekóvape,	Opa mba’e rerekóvape,	NOCHANGE
Upéichape ojekuaa, concepción-pe oĩha	Upéichape ojekuaa, concepción-pe oĩha	NOCHANGE
Jerovia ha’e upe tembiapo oñemomba’eguasuvéva. ha’ekuéra omomba’eguasu tupã	Jerovia ha’e upe tembiapo oñemomba’eguasuvéva. ha’ekuéra omomba’eguasu tupã	NOCHANGE
Heta oĩ ñande rapicha ndoikuaáiva pe mbói guasu	Heta oĩ ñande rapicha ndoikuaáiva pe mbói guasu	NOCHANGE
. he’ĩ rehe añetegua.	. he’ĩ rehe añetegua.	NOCHANGE
Oporomomembýva, oñembohérava partéra chae, oipytyvõva kuña hyeguasúvape imemby	Oporomomembýva, oñembohérava partéra chae, oipytyvõva kuña hyeguasúvape imemby	NOCHANGE
Primavera rehegua.	Primavera rehegua.	NOCHANGE
Paraguay, ñemby	Paraguay, ñemby	NOCHANGE
Heta ñe’ẽ ñarõ oisu’u ñane ñe’ẽme	Heta ñe’ẽ ñarõ oisu’u ñane ñe’ẽme	NOCHANGE
Iberoamérica-pe, ha oñemba’apo va’erã umi tetã ikangýva gueteri	Iberoamérica-pe, ha oñemba’apo va’erã umi tetã ikangýva gueteri	NOCHANGE
Hi’ânte iko’êmo he’i ñandejára	Hi’ânte iko’êmo he’i ñandejára	NOCHANGE
Ohecha isy ha itúvape, ha’ekuéra angekóipe aréma oheka chupe.	Ohecha isy ha itúvape, ha’ekuéra angekóipe aréma oheka chupe.	NOCHANGE
Mbo’ehára ikatupyryveva’ekue i	Mbo’ehára ikatupyryveva’ekue i	NOCHANGE
Ateneo rejuhúta mayma táva’i ha tavaguasúpe oñeha’ã	Ateneo rejuhúta mayma táva’i ha tavaguasúpe oñeha’ã	NOCHANGE
Y ñe’ẽ opararã ohasávo yvykuáre	Y ñe’ẽ opararã ohasávo yvykuáre	NOCHANGE
Tetã pindoráma momorãhéi	Tetã pindoráma momorãhéi	NOCHANGE
Ha jatevu ojuhu porã. upéicha oguahẽ ára oiko haguã ñani guasu. jatevu oguahẽ avei upepe.	Ha jatevu ojuhu porã. upéicha oguahẽ ára oiko haguã ñani guasu. jatevu oguahẽ avei upepe.	NOCHANGE
Ha’e ohecha ko yvy ári ojehúva,	Ha’e ohecha ko yvy ári ojehúva,	NOCHANGE
Ikatu haguã opavave ohupyty umi mba’e porã oguerúva pe tekopykuaa	Ikatu haguã opavave ohupyty umi mba’e porã oguerúva pe tekopykuaa	NOCHANGE
Ñane angaipa rehe.	Ñane angaipa rehe.	NOCHANGE
Oveve ápe ha pépe	Oveve ápe ha pépe	NOCHANGE
He’iséva ñembojarupe gua nda ha’eteeiva.	He’iséva ñembojarupe gua nda ha’eteeiva.	NOCHANGE
Ñane ñenguahy’i va’ekuéma,	Ñane ñenguahy’i va’ekuéma,	NOCHANGE
Tetã peteĩ reko amérikagua	Tetã peteĩ reko amérikagua	NOCHANGE
Ndaikuaaivoínte ko chéve ojehúva.	Ndaikuaaivoínte ko chéve ojehúva.	NOCHANGE
Opaite mba’e apóre oñehepyme’ẽva’erã hekopete.	Opaite mba’e apóre oñehepyme’ẽva’erã hekopete.	NOCHANGE
Anive jaheja oiko ã mba’e vaiete ñane avañe’ẽre.	Anive jaheja oiko ã mba’e vaiete ñane avañe’ẽre.	NOCHANGE
Peteĩ jagua ogueraha ijurúpe so’o pehẽngue guasu.	Peteĩ jagua ogueraha ijurúpe so’o pehẽngue guasu.	NOCHANGE
Mokõive ñane ñe’ẽme rohai roipotágui mokõivéva oĩ ojoykére ikatuhaguãicha hetave ñane retãgua omoñe’ẽ ha oikuaa ñane mba’e jeroviaha.	Mokõive ñane ñe’ẽme rohai roipotágui mokõivéva oĩ ojoykére ikatuhaguãicha hetave ñane retãgua omoñe’ẽ ha oikuaa ñane mba’e jeroviaha.	NOCHANGE
Ayvu rapyta rã i oikuaá	Ayvu rapyta rã i oikuaá	NOCHANGE
Manu, imitãrusúpe, heta ára oguata ka’aguy pa’ũre iñirũnguérandi. iñirũnguéra opurahéi ojesareko mymbáre ha manu umi guyra purahéire.	Manu, imitãrusúpe, heta ára oguata ka’aguy pa’ũre iñirũnguérandi. iñirũnguéra opurahéi ojesareko mymbáre ha manu umi guyra purahéire.	NOCHANGE
Ha’eha ko yvy ári	Ha’eha ko yvy ári	NOCHANGE
Oĩ peteĩntechagua tesa porã ha’e umi oma’ẽva nderehe kunu’ũrekope	Oĩ peteĩntechagua tesa porã ha’e umi oma’ẽva nderehe kunu’ũrekope	NOCHANGE
Táva poyvi.	Táva poyvi.	NOCHANGE
Oĩ ha ojepuru guarani ñe’ẽ paraguáipe,	Oĩ ha ojepuru guarani ñe’ẽ paraguáipe,	NOCHANGE
Pe ho’ysã teete kuimba’ekuérape ombopy’akangyete,	Pe ho’ysã teete kuimba’ekuérape ombopy’akangyete,	NOCHANGE
Piro’ýpe y’uhéi ombogue.	Piro’ýpe y’uhéi ombogue.	NOCHANGE
Reko ha ñane ñe’ẽnguéra.	Reko ha ñane ñe’ẽnguéra.	NOCHANGE
Mba’éichapa oñeñangarekova’erã. upeichavérõ jepe, ndokuerái. upémarõ ojeraha	Mba’éichapa oñeñangarekova’erã. upeichavérõ jepe, ndokuerái. upémarõ ojeraha	NOCHANGE
Umi ygua peteĩ árapegua haguynóma ko’ẽro guarã. upévare ñambosako’i va’erã ko’ẽreíre upe jaiporútavante voi.	Umi ygua peteĩ árapegua haguynóma ko’ẽro guarã. upévare ñambosako’i va’erã ko’ẽreíre upe jaiporútavante voi.	NOCHANGE
Ha ha’e kuéra oikoháicha	Ha ha’e kuéra oikoháicha	NOCHANGE
Ñane retãgua hese tokambu. ha tomomorã.	Ñane retãgua hese tokambu. ha tomomorã.	NOCHANGE
Taheñói jevy ñane mba’e.	Taheñói jevy ñane mba’e.	NOCHANGE
Mokõi pu’ae atã ohóva ojoapykuéri ñe’ẽpehẽme, ara-ka’eve nomoheñóiva pukõi.	Mokõi pu’ae atã ohóva ojoapykuéri ñe’ẽpehẽme, ara-ka’eve nomoheñóiva pukõi.	NOCHANGE
Upe acusación terã denuncia oĩ va’erã kuatiápe, ha he’i porã va’erã mba’etépa umi ojejapo	Upe acusación terã denuncia oĩ va’erã kuatiápe, ha he’i porã va’erã mba’etépa umi ojejapo	NOCHANGE
Jukyrýre osyrýva upépe ombe’úva ijapyra’ỹva ñande rekove	Jukyrýre osyrýva upépe ombe’úva ijapyra’ỹva ñande rekove	NOCHANGE
Mbo’ehára oipuru itahai.	Mbo’ehára oipuru itahai.	NOCHANGE
A- ko aty oñeha’ãta ombohape ñe’ẽ rembiapo rehegua, tojejapo jekupytýpe, ñe’ẽasa ha he’iséva.	A- ko aty oñeha’ãta ombohape ñe’ẽ rembiapo rehegua, tojejapo jekupytýpe, ñe’ẽasa ha he’iséva.	NOCHANGE
Ñembo’e pa’iruvichakuéra ñane retâmegua oipotáva oñeñembo’e	Ñembo’e pa’iruvichakuéra ñane retâmegua oipotáva oñeñembo’e	NOCHANGE
Mba’eve omboguevi ichupe.	Mba’eve omboguevi ichupe.	NOCHANGE
Kuatiapareviára ha’e mba’e ndojepotaíva ojekuaa kaauka, hembyre ha’e marãnduñémurã	Kuatiapareviára ha’e mba’e ndojepotaíva ojekuaa kaauka, hembyre ha’e marãnduñémurã	NOCHANGE
Hembiapohápe, oĩ aja upe gobernador omoĩ va’ekue ichupe.	Hembiapohápe, oĩ aja upe gobernador omoĩ va’ekue ichupe.	NOCHANGE
Ko aty mba’erepyme’ẽ ojejapo mymbajuka, pira jeikutu ha yva ñemono’õgui.	Ko aty mba’erepyme’ẽ ojejapo mymbajuka, pira jeikutu ha yva ñemono’õgui.	NOCHANGE
Ko’ã mba’e porãita	Ko’ã mba’e porãita	NOCHANGE
Kirito omano ñande angaipakuérare. ñañanimanepa jaheja mba’e vai apo ha jajapo tekotevẽ’ỹ ijehasa asyete	Kirito omano ñande angaipakuérare. ñañanimanepa jaheja mba’e vai apo ha jajapo tekotevẽ’ỹ ijehasa asyete	NOCHANGE
Paraguáipe.	Paraguáipe.	NOCHANGE
Itá mbaraka.	Itá mbaraka.	NOCHANGE
Reko porãve ndive.	Reko porãve ndive.	NOCHANGE
Pyharevete chochĩ ijayvujoa avatytýpa ha óga jerére.	Pyharevete chochĩ ijayvujoa avatytýpa ha óga jerére.	NOCHANGE
Ndaipotái mba’eve,	Ndaipotái mba’eve,	NOCHANGE
Kuarahymimby ahecha ñe’êmbucu rape rupi.	Kuarahymimby ahecha ñe’êmbucu rape rupi.	NOCHANGE
Mba’éichapa mbo’ehára che rera javier	Mba’éichapa mbo’ehára che rera javier	NOCHANGE
Ñane retã ipytuhê.	Ñane retã ipytuhê.	NOCHANGE
Kóva niko ñe’ẽpyahã ñe’ẽngatu rupive. ojapóva ñe’ẽsyry oñeha’ãne ikatuha peve omoinge hemiandu hapicha -ohendúva- apytu’ũme.	Kóva niko ñe’ẽpyahã ñe’ẽngatu rupive. ojapóva ñe’ẽsyry oñeha’ãne ikatuha peve omoinge hemiandu hapicha -ohendúva- apytu’ũme.	NOCHANGE
He’iséva téra ojeheroha guairaguakuérape.	He’iséva téra ojeheroha guairaguakuérape.	NOCHANGE
Ñande yvy imarãtaha,	Ñande yvy imarãtaha,	NOCHANGE
Upéi, pyhareve peteĩ, kuarahy aku guahẽme, ára pa-	Upéi, pyhareve peteĩ, kuarahy aku guahẽme, ára pa-	NOCHANGE
Tembikuaaty ha’etéva ha tembikuaaty purúva	Tembikuaaty ha’etéva ha tembikuaaty purúva	NOCHANGE
Ha péina katu iko’ẽ kyvõ ko oñemondepáva	Ha péina katu iko’ẽ kyvõ ko oñemondepáva	NOCHANGE
Pya’e ajohéipata che ao.	Pya’e ajohéipata che ao.	NOCHANGE
Ñane ñe’ẽ teete porãite	Ñane ñe’ẽ teete porãite	NOCHANGE
Jesu’ýre, che ndaikosevéi.	Jesu’ýre, che ndaikosevéi.	NOCHANGE
Hyakuãvu paraguay, ko yvága ja’eha.	Hyakuãvu paraguay, ko yvága ja’eha.	NOCHANGE
Pe techakuaa, ñepysyrõ, jehechauka ha ñeñangareko umi arandu yma	Pe techakuaa, ñepysyrõ, jehechauka ha ñeñangareko umi arandu yma	NOCHANGE
Ñande po kuéra, ome’ê akanundu	Ñande po kuéra, ome’ê akanundu	NOCHANGE
Tapichakuéra ko tavaygua avei omba’apo mitã kuña membygua’u aoguigua apópe.	Tapichakuéra ko tavaygua avei omba’apo mitã kuña membygua’u aoguigua apópe.	NOCHANGE
Cedro, guatambú omboverãva’erã,	Cedro, guatambú omboverãva’erã,	NOCHANGE
Mbo’ehára ome’êjey chéve che rembiapokue.	Mbo’ehára ome’êjey chéve che rembiapokue.	NOCHANGE
Mba’e ha’e virurenda ñemonda ñambojojarõ imoypyre	Mba’e ha’e virurenda ñemonda ñambojojarõ imoypyre	NOCHANGE
Upépe ae nesãsóta ha upépe ae revy’áne.	Upépe ae nesãsóta ha upépe ae revy’áne.	NOCHANGE
Ko mymba oiko paraguasure ha ysyryre (ñembyamérika ha mbyteamérika ñóntema) avei.	Ko mymba oiko paraguasure ha ysyryre (ñembyamérika ha mbyteamérika ñóntema) avei.	NOCHANGE
Ha máva pendereru ko’ápe.	Ha máva pendereru ko’ápe.	NOCHANGE
Ñemoheñói niko mba’eguasuete umi	Ñemoheñói niko mba’eguasuete umi	NOCHANGE
Ha iñe’ẽ hyakuã ymáva	Ha iñe’ẽ hyakuã ymáva	NOCHANGE
Maymáva aipota pe jehesarekomi sapy’aite	Maymáva aipota pe jehesarekomi sapy’aite	NOCHANGE
Hetaite ñe’ẽpoty poravopyre kuña ñe’ãme oñongatu porãva	Hetaite ñe’ẽpoty poravopyre kuña ñe’ãme oñongatu porãva	NOCHANGE
Che katu ko’ápe ko’ẽ mboyvemi ajetypekáma	Che katu ko’ápe ko’ẽ mboyvemi ajetypekáma	NOCHANGE
Ohókuri omba’apo peteĩ mandyjutýpe. mbeguekatúpe ojoguajeýkuri tupa, apyka,	Ohókuri omba’apo peteĩ mandyjutýpe. mbeguekatúpe ojoguajeýkuri tupa, apyka,	NOCHANGE
Avañe’ẽkuaahára ojapo umi mba’e iporãitereirasáva	Avañe’ẽkuaahára ojapo umi mba’e iporãitereirasáva	NOCHANGE
Oguyguy ápe ha pépe. hógape ndopytavéi.	Oguyguy ápe ha pépe. hógape ndopytavéi.	NOCHANGE
Nde réra ahenói, che pytu ikangy,	Nde réra ahenói, che pytu ikangy,	NOCHANGE
Ha’ekuéra ojoguaniko ombo’eniko	Ha’ekuéra ojoguaniko ombo’eniko	NOCHANGE
Kuimba’e ndohaíri ijeheguireínte. ha’ekuéra ohai	Kuimba’e ndohaíri ijeheguireínte. ha’ekuéra ohai	NOCHANGE
Mokõi tupãrymbami ogueraha peteĩ ánga yvágape. hesu rape jerovia ñemohechauka.	Mokõi tupãrymbami ogueraha peteĩ ánga yvágape. hesu rape jerovia ñemohechauka.	NOCHANGE
Oñembyakúva’erã ñandy térã ñandyry ha pype ojýva’erã sevói hykupa peve, oñemoĩ chupe juky, ojeipe’a tatágui ha ojehejáva’erã oñemboho’ysã.	Oñembyakúva’erã ñandy térã ñandyry ha pype ojýva’erã sevói hykupa peve, oñemoĩ chupe juky, ojeipe’a tatágui ha ojehejáva’erã oñemboho’ysã.	NOCHANGE
Oñemboykeháicha oúvo ndaha’éi ohapejokónteva,	Oñemboykeháicha oúvo ndaha’éi ohapejokónteva,	NOCHANGE
Mitã ome’ẽ ñandeve py’a rory	Mitã ome’ẽ ñandeve py’a rory	NOCHANGE
Representante terã abogado de empresa reheguárõ, omba’apóva hepyrehe tetãguasu, tetãmini ha	Representante terã abogado de empresa reheguárõ, omba’apóva hepyrehe tetãguasu, tetãmini ha	NOCHANGE
Oiméramo ohenóiva ne rokẽme peteĩ pyhareve	Oiméramo ohenóiva ne rokẽme peteĩ pyhareve	NOCHANGE
O ñembyahýi.	O ñembyahýi.	NOCHANGE
Rabiar. intr. ñeko’õi, resako’õ, pochy, ñemyrõ, ñarõ.	Rabiar. intr. ñeko’õi, resako’õ, pochy, ñemyrõ, ñarõ.	NOCHANGE
Oñemombarete haguâ, ombojuruhe jey ha omoingo porâ jevy hagua tembi’ukuéra rape hasy rire	Oñemombarete haguâ, ombojuruhe jey ha omoingo porâ jevy hagua tembi’ukuéra rape hasy rire	NOCHANGE
Yvypóra rape.	Yvypóra rape.	NOCHANGE
Upeicha oguahẽ mborayhu añetete	Upeicha oguahẽ mborayhu añetete	NOCHANGE
Ha katu pe añeteguava oiko va’ekue, ha justicia nda hechái	Ha katu pe añeteguava oiko va’ekue, ha justicia nda hechái	NOCHANGE
Pumbasy niko ha’e mba’e tuichavéva ojapova’ekue	Pumbasy niko ha’e mba’e tuichavéva ojapova’ekue	NOCHANGE
Ára ha ára iñangatáva	Ára ha ára iñangatáva	NOCHANGE
Ñañeha’âkena ñamombykyve ára ha ára teko asy.	Ñañeha’âkena ñamombykyve ára ha ára teko asy.	NOCHANGE
Ko ñe’ê omanóta, ipytu kangýma guarani ñe’ê.	Ko ñe’ê omanóta, ipytu kangýma guarani ñe’ê.	NOCHANGE
Oñe’ẽve opa umi ñe’ẽnguéra rehegua derécho ojeguerekóva rehe ha he’i derécho humano-rõ voi ojeguerekoha ko mba’e.	Oñe’ẽve opa umi ñe’ẽnguéra rehegua derécho ojeguerekóva rehe ha he’i derécho humano-rõ voi ojeguerekoha ko mba’e.	NOCHANGE
Karu ñemuha rembi’u rysýikaru ñemuha rembi’u rysýi	Karu ñemuha rembi’u rysýikaru ñemuha rembi’u rysýi	NOCHANGE
Ha péicha avei heta oime upérupi oikundaháva	Ha péicha avei heta oime upérupi oikundaháva	NOCHANGE
Gua’upore mba’e iporãvéva , heta mobe’uapy’ãkuérape, ha’e marandu he’íva mba’apojekuéra oñeimo’ãvanteha	Gua’upore mba’e iporãvéva , heta mobe’uapy’ãkuérape, ha’e marandu he’íva mba’apojekuéra oñeimo’ãvanteha	NOCHANGE
Ore retâ, ore ñe’â,	Ore retâ, ore ñe’â,	NOCHANGE
Oñakamby ñane ñe’ẽ oñani oho ñane retãre.	Oñakamby ñane ñe’ẽ oñani oho ñane retãre.	NOCHANGE
Paraguay mba’eteéva ani haguã okañy	Paraguay mba’eteéva ani haguã okañy	NOCHANGE
Ku ko’ẽ pytã jave,	Ku ko’ẽ pytã jave,	NOCHANGE
Jahava’erâ jahecha mba’épa oikotevê umi mitâ.	Jahava’erâ jahecha mba’épa oikotevê umi mitâ.	NOCHANGE
Ñe’ẽasãihára ypykuérava omoherakuãporãseve iñe’ẽ ha iñarandupykuéra	Ñe’ẽasãihára ypykuérava omoherakuãporãseve iñe’ẽ ha iñarandupykuéra	NOCHANGE
Ko yakã iporã.	Ko yakã iporã.	NOCHANGE
Raperã ojepe’áva, ha hi’arietegua, jahecha porãvo tuichaha ojapóva pe	Raperã ojepe’áva, ha hi’arietegua, jahecha porãvo tuichaha ojapóva pe	NOCHANGE
Mba’ekuéra jaikuaa porãvéva ha’e umi araka’eve jaikuaapyhyvaekue	Mba’ekuéra jaikuaa porãvéva ha’e umi araka’eve jaikuaapyhyvaekue	NOCHANGE
Ha chupe oñemomba’éva	Ha chupe oñemomba’éva	NOCHANGE
Ha ipukúva rembe ári.	Ha ipukúva rembe ári.	NOCHANGE
Ndaijáiva arapy rembiasakuépe. ha’ekuéra, ára ha ára, ija táva marandu huguýva apytépente.	Ndaijáiva arapy rembiasakuépe. ha’ekuéra, ára ha ára, ija táva marandu huguýva apytépente.	NOCHANGE
Tekove ha’e ojehúva ndéve nerembiapo’aja ambue apopyrãpe	Tekove ha’e ojehúva ndéve nerembiapo’aja ambue apopyrãpe	NOCHANGE
Tupãópe oñeguahẽ haguã.	Tupãópe oñeguahẽ haguã.	NOCHANGE
Ha’e oguatáva itáva rupi.	Ha’e oguatáva itáva rupi.	NOCHANGE
Mbo’eharakuéra hatãiterei ñe’ẽtekuaápe ha nombo’éi ñe’ẽ jeporu.	Mbo’eharakuéra hatãiterei ñe’ẽtekuaápe ha nombo’éi ñe’ẽ jeporu.	NOCHANGE
Mbyjajere itaembo ojeréva kuarahýre.	Mbyjajere itaembo ojeréva kuarahýre.	NOCHANGE
Tetãguasúre, terã héra porãre, ojapo porã haguã hembiapo.	Tetãguasúre, terã héra porãre, ojapo porã haguã hembiapo.	NOCHANGE
Marõ oĩmiviva ko arapýpe	Marõ oĩmiviva ko arapýpe	NOCHANGE
Mávapa oimo’â ko che rekove	Mávapa oimo’â ko che rekove	NOCHANGE
Paraguay pyahu ha iñarandúva jaipurumanteva’erâ ñane avañe’ê opaite hendápe ha	Paraguay pyahu ha iñarandúva jaipurumanteva’erâ ñane avañe’ê opaite hendápe ha	NOCHANGE
Iporã, ajépa ko ára.	Iporã, ajépa ko ára.	NOCHANGE
. ñande pytu hóva ñañandúrõ hína ko juayhu paha.	. ñande pytu hóva ñañandúrõ hína ko juayhu paha.	NOCHANGE
Peteĩ yvypóra hemiandu pyahúva ha’e peteĩ tarova hemiandu ijyvytupeve	Peteĩ yvypóra hemiandu pyahúva ha’e peteĩ tarova hemiandu ijyvytupeve	NOCHANGE
Moteĩva iñe’ẽpehẽteĩva	Moteĩva iñe’ẽpehẽteĩva	NOCHANGE
Nhaneramoĩ kuery monde ojapo raka’e. oma’ẽ rã yvyra re ipoyi porã’i va’e’rã	Nhaneramoĩ kuery monde ojapo raka’e. oma’ẽ rã yvyra re ipoyi porã’i va’e’rã	NOCHANGE
Ma’ẽrã oikóta ñane ko’ẽrõ ñamyakãsã guive umi peky	Ma’ẽrã oikóta ñane ko’ẽrõ ñamyakãsã guive umi peky	NOCHANGE
Ñande yvy guaraní opu’ã oñe’ẽ oñeme’ẽ mba’aporã.	Ñande yvy guaraní opu’ã oñe’ẽ oñeme’ẽ mba’aporã.	NOCHANGE
Ha’eha nde ára	Ha’eha nde ára	NOCHANGE
Nde pukavy kangy ha nde áva apopê sa’yju asy	Nde pukavy kangy ha nde áva apopê sa’yju asy	NOCHANGE
Ojupi yvágape, oikove jevy,	Ojupi yvágape, oikove jevy,	NOCHANGE
Oĩ ko pakistán asiape tetã.	Oĩ ko pakistán asiape tetã.	NOCHANGE
Ore ha’e ko tetã ãngapu,	Ore ha’e ko tetã ãngapu,	NOCHANGE
Tembiapo imbaretevéva upépe ha’e mymba ñemongakuaa.	Tembiapo imbaretevéva upépe ha’e mymba ñemongakuaa.	NOCHANGE
Kóva ko che ayvu atýpe	Kóva ko che ayvu atýpe	NOCHANGE
Ha umi guyra opurahéi	Ha umi guyra opurahéi	NOCHANGE
Che ru hái rasy ha oipohanóva’erã.	Che ru hái rasy ha oipohanóva’erã.	NOCHANGE
Tetãvore itapúa, paraguay	Tetãvore itapúa, paraguay	NOCHANGE
A-mbo-jere ña’ẽmbe	A-mbo-jere ña’ẽmbe	NOCHANGE
Ko táva oñemohenda peteĩ tenda yvatépe ha ojerepa hese yvytyeta omoporãmba jepéva.	Ko táva oñemohenda peteĩ tenda yvatépe ha ojerepa hese yvytyeta omoporãmba jepéva.	NOCHANGE
Tetãme, yvy ape ári oĩva.	Tetãme, yvy ape ári oĩva.	NOCHANGE
Opukavy ñane ñe’ã ha ipotĩ ñande ruguy,	Opukavy ñane ñe’ã ha ipotĩ ñande ruguy,	NOCHANGE
Jehai mbyky ñe’ê reko ha jeiporu rehegua	Jehai mbyky ñe’ê reko ha jeiporu rehegua	NOCHANGE
Upe mba’e oñandumavoi hikuái ho’óre.	Upe mba’e oñandumavoi hikuái ho’óre.	NOCHANGE
Ichupe kuéra.	Ichupe kuéra.	NOCHANGE
Ojepuru’arã upe ka’avo pyahu, hérava ka’a, opytava’ekue mokõivéva poguýpe.	Ojepuru’arã upe ka’avo pyahu, hérava ka’a, opytava’ekue mokõivéva poguýpe.	NOCHANGE
Ñande py’ápe	Ñande py’ápe	NOCHANGE
Opoñýva ko che ãngapýre ñe’ẽtee.	Opoñýva ko che ãngapýre ñe’ẽtee.	NOCHANGE
Ndojehekyichéne araka’eve	Ndojehekyichéne araka’eve	NOCHANGE
Ha upéicha oguahéramo pe ára ipaha,	Ha upéicha oguahéramo pe ára ipaha,	NOCHANGE
Tetãvore taragui tetãmini	Tetãvore taragui tetãmini	NOCHANGE
Ha’e ojeroky che amiga pirundi.	Ha’e ojeroky che amiga pirundi.	NOCHANGE
Ko moambueha niko oñanduka ñandéve mba’eichaitépa ojehu ñe’ẽtéva moandu.	Ko moambueha niko oñanduka ñandéve mba’eichaitépa ojehu ñe’ẽtéva moandu.	NOCHANGE
Korea (india), peteĩ táva india pegua, korea tavaty itavusu, tetãvore chhattisgarh-pe.	Korea (india), peteĩ táva india pegua, korea tavaty itavusu, tetãvore chhattisgarh-pe.	NOCHANGE
Ñande yvy itarova,	Ñande yvy itarova,	NOCHANGE
Ojepurúva mba’e porã ha mba’e vai aporã. oĩ tapicha -iñaranduka’atýva-	Ojepurúva mba’e porã ha mba’e vai aporã. oĩ tapicha -iñaranduka’atýva-	NOCHANGE
Upévare ha’e peteĩ táva javy’aha ndaiporihápe tyapu vai, ikatuhaguãicha mbohupakuéra oñemoguahẽ porã.	Upévare ha’e peteĩ táva javy’aha ndaiporihápe tyapu vai, ikatuhaguãicha mbohupakuéra oñemoguahẽ porã.	NOCHANGE
Mitâmimi jepémo ndaha’éi iñemoñare tee. upéicha avei, umi kuimba’e oñemboheko	Mitâmimi jepémo ndaha’éi iñemoñare tee. upéicha avei, umi kuimba’e oñemboheko	NOCHANGE
Ñande yvy tahory.	Ñande yvy tahory.	NOCHANGE
Oikóva oñakãrapu’ã haguã, upe tekopykuaa juavy ojeguerovy’a ha	Oikóva oñakãrapu’ã haguã, upe tekopykuaa juavy ojeguerovy’a ha	NOCHANGE
Upévako hína pe chéve ojehúva	Upévako hína pe chéve ojehúva	NOCHANGE
Ajopy ajora amboty avañe’ẽme,	Ajopy ajora amboty avañe’ẽme,	NOCHANGE
Tetã rekuái	Tetã rekuái	NOCHANGE
Hekoha rehe, hapichakuéra rekove rehe, hemikotevë rehe, heko	Hekoha rehe, hapichakuéra rekove rehe, hemikotevë rehe, heko	NOCHANGE
Tupã oheja ñandéve pa porokuaitáva	Tupã oheja ñandéve pa porokuaitáva	NOCHANGE
Ñe’ê rusu oúva ahy’o ñembotýgui	Ñe’ê rusu oúva ahy’o ñembotýgui	NOCHANGE
Peteĩ ka’aru pytũ.	Peteĩ ka’aru pytũ.	NOCHANGE
Centurión ohupyty va’ekue tuicha ñemoarandu. iñarandu pypuku rupi ikatúkuri jaikuaa porã mba’etépa umi paraguái rembihasakue.	Centurión ohupyty va’ekue tuicha ñemoarandu. iñarandu pypuku rupi ikatúkuri jaikuaa porã mba’etépa umi paraguái rembihasakue.	NOCHANGE
Oñepyrũ ñani guasu. jatevu opo guasu ruguái rehe ha ojoko upépe.	Oñepyrũ ñani guasu. jatevu opo guasu ruguái rehe ha ojoko upépe.	NOCHANGE
Peichaháguinte oñandu sapy’a opokóva hese, ha’ete voi	Peichaháguinte oñandu sapy’a opokóva hese, ha’ete voi	NOCHANGE
Oñe’ẽ mbegue chive hembirekópe	Oñe’ẽ mbegue chive hembirekópe	NOCHANGE
Ani rejehe’a hese kuéra.	Ani rejehe’a hese kuéra.	NOCHANGE
Oiko ndaje jurumi, eterei ojerokyséva ha ojehechaukaséva umi ambue tapicha kuérape.	Oiko ndaje jurumi, eterei ojerokyséva ha ojehechaukaséva umi ambue tapicha kuérape.	NOCHANGE
(peteĩ tecñaukápe.)	(peteĩ tecñaukápe.)	NOCHANGE
Aĩchagua mba’e porã	Aĩchagua mba’e porã	NOCHANGE
Marandu ciencia reheguáva avei.	Marandu ciencia reheguáva avei.	NOCHANGE
Oipota rupi iporã.	Oipota rupi iporã.	NOCHANGE
Tetã paraguái momorãhéi	Tetã paraguái momorãhéi	NOCHANGE
Ndaikatúi amongeta che ñe’ẽ ojepo’opa cheñe’ã ojereraha	Ndaikatúi amongeta che ñe’ẽ ojepo’opa cheñe’ã ojereraha	NOCHANGE
Rejapo porã.	Rejapo porã.	NOCHANGE
Ha che anga ku mitãicha nde rehe ama’ê asy	Ha che anga ku mitãicha nde rehe ama’ê asy	NOCHANGE
Ñane retãme oñeñoty avei avati miri ha ojejapo chugui pan (mbujape)	Ñane retãme oñeñoty avei avati miri ha ojejapo chugui pan (mbujape)	NOCHANGE
Karuguápe ha ka’aguýpe	Karuguápe ha ka’aguýpe	NOCHANGE
Kirirĩme ha’eñónte, omyasaĩ ñe’ãpopópe	Kirirĩme ha’eñónte, omyasaĩ ñe’ãpopópe	NOCHANGE
Omba’emombe’úva oikóva ha he’íva mba’éichapa	Omba’emombe’úva oikóva ha he’íva mba’éichapa	NOCHANGE
Térã ñañeme’e ñamano peve.	Térã ñañeme’e ñamano peve.	NOCHANGE
Maravẽ ndoikói, mba’e sa’ýpa eguereko	Maravẽ ndoikói, mba’e sa’ýpa eguereko	NOCHANGE
Ñande ha’e umi avañe’ẽ rape porãite	Ñande ha’e umi avañe’ẽ rape porãite	NOCHANGE
Nde rehotapa ko’ẽrõ	Nde rehotapa ko’ẽrõ	NOCHANGE
Péichantevoiko kuimba’e yvy ári	Péichantevoiko kuimba’e yvy ári	NOCHANGE
Ombohetia’éva ñemongeta opáichagua yvypóra aty apytépe, ha	Ombohetia’éva ñemongeta opáichagua yvypóra aty apytépe, ha	NOCHANGE
Ombohekoviáne umívape nomomarãi guive umi oje’éva ko constitución-pe.	Ombohekoviáne umívape nomomarãi guive umi oje’éva ko constitución-pe.	NOCHANGE
Che ñe’ãme oikóva oikarãi,	Che ñe’ãme oikóva oikarãi,	NOCHANGE
Nde poyvi araháta ko che pyti’ápe tomimbirei.	Nde poyvi araháta ko che pyti’ápe tomimbirei.	NOCHANGE
Kóva peteĩ mba’e he’ẽ ndajaroviaseivavoi, ha’e he’ẽre ha ojejapógui mba’e háivagui. ojejapopa rire opyta haivy’asy ha hi’acido’imi.	Kóva peteĩ mba’e he’ẽ ndajaroviaseivavoi, ha’e he’ẽre ha ojejapógui mba’e háivagui. ojejapopa rire opyta haivy’asy ha hi’acido’imi.	NOCHANGE
Mba’e ikatúva tuicha ombyai	Mba’e ikatúva tuicha ombyai	NOCHANGE
Tuichaite mba’e ñande rekoha	Tuichaite mba’e ñande rekoha	NOCHANGE
Ñane rekosâ’ỹre, ñane ñe’êngatúre	Ñane rekosâ’ỹre, ñane ñe’êngatúre	NOCHANGE
Ha’eha peteĩ ñe’ẽ komunidapegua, oipurúvo	Ha’eha peteĩ ñe’ẽ komunidapegua, oipurúvo	NOCHANGE
Ko aretépe roñembyatýta óga guasúpe.	Ko aretépe roñembyatýta óga guasúpe.	NOCHANGE
Ñande ra’ykuérape ñame’ẽne	Ñande ra’ykuérape ñame’ẽne	NOCHANGE
Ava rembiasakue yvy ape ári heñói guive	Ava rembiasakue yvy ape ári heñói guive	NOCHANGE
Amo gotyo, ñemano ýpe.	Amo gotyo, ñemano ýpe.	NOCHANGE
Ojuka mba’epota heta ára ñaneavañe’ẽ	Ojuka mba’epota heta ára ñaneavañe’ẽ	NOCHANGE
Ko puruhára oguereko guarani ñe’ẽ iñe’ẽteérõ.	Ko puruhára oguereko guarani ñe’ẽ iñe’ẽteérõ.	NOCHANGE
Tyapu ojoguáva ñe’ẽme.	Tyapu ojoguáva ñe’ẽme.	NOCHANGE
Ha’évo che ndaha’eiha ára yvoty	Ha’évo che ndaha’eiha ára yvoty	NOCHANGE
Pe mba’e ñambyasyetéva	Pe mba’e ñambyasyetéva	NOCHANGE
Ñemby, nemby, paraguay	Ñemby, nemby, paraguay	NOCHANGE
Ko ojehúca chéve.	Ko ojehúca chéve.	NOCHANGE
Ko yvy ári jeiko	Ko yvy ári jeiko	NOCHANGE
Peteĩ tapỹi ndaiporivéima...	Peteĩ tapỹi ndaiporivéima...	NOCHANGE
Ma’erã piko ñandejára	Ma’erã piko ñandejára	NOCHANGE
Paraguaýpe ha upe ára guive opytu’úma ñane retãme.	Paraguaýpe ha upe ára guive opytu’úma ñane retãme.	NOCHANGE
Tohasána (ha’ekuéra) toñapytĩna (ha’ekuéra)	Tohasána (ha’ekuéra) toñapytĩna (ha’ekuéra)	NOCHANGE
Heta ñe’ẽ kirirĩ	Heta ñe’ẽ kirirĩ	NOCHANGE
Ha’ekuéra ojahupa omopotĩmba	Ha’ekuéra ojahupa omopotĩmba	NOCHANGE
Tesakã, r, h, ñe’	Tesakã, r, h, ñe’	NOCHANGE
Omboypáma ko tetã.	Omboypáma ko tetã.	NOCHANGE
Ha’eha mba’e he’õ rerekuára. avei ha’e pira, mbusu, ysapy ha yvoty ñangarekohára.	Ha’eha mba’e he’õ rerekuára. avei ha’e pira, mbusu, ysapy ha yvoty ñangarekohára.	NOCHANGE
(oñembohapejeýva tetãvorekuéra ñembyatypyre mikyonésiagua)	(oñembohapejeýva tetãvorekuéra ñembyatypyre mikyonésiagua)	NOCHANGE
Tavakuairetã amandajerapépe (tembiapoukapýpe)	Tavakuairetã amandajerapépe (tembiapoukapýpe)	NOCHANGE
Yvy jave re,	Yvy jave re,	NOCHANGE
Upe pyhare guive ojehecha ko guyra pyahu omimbipáva jeguágui.	Upe pyhare guive ojehecha ko guyra pyahu omimbipáva jeguágui.	NOCHANGE
Mokõi mba’e vai apytépe, aiporavo jepi pe ndaikuaaívagueteri	Mokõi mba’e vai apytépe, aiporavo jepi pe ndaikuaaívagueteri	NOCHANGE
Mba’éichaitépa oiko itavakuérape ha avei mba’éichapa omba’apo hikuái.	Mba’éichaitépa oiko itavakuérape ha avei mba’éichapa omba’apo hikuái.	NOCHANGE
Ho’a, opu’â ha ojeity nde ári	Ho’a, opu’â ha ojeity nde ári	NOCHANGE
Yvypóra ko arapýpe,	Yvypóra ko arapýpe,	NOCHANGE
Mitâ’iete ha opurahéima ñanemba’etéva	Mitâ’iete ha opurahéima ñanemba’etéva	NOCHANGE
Upépe oikéva guive.	Upépe oikéva guive.	NOCHANGE
Iporã jaikuaami mba’éichapa heñói mymbakuéra.	Iporã jaikuaami mba’éichapa heñói mymbakuéra.	NOCHANGE
Omyasãi mbya pa’ũme iñe’ẽ poty jera,	Omyasãi mbya pa’ũme iñe’ẽ poty jera,	NOCHANGE
Apa ñe’ẽtéva	Apa ñe’ẽtéva	NOCHANGE
Ohejava’ekue ñandéve hekovia ko arapýpe	Ohejava’ekue ñandéve hekovia ko arapýpe	NOCHANGE
Guarani ñe’ẽ oñemoañetévo jápoke péva	Guarani ñe’ẽ oñemoañetévo jápoke péva	NOCHANGE
Topami pe ñembyahýi mba’epota	Topami pe ñembyahýi mba’epota	NOCHANGE
Ko ñe’ẽ poty porãite	Ko ñe’ẽ poty porãite	NOCHANGE
Oñemomba’eguasu ñane avañe’ê.	Oñemomba’eguasu ñane avañe’ê.	NOCHANGE
Iguaraniñe’ẽ añóvapente, ha’ekuéraramo	Iguaraniñe’ẽ añóvapente, ha’ekuéraramo	NOCHANGE
Umi mba’e osẽva’ekuére oñeha’ãramo	Umi mba’e osẽva’ekuére oñeha’ãramo	NOCHANGE
Pytuhê rape mba’asykuérape guarâ.	Pytuhê rape mba’asykuérape guarâ.	NOCHANGE
Ary pukukue jave, ojejapo aty tetâ remimboukuéra argentina-ygua paraguáipe	Ary pukukue jave, ojejapo aty tetâ remimboukuéra argentina-ygua paraguáipe	NOCHANGE
Mba’éichapa ñane âme	Mba’éichapa ñane âme	NOCHANGE
Iporã ha uáicha ñe’ẽ rekove, oĩnte rehe	Iporã ha uáicha ñe’ẽ rekove, oĩnte rehe	NOCHANGE
Ha’ekuéra ohovereve ohetũve	Ha’ekuéra ohovereve ohetũve	NOCHANGE
Ñe’ême. ipahápe, pachín centurión imbaraka reheve, ohenduka opavavépe purahéi	Ñe’ême. ipahápe, pachín centurión imbaraka reheve, ohenduka opavavépe purahéi	NOCHANGE
Ohenói ko’ẽtĩ guyrakuéra ñe’ẽ,	Ohenói ko’ẽtĩ guyrakuéra ñe’ẽ,	NOCHANGE
Péicha oiko hikuái heta ára joayhu pórã, joayhu potĩme.	Péicha oiko hikuái heta ára joayhu pórã, joayhu potĩme.	NOCHANGE
Jasypoapy, ava ñe’ê jasy	Jasypoapy, ava ñe’ê jasy	NOCHANGE
Oñeñeha’ã voi ojejukaite haguã icha ko ñe’ẽ.	Oñeñeha’ã voi ojejukaite haguã icha ko ñe’ẽ.	NOCHANGE
Tembiguai ñe’ê po’ive	Tembiguai ñe’ê po’ive	NOCHANGE
Ha’ekuérakatu añeteguáicha, ombohovái ha opukavymi.	Ha’ekuérakatu añeteguáicha, ombohovái ha opukavymi.	NOCHANGE
Ha oñeha’â hikuái oiko joaju, tesâi, mbarete ha vy’apavême	Ha oñeha’â hikuái oiko joaju, tesâi, mbarete ha vy’apavême	NOCHANGE
Tapichápe. oñemohu’ãvo ko tembiapo	Tapichápe. oñemohu’ãvo ko tembiapo	NOCHANGE
Ha oipyaháva purahéi chupekuéra omoñe’ê.	Ha oipyaháva purahéi chupekuéra omoñe’ê.	NOCHANGE
Porã rerekua ko’ẽ potyju ne ma’ẽ mimbíva,	Porã rerekua ko’ẽ potyju ne ma’ẽ mimbíva,	NOCHANGE
Panambi pytã.	Panambi pytã.	NOCHANGE
Ha opaite mba’e ivaíva hesekuérante opẽmba.	Ha opaite mba’e ivaíva hesekuérante opẽmba.	NOCHANGE
Ku avave oikuaa’ỹva	Ku avave oikuaa’ỹva	NOCHANGE
Ñande ypykuéra oiko yvy marae’y reka.	Ñande ypykuéra oiko yvy marae’y reka.	NOCHANGE
Sediciosa ojerereko va’erã mba’evetérõ.	Sediciosa ojerereko va’erã mba’evetérõ.	NOCHANGE
Ne ñe’ã ruguápe ipoty ko’ẽ.	Ne ñe’ã ruguápe ipoty ko’ẽ.	NOCHANGE
Ñande ypykuéra oikuaa porãva	Ñande ypykuéra oikuaa porãva	NOCHANGE
- haku mbeguakatu he’i, ñemihápe guari omboy’úva.	- haku mbeguakatu he’i, ñemihápe guari omboy’úva.	NOCHANGE
Péicha peru omoticha’i rréipe, omenda itajýra rehe ha imba’ereko heta opytávo.	Péicha peru omoticha’i rréipe, omenda itajýra rehe ha imba’ereko heta opytávo.	NOCHANGE
Che ñe’ãme aipeju	Che ñe’ãme aipeju	NOCHANGE
. ko yvy ári jahasáva,	. ko yvy ári jahasáva,	NOCHANGE
Ne ryakuãvúva reína ku ára ha pyhare.	Ne ryakuãvúva reína ku ára ha pyhare.	NOCHANGE
. ha tetã rayhu niko oñohẽ.	. ha tetã rayhu niko oñohẽ.	NOCHANGE
Oikuaa pu’aka oguerekóva	Oikuaa pu’aka oguerekóva	NOCHANGE
Tetãvore paraguari	Tetãvore paraguari	NOCHANGE
Tavakuéra ha tenda ambuéva mauritáñame	Tavakuéra ha tenda ambuéva mauritáñame	NOCHANGE
Chembopotava’erã.	Chembopotava’erã.	NOCHANGE
He’iséva ava aty oikóva’ekue ñane retãme.	He’iséva ava aty oikóva’ekue ñane retãme.	NOCHANGE
Ha omoĩ ñane ne’ã kuápe heñoi ha ipoty jera	Ha omoĩ ñane ne’ã kuápe heñoi ha ipoty jera	NOCHANGE
Ñe’ê mba’asy rehegua ojeporuvéva	Ñe’ê mba’asy rehegua ojeporuvéva	NOCHANGE
Ñe’ẽasahára.	Ñe’ẽasahára.	NOCHANGE
Ha nde ári ojeroky	Ha nde ári ojeroky	NOCHANGE
Temimbo’ekuéra ohova’ekue posadas guive	Temimbo’ekuéra ohova’ekue posadas guive	NOCHANGE
Ñande yvyñe’ẽ guaraniñe’ẽ omomba’ekuaáva ñane retã	Ñande yvyñe’ẽ guaraniñe’ẽ omomba’ekuaáva ñane retã	NOCHANGE
Ñemongakuaa ojupe, oñeme’ê memehápe mba’e porã jehechauka	Ñemongakuaa ojupe, oñeme’ê memehápe mba’e porã jehechauka	NOCHANGE
Tavayguakuéra oñembosako’i	Tavayguakuéra oñembosako’i	NOCHANGE
Kokue ha yvyra. kokue ha yvyramata.	Kokue ha yvyra. kokue ha yvyramata.	NOCHANGE
Tekombo’e ha’e tembiaporape ohejáva ojehupyty hetavéva temiandu ragẽ	Tekombo’e ha’e tembiaporape ohejáva ojehupyty hetavéva temiandu ragẽ	NOCHANGE
Opaite ára ary pegua	Opaite ára ary pegua	NOCHANGE
Añembokate asy guaraní ñe’ẽme	Añembokate asy guaraní ñe’ẽme	NOCHANGE
Mba’e a’ã petei i oguerojera ojeupe.	Mba’e a’ã petei i oguerojera ojeupe.	NOCHANGE
Che- mbyaju ko- t- a’arõ	Che- mbyaju ko- t- a’arõ	NOCHANGE
Ñande rekove opa ñakirirĩramo mba’ekuéra momba’etéva añete rovai	Ñande rekove opa ñakirirĩramo mba’ekuéra momba’etéva añete rovai	NOCHANGE
Tavakuairetã ndominikagua	Tavakuairetã ndominikagua	NOCHANGE
Oñembohapéta avei ñe’ẽ raperekarã, ha mokõive ñane ñe’ẽtee, ypykuéra ñe’ẽ ha pytaguay ñe’ẽ ñemoasãi ha ñeñongatu.	Oñembohapéta avei ñe’ẽ raperekarã, ha mokõive ñane ñe’ẽtee, ypykuéra ñe’ẽ ha pytaguay ñe’ẽ ñemoasãi ha ñeñongatu.	NOCHANGE
Ombohovái umi mba’e iñypytũ, hypy’ũ, jahecha’ỹ ha jaikuaaporã’ỹva, jepémo	Ombohovái umi mba’e iñypytũ, hypy’ũ, jahecha’ỹ ha jaikuaaporã’ỹva, jepémo	NOCHANGE
Hesu tupão añete	Hesu tupão añete	NOCHANGE
Aranduveterekohára ha’e peteĩ hesatũva koty iñypytũvápe ohekava peteĩ mbarakaja hũ ndaipóriva upepe. peteĩ tupãrekokuaáva ha’e pe ojuhúva	Aranduveterekohára ha’e peteĩ hesatũva koty iñypytũvápe ohekava peteĩ mbarakaja hũ ndaipóriva upepe. peteĩ tupãrekokuaáva ha’e pe ojuhúva	NOCHANGE
Ñanderesaraivóve ñandehegui, jajapo mba’ekuéra momba’eguasurã ha mandu’arãpy	Ñanderesaraivóve ñandehegui, jajapo mba’ekuéra momba’eguasurã ha mandu’arãpy	NOCHANGE
Je’ejey ojehu tekotevẽramo ojepurujeyjey peteĩ ñe’ẽ hesakaporãve hagua pe oje’eséva.	Je’ejey ojehu tekotevẽramo ojepurujeyjey peteĩ ñe’ẽ hesakaporãve hagua pe oje’eséva.	NOCHANGE
Oñeñangareko va’erã óga ojejapo va’ekue upevarã anihaguáicha oñembyai hete ha iñakã rehegua.	Oñeñangareko va’erã óga ojejapo va’ekue upevarã anihaguáicha oñembyai hete ha iñakã rehegua.	NOCHANGE
Peteĩ kuña oñeme’ẽramo he’ise ipu’akahague	Peteĩ kuña oñeme’ẽramo he’ise ipu’akahague	NOCHANGE
Ary oiko távapy paraguaýpe.	Ary oiko távapy paraguaýpe.	NOCHANGE
Ijapúva ndaha’éiva imba’e porãva.	Ijapúva ndaha’éiva imba’e porãva.	NOCHANGE
Umi hénte ombyasy hembiapo vai hague. upéva ohechauka hikuái oadora jeývo jehovápe. upévare, jehová oipytyvõ jey chupekuéra.	Umi hénte ombyasy hembiapo vai hague. upéva ohechauka hikuái oadora jeývo jehovápe. upévare, jehová oipytyvõ jey chupekuéra.	NOCHANGE
(oñembohapejeýva tetã peteĩ reko amérikagua tetãvorekuéra)	(oñembohapejeýva tetã peteĩ reko amérikagua tetãvorekuéra)	NOCHANGE
Ñane avañe’ë marangatúpe.	Ñane avañe’ë marangatúpe.	NOCHANGE
Jaikóvo ha’éicha oñondivepa.	Jaikóvo ha’éicha oñondivepa.	NOCHANGE
Takuarembo (táva)	Takuarembo (táva)	NOCHANGE
Ñande katu ko yvy ári	Ñande katu ko yvy ári	NOCHANGE
Ha kuimba’e ndeikuaáva rembyatypa nde jehe.	Ha kuimba’e ndeikuaáva rembyatypa nde jehe.	NOCHANGE
Mitãkaria’ykuéra ko’ágãgua oha’ãngapy’ãpo pira pire ha’eha opaite mba’e, okakuaavove oikua porã	Mitãkaria’ykuéra ko’ágãgua oha’ãngapy’ãpo pira pire ha’eha opaite mba’e, okakuaavove oikua porã	NOCHANGE
Jajora ñene ñe’ẽ apytĩ.	Jajora ñene ñe’ẽ apytĩ.	NOCHANGE
Ñepyrũrãite guive iñe’ẽ ypykuépe,	Ñepyrũrãite guive iñe’ẽ ypykuépe,	NOCHANGE
Chupe ajerurévo che ñe’ẽ yrũrã,	Chupe ajerurévo che ñe’ẽ yrũrã,	NOCHANGE
Oguerekoje ipoguýpe umi karugua guasu, tuju ha y renda ojepysóva ñúre.	Oguerekoje ipoguýpe umi karugua guasu, tuju ha y renda ojepysóva ñúre.	NOCHANGE
Ñame’ẽ haguã ichupe	Ñame’ẽ haguã ichupe	NOCHANGE
Tavakuairetã kóngo táva	Tavakuairetã kóngo táva	NOCHANGE
Taropurahéi nde juru mboypýri nde ratypykua.	Taropurahéi nde juru mboypýri nde ratypykua.	NOCHANGE
Ha’ekuéra ohapyhína omboguehína	Ha’ekuéra ohapyhína omboguehína	NOCHANGE
Tembiapokue tembikuaapavẽ rapykuere, ha ambueve.	Tembiapokue tembikuaapavẽ rapykuere, ha ambueve.	NOCHANGE
Atyñe’ẽ oñemongeta haguã tembiapokuéra ka’arehegua)	Atyñe’ẽ oñemongeta haguã tembiapokuéra ka’arehegua)	NOCHANGE
Ñe’ẽriregua -iñe’ẽpehẽtei ha iñe’ẽpehẽ’etáva- ojepuru ha ojehai jave, katuete ohova’erã peteĩ ñe’ẽ rire.	Ñe’ẽriregua -iñe’ẽpehẽtei ha iñe’ẽpehẽ’etáva- ojepuru ha ojehai jave, katuete ohova’erã peteĩ ñe’ẽ rire.	NOCHANGE
Ñane reta ha mañaípa ha’ekuéra nderehe imandu’a	Ñane reta ha mañaípa ha’ekuéra nderehe imandu’a	NOCHANGE
Ombopyahu yvotyty, ko yvy ape omoporâ.	Ombopyahu yvotyty, ko yvy ape omoporâ.	NOCHANGE
Ko tembi’u ikatu ñañaongatu heta ára jave, upevarã katu jajaty va’erã avatiku’i ñembojy pyrépe.	Ko tembi’u ikatu ñañaongatu heta ára jave, upevarã katu jajaty va’erã avatiku’i ñembojy pyrépe.	NOCHANGE
Sa’ive oikuaaro tapichakuéra mba’eichapa ojejapo so’oku’iapytĩnguera ha tekorãnguéra, oke porãvene	Sa’ive oikuaaro tapichakuéra mba’eichapa ojejapo so’oku’iapytĩnguera ha tekorãnguéra, oke porãvene	NOCHANGE
Tetã rendakue térã ijapekue.	Tetã rendakue térã ijapekue.	NOCHANGE
Isásórõ ñande yvy,	Isásórõ ñande yvy,	NOCHANGE
Peteĩ ñati’ũmi	Peteĩ ñati’ũmi	NOCHANGE
Pehẽngue ome’ẽva ichupe mba’ekuaaita. oipurúva oguerokañy	Pehẽngue ome’ẽva ichupe mba’ekuaaita. oipurúva oguerokañy	NOCHANGE
Oikóva ’ãga ha umi ouva’erãme guarã.	Oikóva ’ãga ha umi ouva’erãme guarã.	NOCHANGE
He’iséva ñeme’ê hi’upyrâ térâ ambue mba’e mávape tavaguasu rupi.	He’iséva ñeme’ê hi’upyrâ térâ ambue mba’e mávape tavaguasu rupi.	NOCHANGE
Ñemongetápe oñembohapóva, ojeiko porãve haguã tetãygua ha tetã	Ñemongetápe oñembohapóva, ojeiko porãve haguã tetãygua ha tetã	NOCHANGE
Umi tekopykuaa ha mba’e porãnguéra apopy tekotevê añete, ojejapo ha	Umi tekopykuaa ha mba’e porãnguéra apopy tekotevê añete, ojejapo ha	NOCHANGE
Mba’e rehe repuka	Mba’e rehe repuka	NOCHANGE
Ojehechakuaa avei iporãha oñembohape tembiapo ogueru va’erã tekojoja	Ojehechakuaa avei iporãha oñembohape tembiapo ogueru va’erã tekojoja	NOCHANGE
Ndaipórirõ sapy’ánte	Ndaipórirõ sapy’ánte	NOCHANGE
Ha’epaite va’ekue ojapo	Ha’epaite va’ekue ojapo	NOCHANGE
Tapichakuéra kuatia guarani ñe’ẽme,	Tapichakuéra kuatia guarani ñe’ẽme,	NOCHANGE
Maymáva ijatyva’ekue	Maymáva ijatyva’ekue	NOCHANGE
Asapukái, aturuñe’ẽ	Asapukái, aturuñe’ẽ	NOCHANGE
Oñembohãimbiti ha oisu’úvo chupe opyta omanorõguáicha.	Oñembohãimbiti ha oisu’úvo chupe opyta omanorõguáicha.	NOCHANGE
Ohejáva neryakuãngue che ñe’ãme	Ohejáva neryakuãngue che ñe’ãme	NOCHANGE
Tembi’urã ijatypáva peteĩ hendápe. upémarõ, kirirĩháme, oñemboja ha omboguejy	Tembi’urã ijatypáva peteĩ hendápe. upémarõ, kirirĩháme, oñemboja ha omboguejy	NOCHANGE
Ndoikuaái gueteri ha’ekuéra	Ndoikuaái gueteri ha’ekuéra	NOCHANGE
Oje’e peteĩ atýpe tuicha mba’eha oñeñangareko ypykuéra ñe’ẽ rehe	Oje’e peteĩ atýpe tuicha mba’eha oñeñangareko ypykuéra ñe’ẽ rehe	NOCHANGE
Nahi’ãiva’ekue che ñe’ẽ oguahẽ avave apysápe	Nahi’ãiva’ekue che ñe’ẽ oguahẽ avave apysápe	NOCHANGE
Ñemby ñemuha	Ñemby ñemuha	NOCHANGE
Oipytyvõ va’erã abogado oikuaháva mitã ha okakuaháva derecho rehegua, oñepyrũ guive	Oipytyvõ va’erã abogado oikuaháva mitã ha okakuaháva derecho rehegua, oñepyrũ guive	NOCHANGE
Ñane avañe’ê, ñande purahéi,	Ñane avañe’ê, ñande purahéi,	NOCHANGE
Mávapa isy ha túva,	Mávapa isy ha túva,	NOCHANGE
Tojejapo ne rembipota ko yvy ári yvágape guáicha.	Tojejapo ne rembipota ko yvy ári yvágape guáicha.	NOCHANGE
Ha ñande poyvi oñuambaitéma ko ñane retã.	Ha ñande poyvi oñuambaitéma ko ñane retã.	NOCHANGE
Mbo’eharakuéra pyahu itapegua	Mbo’eharakuéra pyahu itapegua	NOCHANGE
Ñe’ẽ péina opurahéi.	Ñe’ẽ péina opurahéi.	NOCHANGE
Ñemby ñemuha poyvi	Ñemby ñemuha poyvi	NOCHANGE
Tekoayhu ndaha’ei ñeme’ẽ, hákatu ñorairõ joja’ỹrekópe	Tekoayhu ndaha’ei ñeme’ẽ, hákatu ñorairõ joja’ỹrekópe	NOCHANGE
Ha’ekuéra ojokuávoi opyrũvoi	Ha’ekuéra ojokuávoi opyrũvoi	NOCHANGE
Amandáu ho’ava’ekue ombyai kogakuéra kokuépegua.	Amandáu ho’ava’ekue ombyai kogakuéra kokuépegua.	NOCHANGE
Umi democracia semidirecta instituto oĩva ko constitción-pe, oñemoingo va’erã voite, ha	Umi democracia semidirecta instituto oĩva ko constitción-pe, oñemoingo va’erã voite, ha	NOCHANGE
Umi omba’apóva tetãmini reheguáre oñepyrũ guive ha ipahape omombe’u va’erã mba’épa	Umi omba’apóva tetãmini reheguáre oñepyrũ guive ha ipahape omombe’u va’erã mba’épa	NOCHANGE
Ha’ekuéra ojojuhu oñonupã	Ha’ekuéra ojojuhu oñonupã	NOCHANGE
Ñamboyke’imi ñopichãi, péva ohechauka ñande ajumahañaína.	Ñamboyke’imi ñopichãi, péva ohechauka ñande ajumahañaína.	NOCHANGE
(oñembohapejeýva inca-kuéra)	(oñembohapejeýva inca-kuéra)	NOCHANGE
Che retã, ku yvotytýpe, opytáva mombyry.	Che retã, ku yvotytýpe, opytáva mombyry.	NOCHANGE
Umi tekopykuaa ha ñe’ê ohechaukáva táva heko ymáva, ñande ypykue ha	Umi tekopykuaa ha ñe’ê ohechaukáva táva heko ymáva, ñande ypykue ha	NOCHANGE
Tupã, ñande jára, nde irũnamo oiko imombe’u katupýra nde kuña pavẽgui.	Tupã, ñande jára, nde irũnamo oiko imombe’u katupýra nde kuña pavẽgui.	NOCHANGE
. ko’ã ore ñe’ẽre nemandu’ahápe	. ko’ã ore ñe’ẽre nemandu’ahápe	NOCHANGE
Aregua ha’e peteĩ táva neporãmbajepéva oñangarekóva ogakuéra porã ymaite guare orekóva óga jereguasu iporãva.	Aregua ha’e peteĩ táva neporãmbajepéva oñangarekóva ogakuéra porã ymaite guare orekóva óga jereguasu iporãva.	NOCHANGE
Ka’aguy hesakãhápe kapi’ipe rovyũ ha hyakuãvureíva ári orairõ	Ka’aguy hesakãhápe kapi’ipe rovyũ ha hyakuãvureíva ári orairõ	NOCHANGE
Nde kóga pono ho’u	Nde kóga pono ho’u	NOCHANGE
Jahupyty va’ekue oñondive.	Jahupyty va’ekue oñondive.	NOCHANGE
Péva ha’e nde túva mba’e.	Péva ha’e nde túva mba’e.	NOCHANGE
Ojapo rupi upéva, oiko chuguikuéra pekadór ha ñandejára omosẽ chupekuéra pe hardíngui.	Ojapo rupi upéva, oiko chuguikuéra pekadór ha ñandejára omosẽ chupekuéra pe hardíngui.	NOCHANGE
Oguata oúvo tupão guive.	Oguata oúvo tupão guive.	NOCHANGE
Me guarépe ojejapyhyha tetã ñe’ẽ teéramo	Me guarépe ojejapyhyha tetã ñe’ẽ teéramo	NOCHANGE
Tavusu tetâ guasu, táva guasu.	Tavusu tetâ guasu, táva guasu.	NOCHANGE
Guaraní ñemoñare ñande yvýre ojeroviáva ha oñeha’ãva.	Guaraní ñemoñare ñande yvýre ojeroviáva ha oñeha’ãva.	NOCHANGE
I ñembyahýi.	I ñembyahýi.	NOCHANGE
Upépe katu oñembohoryvéma hese hikuái, ova ova yvyra rakãre, opuka ha oiporavo yva iporãvéva tujamíme ohechauka.	Upépe katu oñembohoryvéma hese hikuái, ova ova yvyra rakãre, opuka ha oiporavo yva iporãvéva tujamíme ohechauka.	NOCHANGE
Temimbo’e ohayhúva hetâ, itáva ha itáva ñemoñarépe	Temimbo’e ohayhúva hetâ, itáva ha itáva ñemoñarépe	NOCHANGE
Peteĩ mburuvicha guasuvépe upepegua omoañete haguã umi hembiapo, ha péicharõ kóva opyta	Peteĩ mburuvicha guasuvépe upepegua omoañete haguã umi hembiapo, ha péicharõ kóva opyta	NOCHANGE
Vy’ápe che retãygua.	Vy’ápe che retãygua.	NOCHANGE
Ha’ekuéra ohejámo oñemitỹmo	Ha’ekuéra ohejámo oñemitỹmo	NOCHANGE
Upéva hína omomoyiva ñane rembiapo.	Upéva hína omomoyiva ñane rembiapo.	NOCHANGE
Che ragẽ iguatako’ẽ ha oho ha’eño ha’e,	Che ragẽ iguatako’ẽ ha oho ha’eño ha’e,	NOCHANGE
Ha mba’erãpa reisu’úta,	Ha mba’erãpa reisu’úta,	NOCHANGE
Omosêse chupekuéra.	Omosêse chupekuéra.	NOCHANGE
Tekopykuaa mba’e porãre. upéicha avei, oipe’a tape iporãva ojeporu haguã,	Tekopykuaa mba’e porãre. upéicha avei, oipe’a tape iporãva ojeporu haguã,	NOCHANGE
Avakuaaty ñemboja’o	Avakuaaty ñemboja’o	NOCHANGE
Kóva. jprd.	Kóva. jprd.	NOCHANGE
Ko ñemohendápe oĩ óga yvateite táva nduvái pegua	Ko ñemohendápe oĩ óga yvateite táva nduvái pegua	NOCHANGE
Apysa rasýpe, hamba’e.	Apysa rasýpe, hamba’e.	NOCHANGE
Iporã ha ojeguapáva. omimbi hovy asy.	Iporã ha ojeguapáva. omimbi hovy asy.	NOCHANGE
Investigaciones administrativas oñepyrũ va’erã omba’apo hembiapokuérape añetehápe, ha	Investigaciones administrativas oñepyrũ va’erã omba’apo hembiapokuérape añetehápe, ha	NOCHANGE
Iporãvéva po’a	Iporãvéva po’a	NOCHANGE
Ojevýje karai y rembe’ýpe ha ohenói pira’ípe.	Ojevýje karai y rembe’ýpe ha ohenói pira’ípe.	NOCHANGE
Ha’evahína upe ñe’ẽ ojepuruvéva.	Ha’evahína upe ñe’ẽ ojepuruvéva.	NOCHANGE
Aguyjevete hína ñande ypykuéra, ñande sy, ñande ru...	Aguyjevete hína ñande ypykuéra, ñande sy, ñande ru...	NOCHANGE
Kangue rasy ñande ku’ápe	Kangue rasy ñande ku’ápe	NOCHANGE
Tetãmini ha táva mokõive ikatuha peve ojapo omoingouka va’erã yvy jeporu ha avei	Tetãmini ha táva mokõive ikatuha peve ojapo omoingouka va’erã yvy jeporu ha avei	NOCHANGE
Ha’ete hyakuã ymáva	Ha’ete hyakuã ymáva	NOCHANGE
Nemoirũ mbyja ko’ẽmbota	Nemoirũ mbyja ko’ẽmbota	NOCHANGE
Purahéi ñanemba’éva	Purahéi ñanemba’éva	NOCHANGE
Huvichakuéra ohendu chupe. oike tetã rembiguáirõ ha oho oguahêmeve campo jordan-pe.	Huvichakuéra ohendu chupe. oike tetã rembiguáirõ ha oho oguahêmeve campo jordan-pe.	NOCHANGE
Ha je aipo che angatarãnte ko yvy ári nde reju.	Ha je aipo che angatarãnte ko yvy ári nde reju.	NOCHANGE
Oñembojoja pe jehechakuaa ha jehepyme’ê umi mba’e porã apoharépe,	Oñembojoja pe jehechakuaa ha jehepyme’ê umi mba’e porã apoharépe,	NOCHANGE
Ñemby , paraguay -	Ñemby , paraguay -	NOCHANGE
Ko’ẽju tenondegua.	Ko’ẽju tenondegua.	NOCHANGE
Omoĩ ka’i ijyva guýpe ha oipykúi hóga rape. oguãhẽ, oheka tukumbo ha oñapytĩ ka’ípe yvyra poguasu óga kupépe oĩva rehe.	Omoĩ ka’i ijyva guýpe ha oipykúi hóga rape. oguãhẽ, oheka tukumbo ha oñapytĩ ka’ípe yvyra poguasu óga kupépe oĩva rehe.	NOCHANGE
Kuimba’ekuéra ojegueraha porãva kuñakuéra ndive ha’e umi oikuaáva mba’eichápa jeikove hese’ỹkuéra	Kuimba’ekuéra ojegueraha porãva kuñakuéra ndive ha’e umi oikuaáva mba’eichápa jeikove hese’ỹkuéra	NOCHANGE
Tetã oĩva tekorãty hetatetãgua hekopegua.	Tetã oĩva tekorãty hetatetãgua hekopegua.	NOCHANGE
Ñe’ẽjoajuha,	Ñe’ẽjoajuha,	NOCHANGE
Ha ipyko’ẽmíva opyta opupu mborayhu ykua,	Ha ipyko’ẽmíva opyta opupu mborayhu ykua,	NOCHANGE
Pe mbyja oguéva ñande ñama’êvo hese.	Pe mbyja oguéva ñande ñama’êvo hese.	NOCHANGE
Ava reko porâ niko heñóiva mba’evai tanimbukuégui	Ava reko porâ niko heñóiva mba’evai tanimbukuégui	NOCHANGE
Ha oimérõ tekotevẽ.	Ha oimérõ tekotevẽ.	NOCHANGE
Peju mitã kuéra, peju pevy’a,	Peju mitã kuéra, peju pevy’a,	NOCHANGE
Tetã tetãvore joapykuéra	Tetã tetãvore joapykuéra	NOCHANGE
Upéi oĩ avei	Upéi oĩ avei	NOCHANGE
Tupãme ajerure che ñembo’épe,	Tupãme ajerure che ñembo’épe,	NOCHANGE
Paraguay (tetã paraguái)	Paraguay (tetã paraguái)	NOCHANGE
Ha upépe oiko hague	Ha upépe oiko hague	NOCHANGE
Karaícha hete ñembo’y,	Karaícha hete ñembo’y,	NOCHANGE
Oguãhẽ ára ajedekitávo nde rehe.	Oguãhẽ ára ajedekitávo nde rehe.	NOCHANGE
Temimbo’ekuéra ndive ii	Temimbo’ekuéra ndive ii	NOCHANGE
Umi mba’e oikóva	Umi mba’e oikóva	NOCHANGE
Hógape opyta itúva ha isy	Hógape opyta itúva ha isy	NOCHANGE
Ñu, ka’aguýre,	Ñu, ka’aguýre,	NOCHANGE
Oñemongetaháguihina hesaho hikuái peteĩ karréta nandíre, ohasáva ohóvo, ha jeko	Oñemongetaháguihina hesaho hikuái peteĩ karréta nandíre, ohasáva ohóvo, ha jeko	NOCHANGE
Jevyevy ke ja’e pe tetã myakãhápe	Jevyevy ke ja’e pe tetã myakãhápe	NOCHANGE
Poteĩha ndereipyhyichéne omenda’ỹva nde rehe ndive.	Poteĩha ndereipyhyichéne omenda’ỹva nde rehe ndive.	NOCHANGE
Tembikuaaty purúva	Tembikuaaty purúva	NOCHANGE
Kurusu ra’ãnga marangatu rehe, nde orepysyrõ orerayhú’ỹvagui. tupã orejára. túva, ta’ýra ha pytu marangatu rerapýpe. ta’upéicha hesu.	Kurusu ra’ãnga marangatu rehe, nde orepysyrõ orerayhú’ỹvagui. tupã orejára. túva, ta’ýra ha pytu marangatu rerapýpe. ta’upéicha hesu.	NOCHANGE
Ñe’ẽ okára hesãiva,	Ñe’ẽ okára hesãiva,	NOCHANGE
Kuéra, ha oñemoĩ ombohovái opa mburuvicha oñemomba’eharére.	Kuéra, ha oñemoĩ ombohovái opa mburuvicha oñemomba’eharére.	NOCHANGE
Che rapichakuéra heko porã.	Che rapichakuéra heko porã.	NOCHANGE
Ñande ypykuéra ojapo mboguaha ha ombohéra yrupê.	Ñande ypykuéra ojapo mboguaha ha ombohéra yrupê.	NOCHANGE
Ahechahápe amba’y ha’e inga, granada, mburukuja ha urumbe yvy pytâháre	Ahechahápe amba’y ha’e inga, granada, mburukuja ha urumbe yvy pytâháre	NOCHANGE
Tetã jehayhu purahéi	Tetã jehayhu purahéi	NOCHANGE
Chepyharéma nde rógape.	Chepyharéma nde rógape.	NOCHANGE
Umi neñe’ẽ ojoapypyre remoporãvéva’erã.	Umi neñe’ẽ ojoapypyre remoporãvéva’erã.	NOCHANGE
Upéva hína peteĩ goviérno pyahu ojapótava hustísia ko yvy ape ári.	Upéva hína peteĩ goviérno pyahu ojapótava hustísia ko yvy ape ári.	NOCHANGE
Pe mitârusu ndachejeroviahái, upévagui ndaipotái ou che rógape.	Pe mitârusu ndachejeroviahái, upévagui ndaipotái ou che rógape.	NOCHANGE
Ñe’ẽpoty - poesia.	Ñe’ẽpoty - poesia.	NOCHANGE
Ñepytyvõ ha mborayhu,	Ñepytyvõ ha mborayhu,	NOCHANGE
Ndaipóri ñe’ê	Ndaipóri ñe’ê	NOCHANGE
Ha heta ára ojekuaátava cherehe.	Ha heta ára ojekuaátava cherehe.	NOCHANGE
Michínte jepépa ndaivevuivéi che mba’embyasy.	Michínte jepépa ndaivevuivéi che mba’embyasy.	NOCHANGE
Ko’aicha mba’éko mitá mboriahúpe rasa ombovy’áva,	Ko’aicha mba’éko mitá mboriahúpe rasa ombovy’áva,	NOCHANGE
Ko ñemohenda ojejapo iñe’ẽpehẽ retakua rupive.	Ko ñemohenda ojejapo iñe’ẽpehẽ retakua rupive.	NOCHANGE
Oipytyvõvaoeerã avei oñemyesakã hagua opa mbaoee	Oipytyvõvaoeerã avei oñemyesakã hagua opa mbaoee	NOCHANGE
Ñambohérava akãrapu’ã ha’e apañuai ñemoambue	Ñambohérava akãrapu’ã ha’e apañuai ñemoambue	NOCHANGE
Kuatiapareviára ha’e pa’ũ nandi gueronyhẽ apokuaapy	Kuatiapareviára ha’e pa’ũ nandi gueronyhẽ apokuaapy	NOCHANGE
Ha’ekuéra ojerovianunga ombyasynunga	Ha’ekuéra ojerovianunga ombyasynunga	NOCHANGE
Che ñe’ã yvágape roguerekóva mbyjami ñemóirõ	Che ñe’ã yvágape roguerekóva mbyjami ñemóirõ	NOCHANGE
Tekombo’e hendapete omopu’ãva omoporãva añete ñane retã	Tekombo’e hendapete omopu’ãva omoporãva añete ñane retã	NOCHANGE
Kuéra rehegua, ha avei he’i mba’éichapa ojejapóne opa umiva.	Kuéra rehegua, ha avei he’i mba’éichapa ojejapóne opa umiva.	NOCHANGE
Ko yvy ápe ári	Ko yvy ápe ári	NOCHANGE
Ndajahechai mba’ekuéra ha’ehaícha, térã ñande ha’ehaícha	Ndajahechai mba’ekuéra ha’ehaícha, térã ñande ha’ehaícha	NOCHANGE
Tenda apohára kuéra.	Tenda apohára kuéra.	NOCHANGE
. purahéi he’ẽ jeroky rari, ha ñe’ẽ porã.	. purahéi he’ẽ jeroky rari, ha ñe’ẽ porã.	NOCHANGE
Ha’ekuéra ojerokymo’ã omondoromo’ã	Ha’ekuéra ojerokymo’ã omondoromo’ã	NOCHANGE
Ko che ñembo’emi	Ko che ñembo’emi	NOCHANGE
Ha mitãnguéra oñe’ẽ.	Ha mitãnguéra oñe’ẽ.	NOCHANGE
Tetã peteĩ reko amérikagua tetãvorekuéra	Tetã peteĩ reko amérikagua tetãvorekuéra	NOCHANGE
Nde rehe kuña	Nde rehe kuña	NOCHANGE
Mba’éichapa, che réra tyra.	Mba’éichapa, che réra tyra.	NOCHANGE
Ñemenda kuña rehayhúvare ha ha’e nderayhúva, ha’e ñeha’ã hendive jahecha mávapa ohayhu poi raẽve	Ñemenda kuña rehayhúvare ha ha’e nderayhúva, ha’e ñeha’ã hendive jahecha mávapa ohayhu poi raẽve	NOCHANGE
Oikove jey ñande ava ñe’ẽ hapeguy kañýva	Oikove jey ñande ava ñe’ẽ hapeguy kañýva	NOCHANGE
Che jurúgui osẽ ñe’ẽ iporãva poravopyre	Che jurúgui osẽ ñe’ẽ iporãva poravopyre	NOCHANGE
Ñande kuéra paraguay hese ñanemandu’a	Ñande kuéra paraguay hese ñanemandu’a	NOCHANGE
Mbo’ehára ikatupyryveva’ekue ii	Mbo’ehára ikatupyryveva’ekue ii	NOCHANGE
Ku pyhareve ombojeguapáva tape rembe’y.	Ku pyhareve ombojeguapáva tape rembe’y.	NOCHANGE
Temimbo’ekuéra mitã ha mitãrusúva,	Temimbo’ekuéra mitã ha mitãrusúva,	NOCHANGE
Avei oĩ mokõihápe takuare’ẽ ñeñotỹ ha irundyhápe avati ñeñotỹme.	Avei oĩ mokõihápe takuare’ẽ ñeñotỹ ha irundyhápe avati ñeñotỹme.	NOCHANGE
Akóinte mbyja ko’ë	Akóinte mbyja ko’ë	NOCHANGE
Oĩ cantera oñeguenohẽhágui itara’ỹi ha tovatĩ.	Oĩ cantera oñeguenohẽhágui itara’ỹi ha tovatĩ.	NOCHANGE
Neko’êjeýre ko árape, e’aguyjeme’ê	Neko’êjeýre ko árape, e’aguyjeme’ê	NOCHANGE
Ikatupyrýva pumbasýpe. ha umíva upéi oñe’ẽ porã ichugui.	Ikatupyrýva pumbasýpe. ha umíva upéi oñe’ẽ porã ichugui.	NOCHANGE
- ambyasy nendive che ryvy. ani rejepy’apy. nde po’a cheguerekógui chéve nde	- ambyasy nendive che ryvy. ani rejepy’apy. nde po’a cheguerekógui chéve nde	NOCHANGE
Terã umi poguasu nde javeve.	Terã umi poguasu nde javeve.	NOCHANGE
Mba’e porãvyma	Mba’e porãvyma	NOCHANGE
Umi guyrakuéra	Umi guyrakuéra	NOCHANGE
Mitãnguérape oñembo’e mbo’ehaópe mba’éichapa oñangarekova’erã hetére.	Mitãnguérape oñembo’e mbo’ehaópe mba’éichapa oñangarekova’erã hetére.	NOCHANGE
Oipuru oñembokapúva’ekue pirekue.	Oipuru oñembokapúva’ekue pirekue.	NOCHANGE
Tetã paraguay ryepýpe, ha’eténte ojeráva mandu’a mangore rembiapokuére. aveíko ojehecharamojey pe héra ha umi ipumbasy.	Tetã paraguay ryepýpe, ha’eténte ojeráva mandu’a mangore rembiapokuére. aveíko ojehecharamojey pe héra ha umi ipumbasy.	NOCHANGE
Ha ipohýiva ñembyepoti cherupytýva ka’irãime,	Ha ipohýiva ñembyepoti cherupytýva ka’irãime,	NOCHANGE
Iguýpe oñembopiro’ymi.	Iguýpe oñembopiro’ymi.	NOCHANGE
Mombyry ñane retã,	Mombyry ñane retã,	NOCHANGE
Ha opavéva ñe’ãme	Ha opavéva ñe’ãme	NOCHANGE
Che ñe’ẽmi kuatiápe	Che ñe’ẽmi kuatiápe	NOCHANGE
Ojapo imba’erã	Ojapo imba’erã	NOCHANGE
Ñamandu kuaray’ã rupare repytu’u porã’ĩ.	Ñamandu kuaray’ã rupare repytu’u porã’ĩ.	NOCHANGE
Osẽ haguã tetãygua oikóva vida democrática ha convivencia humana-pe. upe tekombo’e	Osẽ haguã tetãygua oikóva vida democrática ha convivencia humana-pe. upe tekombo’e	NOCHANGE
Tavýgui ñane retãme, umi mbaraka mbopuhárape ojehypýi jejahéipe umi ñe’ẽrei apytépe.	Tavýgui ñane retãme, umi mbaraka mbopuhárape ojehypýi jejahéipe umi ñe’ẽrei apytépe.	NOCHANGE
Aguara ohasáramo taperã rupi, pe máva oñedesatina, oikuaa porãramo jepe tape.	Aguara ohasáramo taperã rupi, pe máva oñedesatina, oikuaa porãramo jepe tape.	NOCHANGE
Ndivéi, ha upérõ umi táva osancionáne terã omyatyrõne icárta orgánica kuéra, sapy’a oikotevẽrõ,	Ndivéi, ha upérõ umi táva osancionáne terã omyatyrõne icárta orgánica kuéra, sapy’a oikotevẽrõ,	NOCHANGE
Tetãnguéra rysýi tuichakuére	Tetãnguéra rysýi tuichakuére	NOCHANGE
Ha ama totyky mbeguemi nde yvy ári.	Ha ama totyky mbeguemi nde yvy ári.	NOCHANGE
- amendase, che niko yma guive hapykuéri aikóva. mba’e piko	- amendase, che niko yma guive hapykuéri aikóva. mba’e piko	NOCHANGE
Haguâ, ñemby ñemuha ryepýpe.	Haguâ, ñemby ñemuha ryepýpe.	NOCHANGE
He’iséva. ñembovy’a ha jeguerohory mávape.	He’iséva. ñembovy’a ha jeguerohory mávape.	NOCHANGE
Tokaru (ha’ekuéra) tome’ẽ (ha’ekuéra)	Tokaru (ha’ekuéra) tome’ẽ (ha’ekuéra)	NOCHANGE
Peteĩ kuña rete.	Peteĩ kuña rete.	NOCHANGE
Ojuavyha ojuehegui, ikatu haguã ha’ekuéra oike syryrýpe opaite	Ojuavyha ojuehegui, ikatu haguã ha’ekuéra oike syryrýpe opaite	NOCHANGE
Ñane ñe’ẽtépe ñañemongeta	Ñane ñe’ẽtépe ñañemongeta	NOCHANGE
Oñemo’âhápe.	Oñemo’âhápe.	NOCHANGE
Ko ñe’ẽ he’ẽtevéva	Ko ñe’ẽ he’ẽtevéva	NOCHANGE
Táva paraguay hi’aramboty	Táva paraguay hi’aramboty	NOCHANGE
. ikatu porãnte ko’ẽramo ára	. ikatu porãnte ko’ẽramo ára	NOCHANGE
Ko yvy tuichakuére	Ko yvy tuichakuére	NOCHANGE
Henda pegua.	Henda pegua.	NOCHANGE
Upe nerenoiva’ekuépe.	Upe nerenoiva’ekuépe.	NOCHANGE
Kóva aikuaa porã.	Kóva aikuaa porã.	NOCHANGE
Ñaipytyvókena ñande retepe ñambopyahujey	Ñaipytyvókena ñande retepe ñambopyahujey	NOCHANGE
Che maína che moñe’ẽ heta aháramo hendápe.	Che maína che moñe’ẽ heta aháramo hendápe.	NOCHANGE
Kuimba’e retia’e hekópe, ohohápente ogueraha imbaraka, ha hymba kavaju ári oikómiva’erã oipyguara ñane retãpy tembiapo rekávo.	Kuimba’e retia’e hekópe, ohohápente ogueraha imbaraka, ha hymba kavaju ári oikómiva’erã oipyguara ñane retãpy tembiapo rekávo.	NOCHANGE
Ombojeguáre mba’ekuaápe mitãnguéra opu’ã pyahúva	Ombojeguáre mba’ekuaápe mitãnguéra opu’ã pyahúva	NOCHANGE
Jahypýi ñane ñe’ẽ,	Jahypýi ñane ñe’ẽ,	NOCHANGE
Ha’ekuéra ojepytasohague	Ha’ekuéra ojepytasohague	NOCHANGE
Reñemohesakãramo peteĩ techapyrãreve, naikũmbyi mba’eve	Reñemohesakãramo peteĩ techapyrãreve, naikũmbyi mba’eve	NOCHANGE
He’i avei hese ha’e hague peteĩ karai nda’ijespíritu ky’áiva a kuimba’e hendápeguaha upé árarupi.	He’i avei hese ha’e hague peteĩ karai nda’ijespíritu ky’áiva a kuimba’e hendápeguaha upé árarupi.	NOCHANGE
Oaproba terã odesecha umi ñe’ẽ me’ẽ tetã ambue, ha umi ojejapo va’ekue ambue tetãmini	Oaproba terã odesecha umi ñe’ẽ me’ẽ tetã ambue, ha umi ojejapo va’ekue ambue tetãmini	NOCHANGE
Ani pya’eterei ñande tuja ha ñande cha’i	Ani pya’eterei ñande tuja ha ñande cha’i	NOCHANGE
Tetã nguéra ojapo háicha.	Tetã nguéra ojapo háicha.	NOCHANGE
Ko tembiapópe oñemboguepy apañuãiramo mba’éichapa angapyhy	Ko tembiapópe oñemboguepy apañuãiramo mba’éichapa angapyhy	NOCHANGE
Ore nde ra’yetaite	Ore nde ra’yetaite	NOCHANGE
Ko tembiapo rupive che ahechauka, ikatuha jajapo heta mba’e ñane retãyguakuéra marangatu rekove rehe opavave.	Ko tembiapo rupive che ahechauka, ikatuha jajapo heta mba’e ñane retãyguakuéra marangatu rekove rehe opavave.	NOCHANGE
Peteĩ ára ndaje vichokuéra oñomboaty hikuái ka’aguýpe. ha’e oñomongetase ha ombosako’i haguã peteĩ ñani guasu.	Peteĩ ára ndaje vichokuéra oñomboaty hikuái ka’aguýpe. ha’e oñomongetase ha ombosako’i haguã peteĩ ñani guasu.	NOCHANGE
Ojapómi aty guasu ijatyhápe ñe’êporâhaihára ha puraheihára. péicha ha’e oñakârapu’â	Ojapómi aty guasu ijatyhápe ñe’êporâhaihára ha puraheihára. péicha ha’e oñakârapu’â	NOCHANGE
Ñe’ême yvate yvateve ko yvy ape ári.	Ñe’ême yvate yvateve ko yvy ape ári.	NOCHANGE
Umi tekove oñemoarandu guaraníme oñe’ẽ ha ohaíma	Umi tekove oñemoarandu guaraníme oñe’ẽ ha ohaíma	NOCHANGE
-haĩ, peteĩ tahýi’i oguata’i hína nde ati’ýre.	-haĩ, peteĩ tahýi’i oguata’i hína nde ati’ýre.	NOCHANGE
Yvyrupi ogueropy’a guasu va’erã.	Yvyrupi ogueropy’a guasu va’erã.	NOCHANGE
Kuña porã resa para.	Kuña porã resa para.	NOCHANGE
Pyharevove mitãnguéra osẽ	Pyharevove mitãnguéra osẽ	NOCHANGE
Ka’i oñemomanoite ta’anga araity ári.	Ka’i oñemomanoite ta’anga araity ári.	NOCHANGE
Ha’ete ka’a porã herakuãva mombyry.	Ha’ete ka’a porã herakuãva mombyry.	NOCHANGE
Péicha aipotamo ko’ẽrõ ára umi pytũhare	Péicha aipotamo ko’ẽrõ ára umi pytũhare	NOCHANGE
Kóva hina tau ha kerana memby poteĩha. oje’e ao ao oikoha	Kóva hina tau ha kerana memby poteĩha. oje’e ao ao oikoha	NOCHANGE
Paraguái niko ojekuaa ko arapy tuichakue	Paraguái niko ojekuaa ko arapy tuichakue	NOCHANGE
Pohã ñana paraguaýpe ojeporuvéva mba’e guarãpa iporã	Pohã ñana paraguaýpe ojeporuvéva mba’e guarãpa iporã	NOCHANGE
Hi’ãnte (chéve) oguahẽ ko’ãga.	Hi’ãnte (chéve) oguahẽ ko’ãga.	NOCHANGE
Chéve ome’ẽ tasẽse.	Chéve ome’ẽ tasẽse.	NOCHANGE
Ha maitei rorýpe ombohetia’éva ñande rekove.	Ha maitei rorýpe ombohetia’éva ñande rekove.	NOCHANGE
Oĩ mba’e renda guasu	Oĩ mba’e renda guasu	NOCHANGE
Ko yvy ape ári,	Ko yvy ape ári,	NOCHANGE
Umi yvyramáta rapo tuichaicha ha oikepa ojokuápe, upéicha rupi umi yvyramáta ikatu oaguanta umi yvytu atã oúva.	Umi yvyramáta rapo tuichaicha ha oikepa ojokuápe, upéicha rupi umi yvyramáta ikatu oaguanta umi yvytu atã oúva.	NOCHANGE
Ñe’ẽriregua jaipurukuaa opaichagua ñe’ẽ ndive ha omohesakã mba’éicha, araka’e, mamo, mba’ére ojehu ñe’ẽ ijykeregua omoandúva.	Ñe’ẽriregua jaipurukuaa opaichagua ñe’ẽ ndive ha omohesakã mba’éicha, araka’e, mamo, mba’ére ojehu ñe’ẽ ijykeregua omoandúva.	NOCHANGE
Ama omohe’õ porã yvy.	Ama omohe’õ porã yvy.	NOCHANGE
Ha ojeréva’erã ndaipóri	Ha ojeréva’erã ndaipóri	NOCHANGE
Heta ára ohasa rire pe tupãsy ra’anga michĩvéva oguereko’ákue hógape hose,	Heta ára ohasa rire pe tupãsy ra’anga michĩvéva oguereko’ákue hógape hose,	NOCHANGE
Joyke’y paraguái iporãma	Joyke’y paraguái iporãma	NOCHANGE
Jarohory ñanemba’éva,	Jarohory ñanemba’éva,	NOCHANGE
