Amondóva ko che ñe’ẽ yvytu pepóre,	Amondóva ko che ñe’ẽ yvytu pepóre,	NOCHANGE
Ñembosaraipavẽ arahakúpe	Ñembosaraipavẽ arahakúpe	NOCHANGE
Tetãnguéra rysýi ava hetakuére	Tetãnguéra rysýi ava hetakuére	NOCHANGE
Hasýva ho’úrõ upe ka’aýpe	Hasýva ho’úrõ upe ka’aýpe	NOCHANGE
Mba’eve omboguevi ichupe.	Mba’eve omboguevi ichupe.	NOCHANGE
Ñu, ka’aguýre,	Ñu, ka’aguýre,	NOCHANGE
Ku ñuatindy rupi, ñu ka’aguýre ñemuñahápe	Ku ñuatindy rupi, ñu ka’aguýre ñemuñahápe	NOCHANGE
Ha’ekuéra okay’u’arã omohenda’arã	Ha’ekuéra okay’u’arã omohenda’arã	NOCHANGE
Ñe’ẽnguéra rehegua derécho oñemoañetévo.	Ñe’ẽnguéra rehegua derécho oñemoañetévo.	NOCHANGE
He’iséva ñañaguasu hakã kangu ojúpiva ambue yvyra rehe ha hi’a hi’upy.	He’iséva ñañaguasu hakã kangu ojúpiva ambue yvyra rehe ha hi’a hi’upy.	NOCHANGE
Arapoteĩ marangatu	Arapoteĩ marangatu	NOCHANGE
Purahéi opa’ã	Purahéi opa’ã	NOCHANGE
Paraguái - tetã paraguái	Paraguái - tetã paraguái	NOCHANGE
Ombotarova térã ojuka peve.	Ombotarova térã ojuka peve.	NOCHANGE
Nati ohenói isýpe ohechaga’úgui chupe	Nati ohenói isýpe ohechaga’úgui chupe	NOCHANGE
Tetã paraguái (gn)	Tetã paraguái (gn)	NOCHANGE
Ka’avokuéra iporâitemi tetépe, omombia mba’asy vai ha omoporâ tuguy, upéicha avei oreko vitamína ha itanarâ opáichagua.	Ka’avokuéra iporâitemi tetépe, omombia mba’asy vai ha omoporâ tuguy, upéicha avei oreko vitamína ha itanarâ opáichagua.	NOCHANGE
Ndaha’éiva avakatu. ha’ekuéra mba’apoharamínte.	Ndaha’éiva avakatu. ha’ekuéra mba’apoharamínte.	NOCHANGE
Upe karaimi ñe’ẽ ndo’aporãi tekoñarõme ha kóva he’i’ỹre mba’evete, ojuka upe karaimi ha hembirekópe.	Upe karaimi ñe’ẽ ndo’aporãi tekoñarõme ha kóva he’i’ỹre mba’evete, ojuka upe karaimi ha hembirekópe.	NOCHANGE
Mboriahukuéra oho guarinihápe oñorairõ ha omano tembipota reikuéra, terekopyheta ha mba’ekuéra tekoteve’ỹetereíva ambuekuéra mba’ere	Mboriahukuéra oho guarinihápe oñorairõ ha omano tembipota reikuéra, terekopyheta ha mba’ekuéra tekoteve’ỹetereíva ambuekuéra mba’ere	NOCHANGE
Ambue távape aime che renyhe mba’e mbyasýgui,	Ambue távape aime che renyhe mba’e mbyasýgui,	NOCHANGE
Ñañemoi peteĩ ñe’ẽme	Ñañemoi peteĩ ñe’ẽme	NOCHANGE
Mborayhu ha’e ojehúva peteĩ kuimba’e ha peteĩ kuña ndojokuaaívape	Mborayhu ha’e ojehúva peteĩ kuimba’e ha peteĩ kuña ndojokuaaívape	NOCHANGE
Heta he’íva ko’ápe ha tetã ambuére, guarania ndaikatuiha ojapo peteĩ ñane retãygua.	Heta he’íva ko’ápe ha tetã ambuére, guarania ndaikatuiha ojapo peteĩ ñane retãygua.	NOCHANGE
Ñane retãpýre omyanyhẽ umi mbo’ehao iporãrasáva	Ñane retãpýre omyanyhẽ umi mbo’ehao iporãrasáva	NOCHANGE
Hi’ãra hína ko’agã, ko árape omboty	Hi’ãra hína ko’agã, ko árape omboty	NOCHANGE
Ñande ka’aguyre jareko va’ekue, yva’a porã ñandevy guãrã,	Ñande ka’aguyre jareko va’ekue, yva’a porã ñandevy guãrã,	NOCHANGE
Amoite ahecha kuimba’ekuéra, che rapicha	Amoite ahecha kuimba’ekuéra, che rapicha	NOCHANGE
Ñane ñe’ã rupipávo herekua ára pytu	Ñane ñe’ã rupipávo herekua ára pytu	NOCHANGE
Paraguái niko ojekuaa ko arapy tuichakue	Paraguái niko ojekuaa ko arapy tuichakue	NOCHANGE
Jevy ñande ryekue, ñanderye ha ñanderyeryguy rire.	Jevy ñande ryekue, ñanderye ha ñanderyeryguy rire.	NOCHANGE
Hi’ánte chéve apay	Hi’ánte chéve apay	NOCHANGE
Umi pohâ ñana ñamone’ê va’ekue ko kuatiápe, oñemohenda según mba’e mba’asýpepa ouporâ,	Umi pohâ ñana ñamone’ê va’ekue ko kuatiápe, oñemohenda según mba’e mba’asýpepa ouporâ,	NOCHANGE
Ojereraha tupão ka’akupépe.	Ojereraha tupão ka’akupépe.	NOCHANGE
Ndaha’éi ñe’ẽ káusante oñemboykéva	Ndaha’éi ñe’ẽ káusante oñemboykéva	NOCHANGE
Peteĩ tetã guasu,	Peteĩ tetã guasu,	NOCHANGE
Upéva hína peteĩ goviérno pyahu ojapótava hustísia ko yvy ape ári.	Upéva hína peteĩ goviérno pyahu ojapótava hustísia ko yvy ape ári.	NOCHANGE
Hi’ãnte oguãhẽvo ko’ẽju pytã	Hi’ãnte oguãhẽvo ko’ẽju pytã	NOCHANGE
He’iséva mba’e apu’a oñembovúva yvytúpe ha oñembohyrúva vakapípe ojeporúva ñembosarái atýpe.	He’iséva mba’e apu’a oñembovúva yvytúpe ha oñembohyrúva vakapípe ojeporúva ñembosarái atýpe.	NOCHANGE
Ojapo ha omboguapy héra ñe’ẽ me’ẽ jehaipyrére tetã ambue ndivéi, ha ñe’ẽ me’ẽ jehaipyre	Ojapo ha omboguapy héra ñe’ẽ me’ẽ jehaipyrére tetã ambue ndivéi, ha ñe’ẽ me’ẽ jehaipyre	NOCHANGE
Ha’e oĩkuri avei umi omoheñoiva’ekue autores paraguayos	Ha’e oĩkuri avei umi omoheñoiva’ekue autores paraguayos	NOCHANGE
Oñemongetaháguihina hesaho hikuái peteĩ karréta nandíre, ohasáva ohóvo, ha jeko	Oñemongetaháguihina hesaho hikuái peteĩ karréta nandíre, ohasáva ohóvo, ha jeko	NOCHANGE
Ha ombopotyva tetã.	Ha ombopotyva tetã.	NOCHANGE
Omopörã potavévo ñane retã paraguay.	Omopörã potavévo ñane retã paraguay.	NOCHANGE
Ateneo rejuhúta mayma táva’i ha tavaguasúpe oñeha’ã	Ateneo rejuhúta mayma táva’i ha tavaguasúpe oñeha’ã	NOCHANGE
A moingatu purahéi.	A moingatu purahéi.	NOCHANGE
Tero ñe’ẽtéva tero ñe’ẽriregua	Tero ñe’ẽtéva tero ñe’ẽriregua	NOCHANGE
Ko’ãichagua ojereko va’erã mba’evetérõ.	Ko’ãichagua ojereko va’erã mba’evetérõ.	NOCHANGE
Ha ha’ẽ oipotánte, jaiporujoaite ñane ava ñe’ẽ.	Ha ha’ẽ oipotánte, jaiporujoaite ñane ava ñe’ẽ.	NOCHANGE
Ha jaiko porã jey.	Ha jaiko porã jey.	NOCHANGE
Ñande rekoha,	Ñande rekoha,	NOCHANGE
A’aguyjeveme’ẽ ñanderuvusukuérape taha’eha’éva	A’aguyjeveme’ẽ ñanderuvusukuérape taha’eha’éva	NOCHANGE
Mba’egui piko ndohayhu mo’ãi jepe ñande’ỹva	Mba’egui piko ndohayhu mo’ãi jepe ñande’ỹva	NOCHANGE
Ñembosako’i rembipuru	Ñembosako’i rembipuru	NOCHANGE
Ha’e oñemoívaerã osapukai añetegua maymava rovake. avave ndogueroviamo’ai ichupe ha oimo’ãta itavymaha	Ha’e oñemoívaerã osapukai añetegua maymava rovake. avave ndogueroviamo’ai ichupe ha oimo’ãta itavymaha	NOCHANGE
Tetã tetãvore joapykuéra	Tetã tetãvore joapykuéra	NOCHANGE
Ha’ekuéra ojapohina sushi.	Ha’ekuéra ojapohina sushi.	NOCHANGE
Peteĩ tapỹi ndaiporivéima...	Peteĩ tapỹi ndaiporivéima...	NOCHANGE
Umi terarãnguete teroñe’ẽramo oĩva, terarãnguete mba’eva ha terarãnguete kuaa’ỹva, ombojoapy sapy’apy’a ñe’ẽpehẽtai kokatuguigua.	Umi terarãnguete teroñe’ẽramo oĩva, terarãnguete mba’eva ha terarãnguete kuaa’ỹva, ombojoapy sapy’apy’a ñe’ẽpehẽtai kokatuguigua.	NOCHANGE
Okakuaa porãramo avatity, oñemono’õ heta avati ra’ỹi	Okakuaa porãramo avatity, oñemono’õ heta avati ra’ỹi	NOCHANGE
Oikuaa pyahúva, ha mba’e.	Oikuaa pyahúva, ha mba’e.	NOCHANGE
Rehegua. mombyry chuguikuéra upe tekojoja. ha’ekuéra ndaha’eivoi tekove.	Rehegua. mombyry chuguikuéra upe tekojoja. ha’ekuéra ndaha’eivoi tekove.	NOCHANGE
Porã apo, ojapohápe tape okakuaa haguã, oñemomba’e haguã,	Porã apo, ojapohápe tape okakuaa haguã, oñemomba’e haguã,	NOCHANGE
Te’ýi guarani yvytyrokái upépe omimbi.	Te’ýi guarani yvytyrokái upépe omimbi.	NOCHANGE
Yvypóra rape.	Yvypóra rape.	NOCHANGE
Upe kuatia he’í va’erã mba’e ha mba’éichapa ojejapo va’erã, ndoikóirõ upéicha katu umi	Upe kuatia he’í va’erã mba’e ha mba’éichapa ojejapo va’erã, ndoikóirõ upéicha katu umi	NOCHANGE
Tembiapo ndaipóri, ndapóri ñe’e	Tembiapo ndaipóri, ndapóri ñe’e	NOCHANGE
(uicn tembiapohára paraguaigua omba’apo ñane retãme)	(uicn tembiapohára paraguaigua omba’apo ñane retãme)	NOCHANGE
Mba’égui piko namanói mba’e.	Mba’égui piko namanói mba’e.	NOCHANGE
Tavýgui ñane retãme, umi mbaraka mbopuhárape ojehypýi jejahéipe umi ñe’ẽrei apytépe.	Tavýgui ñane retãme, umi mbaraka mbopuhárape ojehypýi jejahéipe umi ñe’ẽrei apytépe.	NOCHANGE
Jeroky ñanemba’éva	Jeroky ñanemba’éva	NOCHANGE
Pe tendápe omohenda hikuái peteĩ kurusu ha oñemombeu upe araite guive oipytyvõha opavave umi ojeroviávape hese.	Pe tendápe omohenda hikuái peteĩ kurusu ha oñemombeu upe araite guive oipytyvõha opavave umi ojeroviávape hese.	NOCHANGE
Ko’águive, opa mba’e ha’etehápe	Ko’águive, opa mba’e ha’etehápe	NOCHANGE
Che apytépe oĩ añete	Che apytépe oĩ añete	NOCHANGE
Ahendu javérõ ñande purahéi.	Ahendu javérõ ñande purahéi.	NOCHANGE
Ojapo vaekue ko yvy,	Ojapo vaekue ko yvy,	NOCHANGE
Opaite tetã ñembyatypyre	Opaite tetã ñembyatypyre	NOCHANGE
Mitãkuimba’e oĩva peteĩ tetã iñe’ẽkõiva	Mitãkuimba’e oĩva peteĩ tetã iñe’ẽkõiva	NOCHANGE
Kóva ohechauka ñe’ẽtéva moandu oñembotuicha ha oñemomirĩvérõ.	Kóva ohechauka ñe’ẽtéva moandu oñembotuicha ha oñemomirĩvérõ.	NOCHANGE
Ha apurahéi.	Ha apurahéi.	NOCHANGE
Ñahendu añete mba’e parara	Ñahendu añete mba’e parara	NOCHANGE
Hesu hete joja asy, ipire morotĩ, iñakãrague apopẽ hũ ha ityvyta po’i. pe hesa mimi, opukavýramo oñemboyvotývaicha hopea hũ puku ipytépe.	Hesu hete joja asy, ipire morotĩ, iñakãrague apopẽ hũ ha ityvyta po’i. pe hesa mimi, opukavýramo oñemboyvotývaicha hopea hũ puku ipytépe.	NOCHANGE
Pyharevove mitãnguéra osẽ	Pyharevove mitãnguéra osẽ	NOCHANGE
Estuvieron ñe’ê renda y ñande pãi tavyterã ñande para-	Estuvieron ñe’ê renda y ñande pãi tavyterã ñande para-	NOCHANGE
Che ñe’ã reñopũ,	Che ñe’ã reñopũ,	NOCHANGE
Ndoikuaái mba’épa ojapóta.	Ndoikuaái mba’épa ojapóta.	NOCHANGE
Ani ñembota oimera’ẽva mba’yrumýi	Ani ñembota oimera’ẽva mba’yrumýi	NOCHANGE
Umi neñe’ẽ ojoapypyre remoporãvéva’erã.	Umi neñe’ẽ ojoapypyre remoporãvéva’erã.	NOCHANGE
Hese ko’ê porã mboyve. oipy’apy asy chupe.	Hese ko’ê porã mboyve. oipy’apy asy chupe.	NOCHANGE
Oporomomembýva, oñembohérava partéra chae, oipytyvõva kuña hyeguasúvape imemby	Oporomomembýva, oñembohérava partéra chae, oipytyvõva kuña hyeguasúvape imemby	NOCHANGE
Ani py’aro ha ñe’ẽmeguãme ñaikusãjopi,	Ani py’aro ha ñe’ẽmeguãme ñaikusãjopi,	NOCHANGE
Oikuaa porãvéva ka’avo ha ñanamimi oĩva ijerére. umíva ha’ehína hembipuru. umi	Oikuaa porãvéva ka’avo ha ñanamimi oĩva ijerére. umíva ha’ehína hembipuru. umi	NOCHANGE
Opyta mba’e ojehuva’ekue rapykuere.	Opyta mba’e ojehuva’ekue rapykuere.	NOCHANGE
Che sýpente ndaipotái remombe’u pa’i.	Che sýpente ndaipotái remombe’u pa’i.	NOCHANGE
Pehechápa umi guyrati’etã pe karugua jahasa ramo’ápe.	Pehechápa umi guyrati’etã pe karugua jahasa ramo’ápe.	NOCHANGE
Táva méhiko	Táva méhiko	NOCHANGE
Ñande rekove jepe ñame’êta	Ñande rekove jepe ñame’êta	NOCHANGE
Omongakuaákuri chupekuéra ha heta jehasa asy rire onohê chupekuéra tenonde	Omongakuaákuri chupekuéra ha heta jehasa asy rire onohê chupekuéra tenonde	NOCHANGE
. ku guyra porã pytã’i	. ku guyra porã pytã’i	NOCHANGE
Oñemboyekuaete reve kuae ñemongeta jaeko, naciones	Oñemboyekuaete reve kuae ñemongeta jaeko, naciones	NOCHANGE
Ijave avei taropurahéi ko ñane retã.	Ijave avei taropurahéi ko ñane retã.	NOCHANGE
Rehechámapa che irũ, heteha ko’ã mba’e.	Rehechámapa che irũ, heteha ko’ã mba’e.	NOCHANGE
Ha mbaretépe, ñamotenondevévo ichupe ko arapýpe.	Ha mbaretépe, ñamotenondevévo ichupe ko arapýpe.	NOCHANGE
Ohokuévo jaguakuéra oñarõmba hese	Ohokuévo jaguakuéra oñarõmba hese	NOCHANGE
A yvy yvycói.	A yvy yvycói.	NOCHANGE
Ndivéi, ambue tetãmini ha umi táva, ojererekóne tenondérupi umi aguĩgua.	Ndivéi, ambue tetãmini ha umi táva, ojererekóne tenondérupi umi aguĩgua.	NOCHANGE
Arapoty purahéi.	Arapoty purahéi.	NOCHANGE
Tetã paraguái (guaranii)	Tetã paraguái (guaranii)	NOCHANGE
Ha upévare amoñe’ẽ	Ha upévare amoñe’ẽ	NOCHANGE
. pejuhúva’erãnte ha’eño oñe’ẽ	. pejuhúva’erãnte ha’eño oñe’ẽ	NOCHANGE
Oĩjekoraka’e peteĩ ñu ndekakuaajepéva, ha upépe oĩmbaite mymbakuéra opaichagua. ha upégui oñepyru’ypyraka’e oveve umi mymba ovevesévaguie.	Oĩjekoraka’e peteĩ ñu ndekakuaajepéva, ha upépe oĩmbaite mymbakuéra opaichagua. ha upégui oñepyru’ypyraka’e oveve umi mymba ovevesévaguie.	NOCHANGE
Ñe’ẽporãguerojera ha’e para ñemoinge kaguápe apokuaapy	Ñe’ẽporãguerojera ha’e para ñemoinge kaguápe apokuaapy	NOCHANGE
Mba’e a’ã ñeychyrõgui omboja’o i anguã.	Mba’e a’ã ñeychyrõgui omboja’o i anguã.	NOCHANGE
Ani nde resarái che ñe’ẽgui.	Ani nde resarái che ñe’ẽgui.	NOCHANGE
Nde ha’éva tekove ipy’aporã ha hekopotĩva	Nde ha’éva tekove ipy’aporã ha hekopotĩva	NOCHANGE
Che ãngañe’ẽ, che korasõ ñe’ẽ, cherekoveñe’ẽ	Che ãngañe’ẽ, che korasõ ñe’ẽ, cherekoveñe’ẽ	NOCHANGE
Mitârusukuéra ombohayvi mbokaja apere’a rapykuéri.	Mitârusukuéra ombohayvi mbokaja apere’a rapykuéri.	NOCHANGE
Ka’aguy hesakãhápe kapi’ipe rovyũ ha hyakuãvureíva ári orairõ	Ka’aguy hesakãhápe kapi’ipe rovyũ ha hyakuãvureíva ári orairõ	NOCHANGE
Kyhyje ha tembiguái.	Kyhyje ha tembiguái.	NOCHANGE
Peteĩ ñe’ẽmete.	Peteĩ ñe’ẽmete.	NOCHANGE
Kuatia pe ijyva guýpe, sapukáipe oikuãve’ẽrõ.	Kuatia pe ijyva guýpe, sapukáipe oikuãve’ẽrõ.	NOCHANGE
Tekove ha’e ojehúva ndéve nerembiapo’aja ambue apopyrãpe	Tekove ha’e ojehúva ndéve nerembiapo’aja ambue apopyrãpe	NOCHANGE
Ohasávo peteĩ ro’y oñemomarandu	Ohasávo peteĩ ro’y oñemomarandu	NOCHANGE
Katuete peteĩ ára	Katuete peteĩ ára	NOCHANGE
Che mandu’ápe reiméta hína nde,	Che mandu’ápe reiméta hína nde,	NOCHANGE
Ñe’ẽ jepuru, he’isevahína oguatakarẽha	Ñe’ẽ jepuru, he’isevahína oguatakarẽha	NOCHANGE
Hi’ánte nde juru aipyte	Hi’ánte nde juru aipyte	NOCHANGE
Upéva niko ñane angirû.	Upéva niko ñane angirû.	NOCHANGE
Ha mba’e mbyasýpe péicha desdichado amanova’erâ.	Ha mba’e mbyasýpe péicha desdichado amanova’erâ.	NOCHANGE
Pe távape oñemba’apove kokue ha mymba ñemongakuaápe.	Pe távape oñemba’apove kokue ha mymba ñemongakuaápe.	NOCHANGE
Tapére oñemboyke oguata vevúi ñembotavy ha oñeha’ã,	Tapére oñemboyke oguata vevúi ñembotavy ha oñeha’ã,	NOCHANGE
Pytu’u’yme oguahê hógape ha ogueru rire ae ipytu omombe’u	Pytu’u’yme oguahê hógape ha ogueru rire ae ipytu omombe’u	NOCHANGE
Kuña rembiapo, oñangareko mitâre, ojapo ajaka ha ombyaty yva ha kogaty	Kuña rembiapo, oñangareko mitâre, ojapo ajaka ha ombyaty yva ha kogaty	NOCHANGE
Ha oñepyrũ oguata joa, oveve, osapukái	Ha oñepyrũ oguata joa, oveve, osapukái	NOCHANGE
Haguã ñemombe’u pyahu, ha omombarete pe tekopykuaa rehegua ñe’ê	Haguã ñemombe’u pyahu, ha omombarete pe tekopykuaa rehegua ñe’ê	NOCHANGE
Nde angaipa, nde angekói.	Nde angaipa, nde angekói.	NOCHANGE
Sy ha’e ñe’ã mano ogapypeguáva, oiporúva tua mba’apo repy omoporãve haguã ha’e okuraha, okeha ha ohechahápe ta’angambyry	Sy ha’e ñe’ã mano ogapypeguáva, oiporúva tua mba’apo repy omoporãve haguã ha’e okuraha, okeha ha ohechahápe ta’angambyry	NOCHANGE
He’iséva akâjere ñembotakuére térâ ambue mba’ére.	He’iséva akâjere ñembotakuére térâ ambue mba’ére.	NOCHANGE
Oñembojoja pe jehechakuaa ha jehepyme’ê umi mba’e porã apoharépe,	Oñembojoja pe jehechakuaa ha jehepyme’ê umi mba’e porã apoharépe,	NOCHANGE
Casaccia oiko va’ekue areguápe. heta mba’e oikuaakuri upe hesapyso ha ohendumombyry rupi. ou ha oho paraguaýre upe mba’yrupukuapesãme.	Casaccia oiko va’ekue areguápe. heta mba’e oikuaakuri upe hesapyso ha ohendumombyry rupi. ou ha oho paraguaýre upe mba’yrupukuapesãme.	NOCHANGE
Kóva ko ñe’ẽpoty	Kóva ko ñe’ẽpoty	NOCHANGE
Tape guasu kumasi távape.	Tape guasu kumasi távape.	NOCHANGE
Ha upéicha ñandejára	Ha upéicha ñandejára	NOCHANGE
Amandajerape ombohovái mburuvicharape rekóre.	Amandajerape ombohovái mburuvicharape rekóre.	NOCHANGE
Ho’a, opu’â ha ojeity nde ári	Ho’a, opu’â ha ojeity nde ári	NOCHANGE
Oñeñomongetáta ypykuéra ñe’ẽ ha tetã remimoĩmby rembiapo rehe	Oñeñomongetáta ypykuéra ñe’ẽ ha tetã remimoĩmby rembiapo rehe	NOCHANGE
. purahéi he’ẽ jeroky rari, ha ñe’ẽ porã.	. purahéi he’ẽ jeroky rari, ha ñe’ẽ porã.	NOCHANGE
Ñembo’yhápe, guatahápe, guapyhápe térâ ñenoháme, páy aja,	Ñembo’yhápe, guatahápe, guapyhápe térâ ñenoháme, páy aja,	NOCHANGE
Ñande jepokuaa ha ñane ñe’ênga	Ñande jepokuaa ha ñane ñe’ênga	NOCHANGE
Ñane retã héra paraguái.	Ñane retã héra paraguái.	NOCHANGE
Ñembykuarahyresẽ asia	Ñembykuarahyresẽ asia	NOCHANGE
Che ropea guýpe romongéva’erã, ka’arupytũvo,	Che ropea guýpe romongéva’erã, ka’arupytũvo,	NOCHANGE
Che, mburuvicha, ahy’okatupyrýpe amoñe’ê kuatiahaipyre atyguasúgui, táva guasu	Che, mburuvicha, ahy’okatupyrýpe amoñe’ê kuatiahaipyre atyguasúgui, táva guasu	NOCHANGE
Ñande jaguata ñande ñamba’apo	Ñande jaguata ñande ñamba’apo	NOCHANGE
Ñemby (táva)	Ñemby (táva)	NOCHANGE
Amo gotyo, ñemano ýpe.	Amo gotyo, ñemano ýpe.	NOCHANGE
Upégui osêha pe jeiko porãve opa tetãme.	Upégui osêha pe jeiko porãve opa tetãme.	NOCHANGE
Ñande ñanguaiva’ekue	Ñande ñanguaiva’ekue	NOCHANGE
Mitã reko marã, ñoha’angarã, osẽ...	Mitã reko marã, ñoha’angarã, osẽ...	NOCHANGE
Guyra ñe’ẽ hetahápe	Guyra ñe’ẽ hetahápe	NOCHANGE
Aty ojokuaikuaáva	Aty ojokuaikuaáva	NOCHANGE
Mitâ’iete ha opurahéima ñanemba’etéva	Mitâ’iete ha opurahéima ñanemba’etéva	NOCHANGE
Tupã, ñande jára, nde irũnamo oiko imombe’u katupýra nde kuña pavẽgui.	Tupã, ñande jára, nde irũnamo oiko imombe’u katupýra nde kuña pavẽgui.	NOCHANGE
Ñemyakã peteĩete	Ñemyakã peteĩete	NOCHANGE
Iporã, hatã ha avei ndokyhyjéi	Iporã, hatã ha avei ndokyhyjéi	NOCHANGE
Aturuñe’ẽ ñaneñe’ẽ teetépe	Aturuñe’ẽ ñaneñe’ẽ teetépe	NOCHANGE
Ñ- ñemby (paraguay)	Ñ- ñemby (paraguay)	NOCHANGE
Kuimba’e oñangarekova’erã ha’ỹire	Kuimba’e oñangarekova’erã ha’ỹire	NOCHANGE
Oikomi ñande apytépe karai aranduete.	Oikomi ñande apytépe karai aranduete.	NOCHANGE
Ñe’ẽpoty - poesia.	Ñe’ẽpoty - poesia.	NOCHANGE
Iguýpe oñembopiro’ymi.	Iguýpe oñembopiro’ymi.	NOCHANGE
Pe ijuru pukavymi nombotuichái mba’eve	Pe ijuru pukavymi nombotuichái mba’eve	NOCHANGE
Omomorãvo ko ko’êmba.	Omomorãvo ko ko’êmba.	NOCHANGE
Ha ñamboguata ñanemba’ete...	Ha ñamboguata ñanemba’ete...	NOCHANGE
Nde ha’e che yvoty,	Nde ha’e che yvoty,	NOCHANGE
Oñembovai ha ojejaheiha hese opaicharei ñane retãygua apytépe, ha	Oñembovai ha ojejaheiha hese opaicharei ñane retãygua apytépe, ha	NOCHANGE
Távape guarã, terã ocontratárõ tetãmini ha umi táva ndivéi, terã ojapyhýrõ gerencia,	Távape guarã, terã ocontratárõ tetãmini ha umi táva ndivéi, terã ojapyhýrõ gerencia,	NOCHANGE
Ñarukã guasu.	Ñarukã guasu.	NOCHANGE
Ha’eha mba’e he’õ rerekuára. avei ha’e pira, mbusu, ysapy ha yvoty ñangarekohára.	Ha’eha mba’e he’õ rerekuára. avei ha’e pira, mbusu, ysapy ha yvoty ñangarekohára.	NOCHANGE
Ñanemongyhyjéva ha opaichaguáva. upeichavérõ jepe, maymáva ñanerekombo’e	Ñanemongyhyjéva ha opaichaguáva. upeichavérõ jepe, maymáva ñanerekombo’e	NOCHANGE
Ijeiretéva ñane ava ñe’ẽ.	Ijeiretéva ñane ava ñe’ẽ.	NOCHANGE
Ha káda oguahẽ heñói hague ára	Ha káda oguahẽ heñói hague ára	NOCHANGE
Oñembojoja haguã umi área protegida-pe táva kuéra ha umi yvýrupi oikóva, oñomongeta va’erã	Oñembojoja haguã umi área protegida-pe táva kuéra ha umi yvýrupi oikóva, oñomongeta va’erã	NOCHANGE
-peteĩ jagua, che ruvicha.	-peteĩ jagua, che ruvicha.	NOCHANGE
He’iháicha, ha oñemomboka va’erã ojerurérõ umi mburuvichaitéva, mante ndoikói péicha	He’iháicha, ha oñemomboka va’erã ojerurérõ umi mburuvichaitéva, mante ndoikói péicha	NOCHANGE
Ha’ekuéra ohypyiva’ekue omoirũva’ekue	Ha’ekuéra ohypyiva’ekue omoirũva’ekue	NOCHANGE
Tetãvore paraguari	Tetãvore paraguari	NOCHANGE
Ndéve onkarga upe mitã.	Ndéve onkarga upe mitã.	NOCHANGE
Ñe’ẽtéva tero	Ñe’ẽtéva tero	NOCHANGE
Mba’épa ndererumi pa’i. mba’éiko oimemi nde juháguio.	Mba’épa ndererumi pa’i. mba’éiko oimemi nde juháguio.	NOCHANGE
A ñembosarái.	A ñembosarái.	NOCHANGE
Mba’éichapa pene ko’ë. ore rovy’a ikatu háre ko’apeve roguahë.	Mba’éichapa pene ko’ë. ore rovy’a ikatu háre ko’apeve roguahë.	NOCHANGE
Tetã ambuére purahéi apoi,	Tetã ambuére purahéi apoi,	NOCHANGE
Ñane retã rekove.	Ñane retã rekove.	NOCHANGE
Ndaipokuaái ipore’ỹ.	Ndaipokuaái ipore’ỹ.	NOCHANGE
Ha’ete mbyja	Ha’ete mbyja	NOCHANGE
Oikóva oipykúi ko arapy.	Oikóva oipykúi ko arapy.	NOCHANGE
Amandaje ñe’ẽ rapereka paraguáipe rehegua	Amandaje ñe’ẽ rapereka paraguáipe rehegua	NOCHANGE
Che ñe’ê yvoty	Che ñe’ê yvoty	NOCHANGE
Nde resa yvága hovy.	Nde resa yvága hovy.	NOCHANGE
Hína ko kuimba’e ndo’uieteha ñane ñe’ẽ	Hína ko kuimba’e ndo’uieteha ñane ñe’ẽ	NOCHANGE
Mahe’ẽ, mba’e he’ẽ - coisa doce.	Mahe’ẽ, mba’e he’ẽ - coisa doce.	NOCHANGE
. ku ko’ẽ ha oje’óigui hi’urã repy reka	. ku ko’ẽ ha oje’óigui hi’urã repy reka	NOCHANGE
Nahániri. ndachéiko. oñembojánteko che rehe.	Nahániri. ndachéiko. oñembojánteko che rehe.	NOCHANGE
Ha ndaikatúi reveve.	Ha ndaikatúi reveve.	NOCHANGE
Ñorãirõ oñesẽvaíva ha’e pe ojehejareíva	Ñorãirõ oñesẽvaíva ha’e pe ojehejareíva	NOCHANGE
. ñe’ẽ yvoty guaraní	. ñe’ẽ yvoty guaraní	NOCHANGE
Oiméramo ohenóiva ne rokẽme peteĩ pyhareve	Oiméramo ohenóiva ne rokẽme peteĩ pyhareve	NOCHANGE
Jañe’ẽ ñañe’ẽ	Jañe’ẽ ñañe’ẽ	NOCHANGE
Ha jerovia póra rehegua (upéva jeko hekovaiva’ekue, iñangaipa hetava’ekue), ha	Ha jerovia póra rehegua (upéva jeko hekovaiva’ekue, iñangaipa hetava’ekue), ha	NOCHANGE
Mba’e ñemboro’y guivy ae,	Mba’e ñemboro’y guivy ae,	NOCHANGE
Mba’apo ha pirapire me’ẽha umi oguereko’ỹvape	Mba’apo ha pirapire me’ẽha umi oguereko’ỹvape	NOCHANGE
Ha oipyaháva purahéi chupekuéra omoñe’ê.	Ha oipyaháva purahéi chupekuéra omoñe’ê.	NOCHANGE
Ha ornyakỹ rire ijahy’okuéra nde y piro’ýpe	Ha ornyakỹ rire ijahy’okuéra nde y piro’ýpe	NOCHANGE
Ha ñañemomirĩ.	Ha ñañemomirĩ.	NOCHANGE
Ikatúnte reporandu, oikuaa porã tupã.	Ikatúnte reporandu, oikuaa porã tupã.	NOCHANGE
Oikóva ombotuicha avañe’ẽ umi mba’ekuaápe okakuaáva	Oikóva ombotuicha avañe’ẽ umi mba’ekuaápe okakuaáva	NOCHANGE
Tetãvore joapykuéra ipoguýpe	Tetãvore joapykuéra ipoguýpe	NOCHANGE
Peteĩ mitã pyahu.	Peteĩ mitã pyahu.	NOCHANGE
Tapichakuéra ko tavaygua avei omba’apo mitã kuña membygua’u aoguigua apópe.	Tapichakuéra ko tavaygua avei omba’apo mitã kuña membygua’u aoguigua apópe.	NOCHANGE
Ndikatúi va’erã oñembojo’a mokõi terã hetave tetãmini rehegua tembiapo ojepagáva,	Ndikatúi va’erã oñembojo’a mokõi terã hetave tetãmini rehegua tembiapo ojepagáva,	NOCHANGE
Mba’éichapa iporã	Mba’éichapa iporã	NOCHANGE
Rupi, katu kóva sa’i gueteri jahecháramo	Rupi, katu kóva sa’i gueteri jahecháramo	NOCHANGE
Ha’ekuéra oporohayhu oporombyepoti	Ha’ekuéra oporohayhu oporombyepoti	NOCHANGE
Che ahai peteĩ aranduka	Che ahai peteĩ aranduka	NOCHANGE
Iñasâiva ápe ha pépe.	Iñasâiva ápe ha pépe.	NOCHANGE
Ko kuñakarai ipytuho heta hasyete rire.	Ko kuñakarai ipytuho heta hasyete rire.	NOCHANGE
(oñembohapejeýva china tekoha tetã)	(oñembohapejeýva china tekoha tetã)	NOCHANGE
Hina tau ha kerana ñemoñare irundyha. ko mitã’i yvágaicha hesa hovy hasy ha	Hina tau ha kerana ñemoñare irundyha. ko mitã’i yvágaicha hesa hovy hasy ha	NOCHANGE
Ojepuru mbói, ñandupe, japeusa ha ambue tymba vai ñandesu’úva pohâgua.	Ojepuru mbói, ñandupe, japeusa ha ambue tymba vai ñandesu’úva pohâgua.	NOCHANGE
Ojeipe’a ichugui pe ikyrakue ha pe iso’okue hembývape oñemoĩ upe naranjahái rykue ha avei juky. kóva oñembojy jevy oreko sa’y pytãngy.	Ojeipe’a ichugui pe ikyrakue ha pe iso’okue hembývape oñemoĩ upe naranjahái rykue ha avei juky. kóva oñembojy jevy oreko sa’y pytãngy.	NOCHANGE
Peteĩ guyra’imi cherendapema ojokuái,	Peteĩ guyra’imi cherendapema ojokuái,	NOCHANGE
Karuguápe ha ka’aguýpe	Karuguápe ha ka’aguýpe	NOCHANGE
Roñe’ẽ, upéicha avei ndaikatúi romýi upégui. péicha roĩkuri upépe oho peve	Roñe’ẽ, upéicha avei ndaikatúi romýi upégui. péicha roĩkuri upépe oho peve	NOCHANGE
Ha’ekuéra ojurajepe omokõjepe	Ha’ekuéra ojurajepe omokõjepe	NOCHANGE
Nañeha’ãva’erã niko ani ohasarei ko ára ha ñame’ẽ ojupe ñane mborayhu.	Nañeha’ãva’erã niko ani ohasarei ko ára ha ñame’ẽ ojupe ñane mborayhu.	NOCHANGE
Mávapa oimo’ãta oĩha ñande rapicha ohayhuasýva guaraní ñe’ẽ, ahendu he’ihikuái, ñane retã rembe’ýpe, omomba’eguasúvo umi nerembiapo.	Mávapa oimo’ãta oĩha ñande rapicha ohayhuasýva guaraní ñe’ẽ, ahendu he’ihikuái, ñane retã rembe’ýpe, omomba’eguasúvo umi nerembiapo.	NOCHANGE
Ha hendy ñane retãme yvágape.	Ha hendy ñane retãme yvágape.	NOCHANGE
Parĩ niko upe táva iporãvéva opa yvórape.	Parĩ niko upe táva iporãvéva opa yvórape.	NOCHANGE
Mavavépe omba’apóva tetãmini rehegua tembiapópe ta ha’e ha’éva, omba’apo aja ndikatúi	Mavavépe omba’apóva tetãmini rehegua tembiapópe ta ha’e ha’éva, omba’apo aja ndikatúi	NOCHANGE
Ñaipytyvókena ñande retepe ñambopyahujey	Ñaipytyvókena ñande retepe ñambopyahujey	NOCHANGE
Sa’ive oikuaaro tapichakuéra mba’eichapa ojejapo so’oku’iapytĩnguera ha tekorãnguéra, oke porãvene	Sa’ive oikuaaro tapichakuéra mba’eichapa ojejapo so’oku’iapytĩnguera ha tekorãnguéra, oke porãvene	NOCHANGE
Hose ndaikatúi ohupyty hogue ojapo hagua tupãsýme hogarãmi. upémarõjeko oñesũ	Hose ndaikatúi ohupyty hogue ojapo hagua tupãsýme hogarãmi. upémarõjeko oñesũ	NOCHANGE
Japu ha’e peteĩ mba’e tekotevẽteva jagueropu’akahaguã ko tekove	Japu ha’e peteĩ mba’e tekotevẽteva jagueropu’akahaguã ko tekove	NOCHANGE
Mba’éicha ikatu reikuaa ñandejára ojeruréva	Mba’éicha ikatu reikuaa ñandejára ojeruréva	NOCHANGE
Ha poguasukuéra.	Ha poguasukuéra.	NOCHANGE
. ha eraha nde pýri ore ñe’ẽmi.	. ha eraha nde pýri ore ñe’ẽmi.	NOCHANGE
Voto añetegua ome’ẽ va’ekuégui.	Voto añetegua ome’ẽ va’ekuégui.	NOCHANGE
Oejecuta terã ojejapo embargo umi bien ha renta opaichagua oñeme’ẽ va’ekue tekombo’e	Oejecuta terã ojejapo embargo umi bien ha renta opaichagua oñeme’ẽ va’ekue tekombo’e	NOCHANGE
Hi’ãma omyasãi ha tañahendu ñande tetãygua.	Hi’ãma omyasãi ha tañahendu ñande tetãygua.	NOCHANGE
Jevyevy ke ja’e pe tetã myakãhápe	Jevyevy ke ja’e pe tetã myakãhápe	NOCHANGE
Tetã argentina momorãhéi	Tetã argentina momorãhéi	NOCHANGE
Jajuayhu porã.	Jajuayhu porã.	NOCHANGE
Tetãvore oruro	Tetãvore oruro	NOCHANGE
Tape mbytére hi’ãnga heñói	Tape mbytére hi’ãnga heñói	NOCHANGE
Oho chaco ñorãirõhápe, oipysyrõvo ñane retã.	Oho chaco ñorãirõhápe, oipysyrõvo ñane retã.	NOCHANGE
Upévako hína pe chéve ojehúva	Upévako hína pe chéve ojehúva	NOCHANGE
Ñande rekove.	Ñande rekove.	NOCHANGE
Jepémo ha’ekuéra tekove ñandeichaguánte,	Jepémo ha’ekuéra tekove ñandeichaguánte,	NOCHANGE
Umi ygua peteĩ árapegua haguynóma ko’ẽro guarã. upévare ñambosako’i va’erã ko’ẽreíre upe jaiporútavante voi.	Umi ygua peteĩ árapegua haguynóma ko’ẽro guarã. upévare ñambosako’i va’erã ko’ẽreíre upe jaiporútavante voi.	NOCHANGE
Upéva aja ndikatúi omba’apo ambue, terã to jepaga ichupekuéra tetãguasu terã tetãminígui.	Upéva aja ndikatúi omba’apo ambue, terã to jepaga ichupekuéra tetãguasu terã tetãminígui.	NOCHANGE
Ta’angaryrýi) guarani ñe’ême ha guarani arandupy ha ambue avakuéra reko rehegua.	Ta’angaryrýi) guarani ñe’ême ha guarani arandupy ha ambue avakuéra reko rehegua.	NOCHANGE
He’iséva ñe’êpehê upéigua paha.	He’iséva ñe’êpehê upéigua paha.	NOCHANGE
Aikuaáma che mba’érepa guaraní ñemoñare,	Aikuaáma che mba’érepa guaraní ñemoñare,	NOCHANGE
Ñande poyvi joguaha.	Ñande poyvi joguaha.	NOCHANGE
Ñandekuéra paraguáy hese ñanemandu’a	Ñandekuéra paraguáy hese ñanemandu’a	NOCHANGE
Ñemoñe’ẽ paha	Ñemoñe’ẽ paha	NOCHANGE
Ku jepérõ oikotevẽ, ha’ekuérante oikuaáva	Ku jepérõ oikotevẽ, ha’ekuérante oikuaáva	NOCHANGE
He’ẽte guaviju che korapypegua.	He’ẽte guaviju che korapypegua.	NOCHANGE
Ha’e oñembo’y ha ipópe omopotĩ hova ry’aikue. ombohasa ipo rykue ikaso revíre oñemokãvo.	Ha’e oñembo’y ha ipópe omopotĩ hova ry’aikue. ombohasa ipo rykue ikaso revíre oñemokãvo.	NOCHANGE
Upe hetave oñemba’apoha katu ha’ehína upe vaka ñemoña rehegua ko tenda rupi.	Upe hetave oñemba’apoha katu ha’ehína upe vaka ñemoña rehegua ko tenda rupi.	NOCHANGE
Pyhare ha ára romoirũ haguã.	Pyhare ha ára romoirũ haguã.	NOCHANGE
Ha upéicha oguahéramo pe ára ipaha,	Ha upéicha oguahéramo pe ára ipaha,	NOCHANGE
Ojupi yvágape, oikove jevy,	Ojupi yvágape, oikove jevy,	NOCHANGE
Tetã nguéra ojapo háicha.	Tetã nguéra ojapo háicha.	NOCHANGE
Karai comi ohendu oñe’ëmondóramo chupe umi oka’úva ha ipochy.	Karai comi ohendu oñe’ëmondóramo chupe umi oka’úva ha ipochy.	NOCHANGE
Mba’eveichaguávape.	Mba’eveichaguávape.	NOCHANGE
Ñe’ë mbykymi kuaapy térã momarandu rehegua oipurúva tavaygua.	Ñe’ë mbykymi kuaapy térã momarandu rehegua oipurúva tavaygua.	NOCHANGE
Añetehápe ko’ã tembipuru pyahu mbo’ekotýpe ojapo hetáva mbo’ehára oñeñandu ipy’atutúva jeporu reheve ko’ã tembiporúgui.	Añetehápe ko’ã tembipuru pyahu mbo’ekotýpe ojapo hetáva mbo’ehára oñeñandu ipy’atutúva jeporu reheve ko’ã tembiporúgui.	NOCHANGE
Mba’eve ndaipori ñanembosareko hetáva ha sa’i mba’e ñanembosarekovýva	Mba’eve ndaipori ñanembosareko hetáva ha sa’i mba’e ñanembosarekovýva	NOCHANGE
Ombohory nde sýpe ne ñe’ê.	Ombohory nde sýpe ne ñe’ê.	NOCHANGE
Ñamoañetévo tuichaha umi ojejapóma va’ekue ha oñembohapéva pe	Ñamoañetévo tuichaha umi ojejapóma va’ekue ha oñembohapéva pe	NOCHANGE
A yvy ryvycói.	A yvy ryvycói.	NOCHANGE
Ko’ãvape ku ra’e tupã yvy ári ombou	Ko’ãvape ku ra’e tupã yvy ári ombou	NOCHANGE
Mba’erãpa reju.	Mba’erãpa reju.	NOCHANGE
Mitãnguéra tokirirĩ ha tokeke avei	Mitãnguéra tokirirĩ ha tokeke avei	NOCHANGE
- cheropehyive mbarakaja iko’ẽ va’ekue poste akã árigui.	- cheropehyive mbarakaja iko’ẽ va’ekue poste akã árigui.	NOCHANGE
Jukyrýre osyrýva upépe ombe’úva ijapyra’ỹva ñande rekove	Jukyrýre osyrýva upépe ombe’úva ijapyra’ỹva ñande rekove	NOCHANGE
Tetãmini ha táva mokõive ikatuha peve ojapo omoingouka va’erã yvy jeporu ha avei	Tetãmini ha táva mokõive ikatuha peve ojapo omoingouka va’erã yvy jeporu ha avei	NOCHANGE
Pópe oiporavóvo mávapa upe ñe’ẽ	Pópe oiporavóvo mávapa upe ñe’ẽ	NOCHANGE
Reñapytĩ ha oho,	Reñapytĩ ha oho,	NOCHANGE
Peteĩ ko’ẽme rejevy jeýrõ	Peteĩ ko’ẽme rejevy jeýrõ	NOCHANGE
Nde poyvi araháta ko che pyti’ápe tomimbirei.	Nde poyvi araháta ko che pyti’ápe tomimbirei.	NOCHANGE
Ndaha’éiva hesegua.	Ndaha’éiva hesegua.	NOCHANGE
Yso. tr. ha’e ningo panambi térâ mberu ra’y osê ramóva tupi’águi ha okarúva ka’avóre oñembopepo mboyve.	Yso. tr. ha’e ningo panambi térâ mberu ra’y osê ramóva tupi’águi ha okarúva ka’avóre oñembopepo mboyve.	NOCHANGE
- amendase, che niko yma guive hapykuéri aikóva. mba’e piko	- amendase, che niko yma guive hapykuéri aikóva. mba’e piko	NOCHANGE
Iguaraniñe’ẽ añóvapente, ha’ekuéraramo	Iguaraniñe’ẽ añóvapente, ha’ekuéraramo	NOCHANGE
Ndaiporiha sy mborayhúicha tuicháva ha ijojaha’yva ko yvy apére.	Ndaiporiha sy mborayhúicha tuicháva ha ijojaha’yva ko yvy apére.	NOCHANGE
Ñane ñe’ẽ teete porãite	Ñane ñe’ẽ teete porãite	NOCHANGE
Cerro ñemby (ñemby)	Cerro ñemby (ñemby)	NOCHANGE
Ha ñanderehe omano.	Ha ñanderehe omano.	NOCHANGE
Hembiguáiramo jaikóne, mba’apo ha ñorairõme	Hembiguáiramo jaikóne, mba’apo ha ñorairõme	NOCHANGE
Ojapo yvy ñemboja’o oñemba’apo porãve haguã administración-pe.	Ojapo yvy ñemboja’o oñemba’apo porãve haguã administración-pe.	NOCHANGE
Anohẽ haguã ahetũ ndavy’áirõ sapy’ánte.	Anohẽ haguã ahetũ ndavy’áirõ sapy’ánte.	NOCHANGE
Mitã itĩñe’ẽva ikatu okuéra oñepohano ha eñembo’é porãramo ichupe.	Mitã itĩñe’ẽva ikatu okuéra oñepohano ha eñembo’é porãramo ichupe.	NOCHANGE
Ñane retãme, umi iñarandúva ombyaty ijehe térã ojejapi ñe’ẽreípe. manu he’íva’ekue pe arapy ha’eha hogapy, hi’ãngapyporãguiraka’e.	Ñane retãme, umi iñarandúva ombyaty ijehe térã ojejapi ñe’ẽreípe. manu he’íva’ekue pe arapy ha’eha hogapy, hi’ãngapyporãguiraka’e.	NOCHANGE
Mitãkaria’ykuéra ko’ágãgua oha’ãngapy’ãpo pira pire ha’eha opaite mba’e, okakuaavove oikua porã	Mitãkaria’ykuéra ko’ágãgua oha’ãngapy’ãpo pira pire ha’eha opaite mba’e, okakuaavove oikua porã	NOCHANGE
Ñe’êhe’isejojáva ñema’ê	Ñe’êhe’isejojáva ñema’ê	NOCHANGE
Omoñepyrũva teko ha ñemano, tytýi.	Omoñepyrũva teko ha ñemano, tytýi.	NOCHANGE
Guarani tetã paraguái paraguái	Guarani tetã paraguái paraguái	NOCHANGE
. ku merõ aju porã ñahetũ ápe ha pépe	. ku merõ aju porã ñahetũ ápe ha pépe	NOCHANGE
Ani anga hesa’yju ovyvyha rupi opyta.	Ani anga hesa’yju ovyvyha rupi opyta.	NOCHANGE
Peteĩ mba’ekuaavetehára ika’avóva, itujaramojepe, he’irõ peteĩ mba’e ikatuha, katuete upeicha. he’iro ndaikatuiha katuete ojejavy	Peteĩ mba’ekuaavetehára ika’avóva, itujaramojepe, he’irõ peteĩ mba’e ikatuha, katuete upeicha. he’iro ndaikatuiha katuete ojejavy	NOCHANGE
Upe oĩháme javy, che tamoĩ añetegua,	Upe oĩháme javy, che tamoĩ añetegua,	NOCHANGE
Oiméva, ’y opáva peguarã terã ikatúva opavave oiporu, avei umi ’y yvyguypegua umichagua	Oiméva, ’y opáva peguarã terã ikatúva opavave oiporu, avei umi ’y yvyguypegua umichagua	NOCHANGE
Ha ojuhúva ho’u	Ha ojuhúva ho’u	NOCHANGE
Hapichápe, opyta tupã poguýpe ha mburuvicha kuéra poguy’ỹgui.	Hapichápe, opyta tupã poguýpe ha mburuvicha kuéra poguy’ỹgui.	NOCHANGE
Hemimo’ã, ha oipyguara mburuvicha rekove, jepérõ ndikatúi ojapo sarambi isã sógui.	Hemimo’ã, ha oipyguara mburuvicha rekove, jepérõ ndikatúi ojapo sarambi isã sógui.	NOCHANGE
Ha toñañuã ñande purahéi.	Ha toñañuã ñande purahéi.	NOCHANGE
Nde py’a karãi ramo sapy’ánte	Nde py’a karãi ramo sapy’ánte	NOCHANGE
Purahéi rire,	Purahéi rire,	NOCHANGE
Oguyguy ápe ha pépe. hógape ndopytavéi.	Oguyguy ápe ha pépe. hógape ndopytavéi.	NOCHANGE
Guaraní rayhupápe ñane retã rembe’ýre ñaikundaha	Guaraní rayhupápe ñane retã rembe’ýre ñaikundaha	NOCHANGE
Ha’ete hyakuã ymáva	Ha’ete hyakuã ymáva	NOCHANGE
Nde ra’y kuéra ndive	Nde ra’y kuéra ndive	NOCHANGE
Ha heta ára ojekuaátava cherehe.	Ha heta ára ojekuaátava cherehe.	NOCHANGE
Ñembohasa’asy ñanembohasy.	Ñembohasa’asy ñanembohasy.	NOCHANGE
Tetã ñembyatypyre amandaje-mburuvicha rapépe	Tetã ñembyatypyre amandaje-mburuvicha rapépe	NOCHANGE
Upeichaháguinte pe kavaju ipyho peteĩ karuguápe ha oñapymi opytávo upépe ikatuve’ỹre omỹi, karia’y,	Upeichaháguinte pe kavaju ipyho peteĩ karuguápe ha oñapymi opytávo upépe ikatuve’ỹre omỹi, karia’y,	NOCHANGE
Mba’e a’ã petei i oguerojera ojeupe.	Mba’e a’ã petei i oguerojera ojeupe.	NOCHANGE
Ñanduti veve ha ñe’ẽmondo	Ñanduti veve ha ñe’ẽmondo	NOCHANGE
Mombyry ñane retã,	Mombyry ñane retã,	NOCHANGE
Heta arandu porã, ijapytépe mba’e guasuha umi ñe’ê ojeguerováva ohóvo	Heta arandu porã, ijapytépe mba’e guasuha umi ñe’ê ojeguerováva ohóvo	NOCHANGE
Iporãmínte ha nde.	Iporãmínte ha nde.	NOCHANGE
Ha’e umi mba’e ombojeguapáva	Ha’e umi mba’e ombojeguapáva	NOCHANGE
Anive peipykua ñe’ẽ	Anive peipykua ñe’ẽ	NOCHANGE
Iporãitereigui nde yvoty	Iporãitereigui nde yvoty	NOCHANGE
Peteĩ tuguaipopo ojejuhúva heta.	Peteĩ tuguaipopo ojejuhúva heta.	NOCHANGE
Ha che ndaguerekói mba’éve	Ha che ndaguerekói mba’éve	NOCHANGE
Ijyvy ojeporu ñemitỹrã.	Ijyvy ojeporu ñemitỹrã.	NOCHANGE
Oikuaauka va’erã	Oikuaauka va’erã	NOCHANGE
Ha umi tapicha oipytyvõ mbaretevéva	Ha umi tapicha oipytyvõ mbaretevéva	NOCHANGE
Nemby, ñemby (paraguay).	Nemby, ñemby (paraguay).	NOCHANGE
Ndaikatúi oiko.	Ndaikatúi oiko.	NOCHANGE
Purahéi jeroky,	Purahéi jeroky,	NOCHANGE
Itá mbaraka.	Itá mbaraka.	NOCHANGE
A mbojoja purahéi.	A mbojoja purahéi.	NOCHANGE
Ñe’ẽ jepuru, kóva niko oiko ymaite	Ñe’ẽ jepuru, kóva niko oiko ymaite	NOCHANGE
Namoĩri che réra arandukakuéra ajoguavare amoñe’ẽpa mboyve, upeicharamo añoite ikatu ha’e che mba’eha	Namoĩri che réra arandukakuéra ajoguavare amoñe’ẽpa mboyve, upeicharamo añoite ikatu ha’e che mba’eha	NOCHANGE
Chupekuéra.	Chupekuéra.	NOCHANGE
Oreko’ẽmba,	Oreko’ẽmba,	NOCHANGE
Táva óga yvate.	Táva óga yvate.	NOCHANGE
Peteĩ ára ko’ẽme che rupágui apu’ãvo	Peteĩ ára ko’ẽme che rupágui apu’ãvo	NOCHANGE
Aipykúi che rape, pya’e pya’e aguata,	Aipykúi che rape, pya’e pya’e aguata,	NOCHANGE
Ro’y porãite cocina ruguápe ha’ekuéra okéne	Ro’y porãite cocina ruguápe ha’ekuéra okéne	NOCHANGE
Iporâitepa ko ára tupa heñoi rehegua.	Iporâitepa ko ára tupa heñoi rehegua.	NOCHANGE
Kuatiañe’ẽ - carta	Kuatiañe’ẽ - carta	NOCHANGE
Avei, upe amandajépe, ojehechaukáta ñande jeroky ha oñehendúta ñande purahéi ha ñane ñe’êpoty, ñamomba’eguasúvo ñane retâ mba’e teéva.	Avei, upe amandajépe, ojehechaukáta ñande jeroky ha oñehendúta ñande purahéi ha ñane ñe’êpoty, ñamomba’eguasúvo ñane retâ mba’e teéva.	NOCHANGE
Nde ra’y ñembyahýire.	Nde ra’y ñembyahýire.	NOCHANGE
Jepémo oikove hikuái ñande apytépe,	Jepémo oikove hikuái ñande apytépe,	NOCHANGE
Ñañomongetáramo hendivekuéra ñaguenohembáta opa kuaapy oguerekóva ha jahejáta haipýpe umi mba’e.	Ñañomongetáramo hendivekuéra ñaguenohembáta opa kuaapy oguerekóva ha jahejáta haipýpe umi mba’e.	NOCHANGE
He’i avei hese ha’e hague peteĩ karai nda’ijespíritu ky’áiva a kuimba’e hendápeguaha upé árarupi.	He’i avei hese ha’e hague peteĩ karai nda’ijespíritu ky’áiva a kuimba’e hendápeguaha upé árarupi.	NOCHANGE
Añe’ẽta peteĩ ñati’ũre,	Añe’ẽta peteĩ ñati’ũre,	NOCHANGE
Pe tekombo’épe ojeiporuva’erã ko tembipuru pyahu, mbo’ehaópe, mbo’ekotýpe, ógape ha avei ñande rogaygua ndive.	Pe tekombo’épe ojeiporuva’erã ko tembipuru pyahu, mbo’ehaópe, mbo’ekotýpe, ógape ha avei ñande rogaygua ndive.	NOCHANGE
Pe yvypóra ndoikovei ñe’êrehe añonte, jepe sapy’ante omokõ vaerã iñe’ê	Pe yvypóra ndoikovei ñe’êrehe añonte, jepe sapy’ante omokõ vaerã iñe’ê	NOCHANGE
Tetãvore méhiko pegua	Tetãvore méhiko pegua	NOCHANGE
Pohãgua. ojeporu avei tako ojejohéi haguã. hapo pirekue ojeporu sevo’i pohãgua, tenondete voi sevo’iasahápe guarã.	Pohãgua. ojeporu avei tako ojejohéi haguã. hapo pirekue ojeporu sevo’i pohãgua, tenondete voi sevo’iasahápe guarã.	NOCHANGE
(oñembohapejeýva apỹi kimi rehegua)	(oñembohapejeýva apỹi kimi rehegua)	NOCHANGE
Jaikovéva ára ha ára	Jaikovéva ára ha ára	NOCHANGE
Ha árape imemby.	Ha árape imemby.	NOCHANGE
Ko yvy tuichakuére	Ko yvy tuichakuére	NOCHANGE
Mba’épa tekotevẽ ejapokuaa	Mba’épa tekotevẽ ejapokuaa	NOCHANGE
Ñambyasy ko’â mba’e	Ñambyasy ko’â mba’e	NOCHANGE
Ko yvy ári ojehasáva	Ko yvy ári ojehasáva	NOCHANGE
Pe tekopykuaa ha turismo oje’eha oguataháicha oñondive ogueru tembiapo	Pe tekopykuaa ha turismo oje’eha oguataháicha oñondive ogueru tembiapo	NOCHANGE
Iporãiteva’erã ipukuverõ	Iporãiteva’erã ipukuverõ	NOCHANGE
Ñane retã purahéi guasu guaraníme	Ñane retã purahéi guasu guaraníme	NOCHANGE
Mba’ere ko’agã ñande rogamime oguajhê ro’y.	Mba’ere ko’agã ñande rogamime oguajhê ro’y.	NOCHANGE
Ñe’ẽ’etáva tendaguáva moteĩva	Ñe’ẽ’etáva tendaguáva moteĩva	NOCHANGE
Iporã jeguerovia temiporã jára ojapóvare, ha nahániri pe he’íva hembiapo rehe	Iporã jeguerovia temiporã jára ojapóvare, ha nahániri pe he’íva hembiapo rehe	NOCHANGE
Ha akóúite nde potyrõ roipo’o che mba’erã.	Ha akóúite nde potyrõ roipo’o che mba’erã.	NOCHANGE
Ha nderehe ndaipo’ái.	Ha nderehe ndaipo’ái.	NOCHANGE
Chéve ogueru nde kuatiañe’ẽ,	Chéve ogueru nde kuatiañe’ẽ,	NOCHANGE
Ko che purahéipe ha’éta ndéve	Ko che purahéipe ha’éta ndéve	NOCHANGE
Ha upéva ku hína ñande jarekóva tetã ahoja.	Ha upéva ku hína ñande jarekóva tetã ahoja.	NOCHANGE
Ary pukukue jave, ojejapo aty tetâ remimboukuéra argentina-ygua paraguáipe	Ary pukukue jave, ojejapo aty tetâ remimboukuéra argentina-ygua paraguáipe	NOCHANGE
Ko’ápe oho che mba’e porandu mbohapýha mboy hague.	Ko’ápe oho che mba’e porandu mbohapýha mboy hague.	NOCHANGE
Akóinte nereñoijeyva’erâ opaite mba’erasy rehasava’ekuégui ha emombaretévo jerovia ndejehe remokechêta taha’eha’éva mba’e vaípe	Akóinte nereñoijeyva’erâ opaite mba’erasy rehasava’ekuégui ha emombaretévo jerovia ndejehe remokechêta taha’eha’éva mba’e vaípe	NOCHANGE
Pohâ iporâva ñande pire rehegua mba’asýpe .	Pohâ iporâva ñande pire rehegua mba’asýpe .	NOCHANGE
Peichaháguinte oñandu sapy’a opokóva hese, ha’ete voi	Peichaháguinte oñandu sapy’a opokóva hese, ha’ete voi	NOCHANGE
Ñe’ë oje’éva ñemihápe.	Ñe’ë oje’éva ñemihápe.	NOCHANGE
Che, ahendu ne ñe’ẽ	Che, ahendu ne ñe’ẽ	NOCHANGE
Jajepoimína hembiapo rapykuerére ha jahecháta mba’emba’épa ojapo ha oheja ñandéve.	Jajepoimína hembiapo rapykuerére ha jahecháta mba’emba’épa ojapo ha oheja ñandéve.	NOCHANGE
Oyvárapy mba’ekuaágui	Oyvárapy mba’ekuaágui	NOCHANGE
Apurahéivo ichupe.	Apurahéivo ichupe.	NOCHANGE
Kuñanguéra estancia-peomba’apo óga mopotĩháraramo ha avei aojohéipe. heta jeýpe ojapóva’erã tembi’u estancia ñangarekohárape.	Kuñanguéra estancia-peomba’apo óga mopotĩháraramo ha avei aojohéipe. heta jeýpe ojapóva’erã tembi’u estancia ñangarekohárape.	NOCHANGE
Oiko sapy’a peteĩ karai vosa	Oiko sapy’a peteĩ karai vosa	NOCHANGE
Ojehekombo’e ñepyrũrãite guive iñe’ẽ	Ojehekombo’e ñepyrũrãite guive iñe’ẽ	NOCHANGE
Omoinge kóva ryepýpe heta ñe’ẽ pyahu mitã oipurúva mbo’ehaópe.	Omoinge kóva ryepýpe heta ñe’ẽ pyahu mitã oipurúva mbo’ehaópe.	NOCHANGE
A árape, ñande rekove	A árape, ñande rekove	NOCHANGE
Oiko ichuguikuéra tapicha arandu	Oiko ichuguikuéra tapicha arandu	NOCHANGE
Opavave oguerekóne jeporu porã tekoha hesãiva ha ijojáva ha oñangareko va’erã	Opavave oguerekóne jeporu porã tekoha hesãiva ha ijojáva ha oñangareko va’erã	NOCHANGE
Mba’asy, jejuka, ñemonda ha	Mba’asy, jejuka, ñemonda ha	NOCHANGE
Nde rete pirĩ pa’ũme	Nde rete pirĩ pa’ũme	NOCHANGE
Ohai ñe’ẽpoty peteĩ	Ohai ñe’ẽpoty peteĩ	NOCHANGE
Repurahéirõ remba’apo jave.	Repurahéirõ remba’apo jave.	NOCHANGE
Ojepuru sa’y pytãngy péva ha’égui kuña sa’y ko yvóra tuichakue javeve.	Ojepuru sa’y pytãngy péva ha’égui kuña sa’y ko yvóra tuichakue javeve.	NOCHANGE
Presidente-pe ha umi távape.	Presidente-pe ha umi távape.	NOCHANGE
(mandu’a, añete ha tekojoja ha’e mbohapy ñe’ẽ ojehaiva’ekue tatápe ñane retãme.)	(mandu’a, añete ha tekojoja ha’e mbohapy ñe’ẽ ojehaiva’ekue tatápe ñane retãme.)	NOCHANGE
Che ñe’â omyenyhêva	Che ñe’â omyenyhêva	NOCHANGE
Ore remikuave’êre, rohenói ára ha pyhare.	Ore remikuave’êre, rohenói ára ha pyhare.	NOCHANGE
Hese ñane mandu’a.	Hese ñane mandu’a.	NOCHANGE
Ñandéicha avei tatápe guarã.	Ñandéicha avei tatápe guarã.	NOCHANGE
Ñambohape ñane ñe’ẽ jajokupyty porãve haguã ñane arandúpe ha ñande rekoitépe merkosur guive	Ñambohape ñane ñe’ẽ jajokupyty porãve haguã ñane arandúpe ha ñande rekoitépe merkosur guive	NOCHANGE
Tetã ambuére oikóva	Tetã ambuére oikóva	NOCHANGE
Akóinte nereñoijeyva’erâ opaite mba’erasy rehasava’ekuégui ha emombaretévo jerovia ndejehe remokechêta taha’eha’éva mba’evaípe	Akóinte nereñoijeyva’erâ opaite mba’erasy rehasava’ekuégui ha emombaretévo jerovia ndejehe remokechêta taha’eha’éva mba’evaípe	NOCHANGE
Oiko ndaje jurumi, eterei ojerokyséva ha ojehechaukaséva umi ambue tapicha kuérape.	Oiko ndaje jurumi, eterei ojerokyséva ha ojehechaukaséva umi ambue tapicha kuérape.	NOCHANGE
Kachíke ha mba’yrumýi puku - o caipira e o trem.	Kachíke ha mba’yrumýi puku - o caipira e o trem.	NOCHANGE
Mba’érepa oñe’ẽva’erã.	Mba’érepa oñe’ẽva’erã.	NOCHANGE
Che rendápe rembyatyva ka’aguy ryakuânguemi	Che rendápe rembyatyva ka’aguy ryakuânguemi	NOCHANGE
Tetãyguakuérape prográma iñe’ẽ teépe.	Tetãyguakuérape prográma iñe’ẽ teépe.	NOCHANGE
Tembikuaaty purúva	Tembikuaaty purúva	NOCHANGE
A. umi ñe’ême’ê oñemomba’e jey jey va’ekue	A. umi ñe’ême’ê oñemomba’e jey jey va’ekue	NOCHANGE
Amoñe’ẽ marandumbe’uha taryrýipe. pea añoite ha’e temiandugua’u ame’ẽva tapia che jupe	Amoñe’ẽ marandumbe’uha taryrýipe. pea añoite ha’e temiandugua’u ame’ẽva tapia che jupe	NOCHANGE
Mba’éichapa kuarahy	Mba’éichapa kuarahy	NOCHANGE
Mba’éichapa imbarete	Mba’éichapa imbarete	NOCHANGE
Ñasaindy perepere pa’ũ rupi oñemboja mbeguekatu oúvo ava oguerúva poyvi pytã, morotĩ ha hovy ijapére.	Ñasaindy perepere pa’ũ rupi oñemboja mbeguekatu oúvo ava oguerúva poyvi pytã, morotĩ ha hovy ijapére.	NOCHANGE
Yvágareje oma’ẽ	Yvágareje oma’ẽ	NOCHANGE
Oñemoambue ichupekuéra hembiapo aja.	Oñemoambue ichupekuéra hembiapo aja.	NOCHANGE
Ta’upami kóva ha taha.	Ta’upami kóva ha taha.	NOCHANGE
Oñemoarandúvo umi aranduka tembiasakue reheguáva ojeheróva	Oñemoarandúvo umi aranduka tembiasakue reheguáva ojeheróva	NOCHANGE
Ha je aipo che angatarãnte ko yvy ári nde reju.	Ha je aipo che angatarãnte ko yvy ári nde reju.	NOCHANGE
V mba’éichapa héra nde jarýi	V mba’éichapa héra nde jarýi	NOCHANGE
Jepémo heta kuimba’e oityse ichupe iñuhãme, jata akóinte ojuhúmi peteĩ tape ojehekýi haguã umívagui.	Jepémo heta kuimba’e oityse ichupe iñuhãme, jata akóinte ojuhúmi peteĩ tape ojehekýi haguã umívagui.	NOCHANGE
Péva ha’epávo chupe ajere amoĩ che akã rehegua ha asẽ. mba’eve vera nde’ivéi chéve. opyta hatã upépe ñemo’ã umi ta’anga yvy.	Péva ha’epávo chupe ajere amoĩ che akã rehegua ha asẽ. mba’eve vera nde’ivéi chéve. opyta hatã upépe ñemo’ã umi ta’anga yvy.	NOCHANGE
Ha’ekuéra ojeruréva,	Ha’ekuéra ojeruréva,	NOCHANGE
Pyhare ha ára	Pyhare ha ára	NOCHANGE
Irundy ñe’ẽngue poravo atýra	Irundy ñe’ẽngue poravo atýra	NOCHANGE
Ñe’ẽndýi ñe’ẽtéva terarãnguete	Ñe’ẽndýi ñe’ẽtéva terarãnguete	NOCHANGE
Okomunikakuaáramo opa mba’e oñandu ha ohechakuaáva.	Okomunikakuaáramo opa mba’e oñandu ha ohechakuaáva.	NOCHANGE
Umi tekopykuaa ha ñe’ê ohechaukáva táva heko ymáva, ñande ypykue ha	Umi tekopykuaa ha ñe’ê ohechaukáva táva heko ymáva, ñande ypykue ha	NOCHANGE
Ombyaty hembi’urã.	Ombyaty hembi’urã.	NOCHANGE
Oaproba terã odesecha umi ñe’ẽ me’ẽ tetã ambue, ha umi ojejapo va’ekue ambue tetãmini	Oaproba terã odesecha umi ñe’ẽ me’ẽ tetã ambue, ha umi ojejapo va’ekue ambue tetãmini	NOCHANGE
Péicha aipotamo ko’ẽrõ ára umi pytũhare	Péicha aipotamo ko’ẽrõ ára umi pytũhare	NOCHANGE
Ko ñe’ã yvyra nde perẽrĩva	Ko ñe’ã yvyra nde perẽrĩva	NOCHANGE
Ko aretépe roñembyatýta óga guasúpe.	Ko aretépe roñembyatýta óga guasúpe.	NOCHANGE
Omonguoeéva tetãygua voi ha ijahápe maymáva,	Omonguoeéva tetãygua voi ha ijahápe maymáva,	NOCHANGE
Mba’e oikóva..	Mba’e oikóva..	NOCHANGE
Avañe’ẽ hyakuã porãmba ñane retãre	Avañe’ẽ hyakuã porãmba ñane retãre	NOCHANGE
Opurahéiva tetãvore joapykuéra pegua	Opurahéiva tetãvore joapykuéra pegua	NOCHANGE
Nde reporoocuaita jupi vae rupi.	Nde reporoocuaita jupi vae rupi.	NOCHANGE
Ha ojeréva’erã ndaipóri	Ha ojeréva’erã ndaipóri	NOCHANGE
Ykuéra ojajái isarambipa-pe, iporã ha hyapu puku	Ykuéra ojajái isarambipa-pe, iporã ha hyapu puku	NOCHANGE
Mombe’upy, káso ñemombe’u, ñe’ẽnga ha hetaiteve mba’e.	Mombe’upy, káso ñemombe’u, ñe’ẽnga ha hetaiteve mba’e.	NOCHANGE
Mbeguekatúpe ojepysyrõva hasypeve ñane retã ijojaha’ỹva	Mbeguekatúpe ojepysyrõva hasypeve ñane retã ijojaha’ỹva	NOCHANGE
Ñehenói ha ñe’ẽha	Ñehenói ha ñe’ẽha	NOCHANGE
Tupãretã paraguay	Tupãretã paraguay	NOCHANGE
Nda ha’éi chévente rembovy’áva	Nda ha’éi chévente rembovy’áva	NOCHANGE
Kuarahy ha pirapire rehe ndaipóri yvypóra omaña aréva.	Kuarahy ha pirapire rehe ndaipóri yvypóra omaña aréva.	NOCHANGE
Heta tembiapo porã hyãkuãta	Heta tembiapo porã hyãkuãta	NOCHANGE
Jesu’ýre, che ndaikosevéi.	Jesu’ýre, che ndaikosevéi.	NOCHANGE
Hi’ãgui upépe aimévo ambogue che mba’ey’uhéi.	Hi’ãgui upépe aimévo ambogue che mba’ey’uhéi.	NOCHANGE
Ha’ekuéra ojosojey oñandujey	Ha’ekuéra ojosojey oñandujey	NOCHANGE
Ome’ẽ permiso ojejapo haguã tembiapo guasu opáva peguarã tetãminíme oñekotevẽva.	Ome’ẽ permiso ojejapo haguã tembiapo guasu opáva peguarã tetãminíme oñekotevẽva.	NOCHANGE
Jepérõ upéicha nomombe’úikuri mavavetépe. oguerokirirĩnte hikuái.	Jepérõ upéicha nomombe’úikuri mavavetépe. oguerokirirĩnte hikuái.	NOCHANGE
Ñande ã ñambohokyva’erã avei ko	Ñande ã ñambohokyva’erã avei ko	NOCHANGE
Tekojoja ndaha’ei ambue mba’e pe imbaretevéva jejuporã	Tekojoja ndaha’ei ambue mba’e pe imbaretevéva jejuporã	NOCHANGE
Ñande jajapo ichupe.	Ñande jajapo ichupe.	NOCHANGE
Joayhu ha mba’aporã.	Joayhu ha mba’aporã.	NOCHANGE
Anive jaheja oiko ã mba’e vaiete ñane avañe’ẽre.	Anive jaheja oiko ã mba’e vaiete ñane avañe’ẽre.	NOCHANGE
Michínte jepépa ndaivevuivéi che mba’embyasy.	Michínte jepépa ndaivevuivéi che mba’embyasy.	NOCHANGE
Mbo’ehára ojetyvyróma ñane retãpýre techapyrã.	Mbo’ehára ojetyvyróma ñane retãpýre techapyrã.	NOCHANGE
Peteĩ karia’y marangatu	Peteĩ karia’y marangatu	NOCHANGE
Ha ojejapóva oku’eva’erãha tetã ñe’ẽ	Ha ojejapóva oku’eva’erãha tetã ñe’ẽ	NOCHANGE
Kuéra ojeruréva, mba’eveichavérõ ndikatúi oñenega ichupekuéra.	Kuéra ojeruréva, mba’eveichavérõ ndikatúi oñenega ichupekuéra.	NOCHANGE
Che kéra yvoty guasu.	Che kéra yvoty guasu.	NOCHANGE
Kuña oho távape. karai tito ojapo ajaka.	Kuña oho távape. karai tito ojapo ajaka.	NOCHANGE
Ha, peteĩ karai,	Ha, peteĩ karai,	NOCHANGE
- mba’éichaiko re’úta arasa upépe, pévango guapo’y.	- mba’éichaiko re’úta arasa upépe, pévango guapo’y.	NOCHANGE
Toúna ñe’ẽ,	Toúna ñe’ẽ,	NOCHANGE
Temimbo’e ikatupyryveva’ekue mbo’esyry kuaa’ypýpe	Temimbo’e ikatupyryveva’ekue mbo’esyry kuaa’ypýpe	NOCHANGE
Mitã, mitã’i	Mitã, mitã’i	NOCHANGE
Pahápe umi apañuãi ñemyatyrõ, ýrõ katu oñemyesakã umi mba’e ñemimby.	Pahápe umi apañuãi ñemyatyrõ, ýrõ katu oñemyesakã umi mba’e ñemimby.	NOCHANGE
Upévare kéra ha’e peteĩ tembiapo ojeguerokuhyjéva.	Upévare kéra ha’e peteĩ tembiapo ojeguerokuhyjéva.	NOCHANGE
Péina ápeve che ñe’ë. aguyjetaite pecherendu rehe. aguyje.	Péina ápeve che ñe’ë. aguyjetaite pecherendu rehe. aguyje.	NOCHANGE
Ha ani orerejátei roñepy’ara’ã,	Ha ani orerejátei roñepy’ara’ã,	NOCHANGE
Karia’y, kuñatãi, mitã rusu ha kakuaa,	Karia’y, kuñatãi, mitã rusu ha kakuaa,	NOCHANGE
Ava ñe’ẽ ñemopu’ãrã	Ava ñe’ẽ ñemopu’ãrã	NOCHANGE
Ore táva rérape roiméva ha ore táva pu’aka roguerekóva,	Ore táva rérape roiméva ha ore táva pu’aka roguerekóva,	NOCHANGE
Aníke ikangy, aníke ogue ñane ñe’ ê ypy.	Aníke ikangy, aníke ogue ñane ñe’ ê ypy.	NOCHANGE
Anítei maymáva ojesape’a.	Anítei maymáva ojesape’a.	NOCHANGE
Umi oikóva ko távape omba’apove kokuépe ha avei mymba ñemongakuaápe.	Umi oikóva ko távape omba’apove kokuépe ha avei mymba ñemongakuaápe.	NOCHANGE
Ha upépe ku ñaguáhẽ,	Ha upépe ku ñaguáhẽ,	NOCHANGE
Umi táva rehegua	Umi táva rehegua	NOCHANGE
Ñande kuéra paraguay hese ñanemandu’a	Ñande kuéra paraguay hese ñanemandu’a	NOCHANGE
Ndive, ñanohẽ marandu puhoe ha kuatiahaipyre rupive. jajoaju ha ñañe’ẽ opaichagua	Ndive, ñanohẽ marandu puhoe ha kuatiahaipyre rupive. jajoaju ha ñañe’ẽ opaichagua	NOCHANGE
Heta ñe’ẽ ñarõ oisu’u ñane ñe’ẽme	Heta ñe’ẽ ñarõ oisu’u ñane ñe’ẽme	NOCHANGE
Mombe’uregua. (narrativo) oiko umi jehupyre ñembohysýire.	Mombe’uregua. (narrativo) oiko umi jehupyre ñembohysýire.	NOCHANGE
Ñemby, paraguay	Ñemby, paraguay	NOCHANGE
Ndaha’eivoínte mba’eve. ndahi’aréi, ñane retâme, ojejaheijeýma hesekuéra,	Ndaha’eivoínte mba’eve. ndahi’aréi, ñane retâme, ojejaheijeýma hesekuéra,	NOCHANGE
Mba’éicha rupípa ko che mitãhápe aiko añembyasy	Mba’éicha rupípa ko che mitãhápe aiko añembyasy	NOCHANGE
Atýra róga mba’éichapa	Atýra róga mba’éichapa	NOCHANGE
Ñanembopy’ajere ha ñanembohye.	Ñanembopy’ajere ha ñanembohye.	NOCHANGE
Opáichagua mba’asy ombohasykuéva karu ha ñemboy’u.	Opáichagua mba’asy ombohasykuéva karu ha ñemboy’u.	NOCHANGE
Oñangareko ménare osẽvove guatahápe, ogueraha tembipurukuéra ha membykuéra.	Oñangareko ménare osẽvove guatahápe, ogueraha tembipurukuéra ha membykuéra.	NOCHANGE
Omoingove ha ombovy’áva	Omoingove ha ombovy’áva	NOCHANGE
Ha katu oime heta ñemity pora che kokuépe,	Ha katu oime heta ñemity pora che kokuépe,	NOCHANGE
Néike mitãnguéra jaha mbo’ehaópe	Néike mitãnguéra jaha mbo’ehaópe	NOCHANGE
Ha’ekuéra omombe’u	Ha’ekuéra omombe’u	NOCHANGE
Peteĩ ryguasu ha’e tembiporu oipurúva peteĩ tupi’a ojapohaguã ambue tupi’a	Peteĩ ryguasu ha’e tembiporu oipurúva peteĩ tupi’a ojapohaguã ambue tupi’a	NOCHANGE
Tee peteĩva.	Tee peteĩva.	NOCHANGE
Imba’e porãite, ñande mbovy’ase	Imba’e porãite, ñande mbovy’ase	NOCHANGE
Ha’eha peteĩ ñe’ẽ komunidapegua, oipurúvo	Ha’eha peteĩ ñe’ẽ komunidapegua, oipurúvo	NOCHANGE
Mba’apo ñeha’ãme maymáva	Mba’apo ñeha’ãme maymáva	NOCHANGE
Upéva rehe.	Upéva rehe.	NOCHANGE
Ojeporavóva corte-pe guarã	Ojeporavóva corte-pe guarã	NOCHANGE
Ñaimo’ã ndéve guarãnte ñandejára oity ko’ẽ.	Ñaimo’ã ndéve guarãnte ñandejára oity ko’ẽ.	NOCHANGE
Noñeme’ẽi va’erã ichupekuéra.	Noñeme’ẽi va’erã ichupekuéra.	NOCHANGE
. hese ojepyaha yvyra rogue, ñandu renimbo.	. hese ojepyaha yvyra rogue, ñandu renimbo.	NOCHANGE
Kirirĩme ha’eñónte, omyasaĩ ñe’ãpopópe	Kirirĩme ha’eñónte, omyasaĩ ñe’ãpopópe	NOCHANGE
Ojeporekarõguare, mba’éichapa	Ojeporekarõguare, mba’éichapa	NOCHANGE
Ndaipóri yvytykuéra ijyvatetéva, peteĩmínte oĩ ijyvatemivéva opytáva sur gotyo ko tetãvorépe, ha kóva oikuaa cerrito-pe.	Ndaipóri yvytykuéra ijyvatetéva, peteĩmínte oĩ ijyvatemivéva opytáva sur gotyo ko tetãvorépe, ha kóva oikuaa cerrito-pe.	NOCHANGE
Ha péina yvytu pepo	Ha péina yvytu pepo	NOCHANGE
Umi ñembosaraipavẽ kora kuéra.	Umi ñembosaraipavẽ kora kuéra.	NOCHANGE
Opyta mba’e ojehuva’ekue rapykuére. havia rastro do ocorrido.	Opyta mba’e ojehuva’ekue rapykuére. havia rastro do ocorrido.	NOCHANGE
Ko che purahéipe hi’ãite amombáy paraguái porãme	Ko che purahéipe hi’ãite amombáy paraguái porãme	NOCHANGE
Jerovia’ỹ ñe’ẽkuérare ombyai’ive jeroviapy raságui	Jerovia’ỹ ñe’ẽkuérare ombyai’ive jeroviapy raságui	NOCHANGE
Ñamoingovemínga ñande avañe’ê.	Ñamoingovemínga ñande avañe’ê.	NOCHANGE
Ñane ñe’ãme ñambo poty	Ñane ñe’ãme ñambo poty	NOCHANGE
Ojupi ha oguejy osapukái jeyjeývo chupe.	Ojupi ha oguejy osapukái jeyjeývo chupe.	NOCHANGE
Omoha’angaporãitereígui, ojehechakuaa mymbakuéra rague ha mba’e.	Omoha’angaporãitereígui, ojehechakuaa mymbakuéra rague ha mba’e.	NOCHANGE
Panambi rapykuéri.	Panambi rapykuéri.	NOCHANGE
Ñembosarái rehegua.	Ñembosarái rehegua.	NOCHANGE
Peteĩ karai po’i oike ka’aguýpe ha	Peteĩ karai po’i oike ka’aguýpe ha	NOCHANGE
Ha’e chupekuéra tokirirĩ.	Ha’e chupekuéra tokirirĩ.	NOCHANGE
Rehegua. oĩ avei omombe’úva mba’éichapa heñóikuri tavakuéra, ỹramo oñe’ẽva	Rehegua. oĩ avei omombe’úva mba’éichapa heñóikuri tavakuéra, ỹramo oñe’ẽva	NOCHANGE
Oĩ óga yvate ha tuichava	Oĩ óga yvate ha tuichava	NOCHANGE
Ko’ápe oiko avei nde ru.	Ko’ápe oiko avei nde ru.	NOCHANGE
Ha oguereko porundy ary.	Ha oguereko porundy ary.	NOCHANGE
Omoiruvo chupe, omanoite peve...he’i maymávape araka’evéma ndoumo’ãiha upégui.	Omoiruvo chupe, omanoite peve...he’i maymávape araka’evéma ndoumo’ãiha upégui.	NOCHANGE
Hi’ânteiko’êmo he’i ñandejára	Hi’ânteiko’êmo he’i ñandejára	NOCHANGE
Temimbo’e ohayhúva hetâ, itáva ha itáva ñemoñarépe	Temimbo’e ohayhúva hetâ, itáva ha itáva ñemoñarépe	NOCHANGE
Pe ñuatindy rupi ñu ka’aguýre ne muñahápe	Pe ñuatindy rupi ñu ka’aguýre ne muñahápe	NOCHANGE
Tavaguasu ojeaho’i reboso ñembyasýpe ha itindy, okirirĩ. ha’ete ku hasẽva kirirĩháme, tesay’ỹme. ikatu te’onguety voi ra’e.	Tavaguasu ojeaho’i reboso ñembyasýpe ha itindy, okirirĩ. ha’ete ku hasẽva kirirĩháme, tesay’ỹme. ikatu te’onguety voi ra’e.	NOCHANGE
Tapichápe. oñemohu’ãvo ko tembiapo	Tapichápe. oñemohu’ãvo ko tembiapo	NOCHANGE
Péina tavy pohãnohára ñane avañe’ẽme jaguerekóma	Péina tavy pohãnohára ñane avañe’ẽme jaguerekóma	NOCHANGE
. torypápe omboy’úva he’ẽvéva eirete.	. torypápe omboy’úva he’ẽvéva eirete.	NOCHANGE
Pe techakuaa, ñepysyrõ, jehechauka ha ñeñangareko umi arandu yma	Pe techakuaa, ñepysyrõ, jehechauka ha ñeñangareko umi arandu yma	NOCHANGE
Ja’úta ñandypa rogue ka’agýpe.	Ja’úta ñandypa rogue ka’agýpe.	NOCHANGE
Mborayhu mba’epota.	Mborayhu mba’epota.	NOCHANGE
Ijaruru, ñeimo’ã ambu’a.	Ijaruru, ñeimo’ã ambu’a.	NOCHANGE
Ohai avei kuatiahaipyrépe térã ñomongetarãme.	Ohai avei kuatiahaipyrépe térã ñomongetarãme.	NOCHANGE
Ha mitãnguéra opuka.	Ha mitãnguéra opuka.	NOCHANGE
Ha hembireko oñenomahína avei pe tupápe, ambue yke gotyo.	Ha hembireko oñenomahína avei pe tupápe, ambue yke gotyo.	NOCHANGE
Tupã ore ru yvága ha yvy apohare	Tupã ore ru yvága ha yvy apohare	NOCHANGE
Ñembo’e pa’iruvichakuéra ñane retâmegua oipotáva oñeñembo’e	Ñembo’e pa’iruvichakuéra ñane retâmegua oipotáva oñeñembo’e	NOCHANGE
Aguyje che angiru ñande ru tanderovasa ha tome’ê ndéve tesãi ha po’a.	Aguyje che angiru ñande ru tanderovasa ha tome’ê ndéve tesãi ha po’a.	NOCHANGE
Upe ne ñe’ẽ ahypýi ysapýpe	Upe ne ñe’ẽ ahypýi ysapýpe	NOCHANGE
Peteĩ mykũpopo ha imemby.	Peteĩ mykũpopo ha imemby.	NOCHANGE
Mayma mbo’ehára ojapo umi mba’e iporãitereirasáva	Mayma mbo’ehára ojapo umi mba’e iporãitereirasáva	NOCHANGE
Oñepyrũ ára pyahu	Oñepyrũ ára pyahu	NOCHANGE
Upépe oñemohenda pavẽ.	Upépe oñemohenda pavẽ.	NOCHANGE
Omymbajukáta ha oñorãirõta jave hikuái oipuru hu’y ha yvyra pehẽngue hatãva. pe arco sã ojejapo guasu pirégui.	Omymbajukáta ha oñorãirõta jave hikuái oipuru hu’y ha yvyra pehẽngue hatãva. pe arco sã ojejapo guasu pirégui.	NOCHANGE
Ñe’ẽpoty ha purahéi	Ñe’ẽpoty ha purahéi	NOCHANGE
Paraguay pyahu ha iñarandúva jaipurumanteva’erâ ñane avañe’ê opaite hendápe ha	Paraguay pyahu ha iñarandúva jaipurumanteva’erâ ñane avañe’ê opaite hendápe ha	NOCHANGE
Ayoreo katuete ho’u oĩva guive ka’aguýpe, yva ha ka’avokuéra apytépe oipuru hikuéi mbohapypa rupi.	Ayoreo katuete ho’u oĩva guive ka’aguýpe, yva ha ka’avokuéra apytépe oipuru hikuéi mbohapypa rupi.	NOCHANGE
Hatãite ko che ñe’ãme	Hatãite ko che ñe’ãme	NOCHANGE
Opaite mba’e apóre oñehepyme’ẽva’erã hekopete.	Opaite mba’e apóre oñehepyme’ẽva’erã hekopete.	NOCHANGE
Ko aty mba’erepyme’ẽ ojejapo mymbajuka, pira jeikutu ha yva ñemono’õgui.	Ko aty mba’erepyme’ẽ ojejapo mymbajuka, pira jeikutu ha yva ñemono’õgui.	NOCHANGE
Mitâ’ikuéra mbo’ehao marangatupegua	Mitâ’ikuéra mbo’ehao marangatupegua	NOCHANGE
Opava ñe’ẽguera ha’evaekue peteĩ jey ñe’ẽpyahu	Opava ñe’ẽguera ha’evaekue peteĩ jey ñe’ẽpyahu	NOCHANGE
Ha opurahéi kuaáva oiko rei...	Ha opurahéi kuaáva oiko rei...	NOCHANGE
Ko ñande yvy	Ko ñande yvy	NOCHANGE
Topuraheimi (ha’ekuéra) toñemumi (ha’ekuéra)	Topuraheimi (ha’ekuéra) toñemumi (ha’ekuéra)	NOCHANGE
Tetã paraguái, héra teépe oñembyatỹva rupive tetã	Tetã paraguái, héra teépe oñembyatỹva rupive tetã	NOCHANGE
Che ñe’ãgui ñemboasy	Che ñe’ãgui ñemboasy	NOCHANGE
Táva henda porã.	Táva henda porã.	NOCHANGE
Mba’e ha’e virurenda ñemonda ñambojojarõ imoypyre	Mba’e ha’e virurenda ñemonda ñambojojarõ imoypyre	NOCHANGE
Ha ñane moñorãirõ.	Ha ñane moñorãirõ.	NOCHANGE
Tetãvore paraguarí	Tetãvore paraguarí	NOCHANGE
Ndaipori mba’e hasyvéva juruhe’ẽgui ñemohatã	Ndaipori mba’e hasyvéva juruhe’ẽgui ñemohatã	NOCHANGE
He’ise oĩmeháma ñane retãme ko ko’ẽ soro.	He’ise oĩmeháma ñane retãme ko ko’ẽ soro.	NOCHANGE
Hasy ndejapu’ỹhaguã nde kuaapyetá ramo. ha’ete ku nderekoajese ramo ne mba’epotava jave	Hasy ndejapu’ỹhaguã nde kuaapyetá ramo. ha’ete ku nderekoajese ramo ne mba’epotava jave	NOCHANGE
He’ẽ asyvéva aipyte haguã.	He’ẽ asyvéva aipyte haguã.	NOCHANGE
Upérõ oikovéne purahéi ava ñe’ê, ha oguéne chokokue y’uhéi.	Upérõ oikovéne purahéi ava ñe’ê, ha oguéne chokokue y’uhéi.	NOCHANGE
Arokañymandi haguã.	Arokañymandi haguã.	NOCHANGE
Mba’aporasýpe tape rehe’ỹme hetave mbykýpe ndaipo’iete.	Mba’aporasýpe tape rehe’ỹme hetave mbykýpe ndaipo’iete.	NOCHANGE
Hakã ru’ãre otitihápe guyra yuhéi.	Hakã ru’ãre otitihápe guyra yuhéi.	NOCHANGE
Sediciosa ojerereko va’erã mba’evetérõ.	Sediciosa ojerereko va’erã mba’evetérõ.	NOCHANGE
Mbo’eharakuéra opaite hendápe, ojepepy ñe’ẽngatu rupive omyesakã ko’ã apañuãigua’u oñemoingéva ñande rapichakuéra akãme.	Mbo’eharakuéra opaite hendápe, ojepepy ñe’ẽngatu rupive omyesakã ko’ã apañuãigua’u oñemoingéva ñande rapichakuéra akãme.	NOCHANGE
Ojerembytévo. (centrípeto) opa mba’e oĩva mombe’urã ryepýpe ojekopa upe ñe’ẽchaukapy rehe.	Ojerembytévo. (centrípeto) opa mba’e oĩva mombe’urã ryepýpe ojekopa upe ñe’ẽchaukapy rehe.	NOCHANGE
Umi irundy kuimba’e iñapysê, pyhare aho’ípe, ñembo’yhápe, tovasýpe, jepytasópe.	Umi irundy kuimba’e iñapysê, pyhare aho’ípe, ñembo’yhápe, tovasýpe, jepytasópe.	NOCHANGE
Pende ru kokuépe ohova’erã	Pende ru kokuépe ohova’erã	NOCHANGE
Ne ñe’ẽ mbeguekatu	Ne ñe’ẽ mbeguekatu	NOCHANGE
Jahypýi ñane ñe’ẽ,	Jahypýi ñane ñe’ẽ,	NOCHANGE
He’iséva mbayru vakapiguigua, ovechapire térâ ambue mba’éguigua isâ ha oñembotyháva, ojeporúva ojeguraha haguâ ao aty.	He’iséva mbayru vakapiguigua, ovechapire térâ ambue mba’éguigua isâ ha oñembotyháva, ojeporúva ojeguraha haguâ ao aty.	NOCHANGE
- ha nde ao hu mbukuguasu ha ne akã perõ niko -he’i kirikiri.	- ha nde ao hu mbukuguasu ha ne akã perõ niko -he’i kirikiri.	NOCHANGE
Ha nde ári ojeroky	Ha nde ári ojeroky	NOCHANGE
Ome’ẽ haguére chéve	Ome’ẽ haguére chéve	NOCHANGE
Mba’éichapa, che réra tyra.	Mba’éichapa, che réra tyra.	NOCHANGE
Peteĩ yvoty pyahu	Peteĩ yvoty pyahu	NOCHANGE
Tapỹimíme yvytu piro’y apytépe kuña porã che mbovy’ava.	Tapỹimíme yvytu piro’y apytépe kuña porã che mbovy’ava.	NOCHANGE
Teroñe’ẽ oñembojoja ñe’ẽtéva ndive avaite ha papapy ñe’ẽpehẽtai rupive.	Teroñe’ẽ oñembojoja ñe’ẽtéva ndive avaite ha papapy ñe’ẽpehẽtai rupive.	NOCHANGE
Nde rehe ama’ẽrõ chemo’ãngaipáva,	Nde rehe ama’ẽrõ chemo’ãngaipáva,	NOCHANGE
Ne ñe’ẽ ajhendúramo ko arapýpe	Ne ñe’ẽ ajhendúramo ko arapýpe	NOCHANGE
Ko’âva ndaijoytávai, he’íje ñati’û mokitéro guýpe.	Ko’âva ndaijoytávai, he’íje ñati’û mokitéro guýpe.	NOCHANGE
Iporã. ha nde. mba’éichapa reiko.	Iporã. ha nde. mba’éichapa reiko.	NOCHANGE
Ha ombo’ypi omokã uhéi, kane’õ ñande rekove	Ha ombo’ypi omokã uhéi, kane’õ ñande rekove	NOCHANGE
Po’a ha tesãi tome’ẽ chupe.	Po’a ha tesãi tome’ẽ chupe.	NOCHANGE
. ha pe ñúre guyrakuéra rehendúmane oñe’ẽva	. ha pe ñúre guyrakuéra rehendúmane oñe’ẽva	NOCHANGE
A- ko aty oñeha’ãta ombohape ñe’ẽ rembiapo rehegua, tojejapo jekupytýpe, ñe’ẽasa ha he’iséva.	A- ko aty oñeha’ãta ombohape ñe’ẽ rembiapo rehegua, tojejapo jekupytýpe, ñe’ẽasa ha he’iséva.	NOCHANGE
Ndaipóri pa’ã ojoko va’erã chupekuéra ojekuaa porã	Ndaipóri pa’ã ojoko va’erã chupekuéra ojekuaa porã	NOCHANGE
Tetãme ojeráva, ha ñe’ãme oiko.	Tetãme ojeráva, ha ñe’ãme oiko.	NOCHANGE
Jha magmá ko tava yvy-pe, omba’apova ocarayguava	Jha magmá ko tava yvy-pe, omba’apova ocarayguava	NOCHANGE
Ojeguereko va’erãha pe tekopykuaa jeporu ha jeguerovy’a derecho	Ojeguereko va’erãha pe tekopykuaa jeporu ha jeguerovy’a derecho	NOCHANGE
Oñe’ẽ mbegue chive hembirekópe	Oñe’ẽ mbegue chive hembirekópe	NOCHANGE
Ndivéi, ha upérõ umi táva osancionáne terã omyatyrõne icárta orgánica kuéra, sapy’a oikotevẽrõ,	Ndivéi, ha upérõ umi táva osancionáne terã omyatyrõne icárta orgánica kuéra, sapy’a oikotevẽrõ,	NOCHANGE
Opa rupi rejuhúta heta imbokóva	Opa rupi rejuhúta heta imbokóva	NOCHANGE
Ko’agã, ko karai pytyvõ rupive, ikatu ojuecha ha oñuañuã ko’ã tapicha, arete rire.	Ko’agã, ko karai pytyvõ rupive, ikatu ojuecha ha oñuañuã ko’ã tapicha, arete rire.	NOCHANGE
Ñu, ka’aguy, yvyty rupi	Ñu, ka’aguy, yvyty rupi	NOCHANGE
Paraguay (tetã paraguái)	Paraguay (tetã paraguái)	NOCHANGE
(oñemotenonde ohóvo tembiapokuéra ka’aguy’oapo rehegua)	(oñemotenonde ohóvo tembiapokuéra ka’aguy’oapo rehegua)	NOCHANGE
Kuña hekoviave’yva’erã chéve	Kuña hekoviave’yva’erã chéve	NOCHANGE
Hyãsia pegua	Hyãsia pegua	NOCHANGE
Ha oñemomba’eguasútanteva tapicha	Ha oñemomba’eguasútanteva tapicha	NOCHANGE
Porã oipytyvõ kuñakuérape kuimba’ekuéra ohayhuhaguã chupekuéra, tovatavy katu ohayhuhaguã kuimba’ekuérape	Porã oipytyvõ kuñakuérape kuimba’ekuéra ohayhuhaguã chupekuéra, tovatavy katu ohayhuhaguã kuimba’ekuérape	NOCHANGE
Michĩ aja ojehero mitãkuña, mitãkuña’i. oiko ituvakuéra ndive, oñeñangarekóva hese.	Michĩ aja ojehero mitãkuña, mitãkuña’i. oiko ituvakuéra ndive, oñeñangarekóva hese.	NOCHANGE
Ha’ekuéra omba’ejuka omba’emondýi	Ha’ekuéra omba’ejuka omba’emondýi	NOCHANGE
Ne ñemoñare oikóva arasême, kuarahy osêha gotyo.	Ne ñemoñare oikóva arasême, kuarahy osêha gotyo.	NOCHANGE
Ndaipóri ndopáiva ko yvy ape ári.	Ndaipóri ndopáiva ko yvy ape ári.	NOCHANGE
Angirũkuéra ha’e umi yvypórakuéra ikatuha ndive nde reko porã	Angirũkuéra ha’e umi yvypórakuéra ikatuha ndive nde reko porã	NOCHANGE
Upe ñu ha ijere	Upe ñu ha ijere	NOCHANGE
Manu, imitãrusúpe, heta ára oguata ka’aguy pa’ũre iñirũnguérandi. iñirũnguéra opurahéi ojesareko mymbáre ha manu umi guyra purahéire.	Manu, imitãrusúpe, heta ára oguata ka’aguy pa’ũre iñirũnguérandi. iñirũnguéra opurahéi ojesareko mymbáre ha manu umi guyra purahéire.	NOCHANGE
Karai mba’e guasuetente oguerekova.	Karai mba’e guasuetente oguerekova.	NOCHANGE
. he’ẽ asyetéva ñane ava ñe’ẽ.	. he’ẽ asyetéva ñane ava ñe’ẽ.	NOCHANGE
Oĩ ha ojepuru guarani ñe’ẽ paraguáipe,	Oĩ ha ojepuru guarani ñe’ẽ paraguáipe,	NOCHANGE
Ikatu nga’u ko’ẽ sapy’ante ha ñane retã	Ikatu nga’u ko’ẽ sapy’ante ha ñane retã	NOCHANGE
Avañe’ẽkuaahára ojapo umi mba’e iporãitereirasáva	Avañe’ẽkuaahára ojapo umi mba’e iporãitereirasáva	NOCHANGE
Ama omohe’õ porã yvy.	Ama omohe’õ porã yvy.	NOCHANGE
Che ñe’ãme aipeju	Che ñe’ãme aipeju	NOCHANGE
Mitãkuera ojuhu opa mba’e mba’evépe, ha kakuaáva katu ndotopai mba’eve opa mba’epe	Mitãkuera ojuhu opa mba’e mba’evépe, ha kakuaáva katu ndotopai mba’eve opa mba’epe	NOCHANGE
Che yakã porã repupu satĩva yvyty pa’ũgui,	Che yakã porã repupu satĩva yvyty pa’ũgui,	NOCHANGE
Ñahenduramo oñe’ẽ	Ñahenduramo oñe’ẽ	NOCHANGE
Ñe’ẽ estado rembiapópe.	Ñe’ẽ estado rembiapópe.	NOCHANGE
Ha yvytúre amyasâi...	Ha yvytúre amyasâi...	NOCHANGE
Neko’êjeýre ko árape, e’aguyjeme’ê	Neko’êjeýre ko árape, e’aguyjeme’ê	NOCHANGE
Ñane ñe’ẽ porãite	Ñane ñe’ẽ porãite	NOCHANGE
. ikatuve’ỹva máramo hesãi roheja guive.	. ikatuve’ỹva máramo hesãi roheja guive.	NOCHANGE
Orehegui oikova’ekue	Orehegui oikova’ekue	NOCHANGE
Ojogua umi anguja’ípe	Ojogua umi anguja’ípe	NOCHANGE
Ndajahechai mba’ekuéra ha’ehaícha, térã ñande ha’ehaícha	Ndajahechai mba’ekuéra ha’ehaícha, térã ñande ha’ehaícha	NOCHANGE
Pukavy ha tetia’épe	Pukavy ha tetia’épe	NOCHANGE
Pytãgua kuéra poguýpe.	Pytãgua kuéra poguýpe.	NOCHANGE
Tembi’ukuéra	Tembi’ukuéra	NOCHANGE
Mbo’ehára ome’êjey chéve che rembiapokue.	Mbo’ehára ome’êjey chéve che rembiapokue.	NOCHANGE
Me guarépe ojejapyhyha tetã ñe’ẽ teéramo	Me guarépe ojejapyhyha tetã ñe’ẽ teéramo	NOCHANGE
Tapichakuéra oikóva	Tapichakuéra oikóva	NOCHANGE
- tojepy’amongeta pypukuve, toñemokyre’ỹ ha hesuita kuéra rembiapo paraguai retãme.	- tojepy’amongeta pypukuve, toñemokyre’ỹ ha hesuita kuéra rembiapo paraguai retãme.	NOCHANGE
Tetã paraguái (guarani)	Tetã paraguái (guarani)	NOCHANGE
Néira, oreko ohasa haguã arte rehe oikóve haguã, ndoikuaái mba’épa	Néira, oreko ohasa haguã arte rehe oikóve haguã, ndoikuaái mba’épa	NOCHANGE
Ndikatúi ojapo aigue hapicháre omba’apóva hendive. ndapéicharõ hembiapo aigue tuicha.	Ndikatúi ojapo aigue hapicháre omba’apóva hendive. ndapéicharõ hembiapo aigue tuicha.	NOCHANGE
Retãnguéra apytépe.	Retãnguéra apytépe.	NOCHANGE
Ha oñeha’â hikuái oiko joaju, tesâi, mbarete ha vy’apavême	Ha oñeha’â hikuái oiko joaju, tesâi, mbarete ha vy’apavême	NOCHANGE
Iporãva’erã avei ojegueromandu’ami	Iporãva’erã avei ojegueromandu’ami	NOCHANGE
Umi pohâ ñana ojeporuvéva paraguáipe ha mba’épepa iporâ	Umi pohâ ñana ojeporuvéva paraguáipe ha mba’épepa iporâ	NOCHANGE
Ko óga kóa chemba’e teete.	Ko óga kóa chemba’e teete.	NOCHANGE
Ogaygua ñembohaperã	Ogaygua ñembohaperã	NOCHANGE
Cáceres-urbieta ohendukákuri purahéi ñanemba’éva	Cáceres-urbieta ohendukákuri purahéi ñanemba’éva	NOCHANGE
Tuicháva, areko hagua che kokuetee, guéi ha opa mba’e...	Tuicháva, areko hagua che kokuetee, guéi ha opa mba’e...	NOCHANGE
Ñemby - paraguay.	Ñemby - paraguay.	NOCHANGE
Tekotevẽ ñambo’eporã pukarã umi mitãme ha umi mitãrusúpe, ñane retã heta oikotevẽta pukarã. aguyje.	Tekotevẽ ñambo’eporã pukarã umi mitãme ha umi mitãrusúpe, ñane retã heta oikotevẽta pukarã. aguyje.	NOCHANGE
Péicha oiko hikuái heta ára joayhu pórã, joayhu potĩme.	Péicha oiko hikuái heta ára joayhu pórã, joayhu potĩme.	NOCHANGE
Avave ndojapresái va’erã ndopagái haguére hembijogua.	Avave ndojapresái va’erã ndopagái haguére hembijogua.	NOCHANGE
Tetãvore joapykuéra pegua	Tetãvore joapykuéra pegua	NOCHANGE
Me (jaipurukuaáva ñe’ẽ tĩgua ndive)	Me (jaipurukuaáva ñe’ẽ tĩgua ndive)	NOCHANGE
Hasyhápe ñande pire ha oñepohano hagua tesa rasy.	Hasyhápe ñande pire ha oñepohano hagua tesa rasy.	NOCHANGE
He’iséva oúva ha ojáva peteĩ tendápe	He’iséva oúva ha ojáva peteĩ tendápe	NOCHANGE
Ñande po kuéra, ome’ê akanundu	Ñande po kuéra, ome’ê akanundu	NOCHANGE
Peteĩ tembi’u pyahu	Peteĩ tembi’u pyahu	NOCHANGE
Omotenonde reve, kerãi tuichague ñemboriko sundaro	Omotenonde reve, kerãi tuichague ñemboriko sundaro	NOCHANGE
Tupâo ha ñembo’épe	Tupâo ha ñembo’épe	NOCHANGE
Hi’upyra, upéicha nte avei.	Hi’upyra, upéicha nte avei.	NOCHANGE
Ojepuru oñepohano hagua tuguy kangy (sa’yju) ha py’a ndoiko porâiva (tye,	Ojepuru oñepohano hagua tuguy kangy (sa’yju) ha py’a ndoiko porâiva (tye,	NOCHANGE
Ko’ẽju sakãvo ñapu’ã varã	Ko’ẽju sakãvo ñapu’ã varã	NOCHANGE
Oñeñangareko porã va’erã opa kuña hyeguasúva rehe ha imemby kambu aja ha	Oñeñangareko porã va’erã opa kuña hyeguasúva rehe ha imemby kambu aja ha	NOCHANGE
Péina oguãhe chéve nde ñe’ẽpoty.	Péina oguãhe chéve nde ñe’ẽpoty.	NOCHANGE
Ha’e ñe’êjoajuita joajupyre omohendáva mba’éichapa	Ha’e ñe’êjoajuita joajupyre omohendáva mba’éichapa	NOCHANGE
Jaikóva ka’aguy ypype ñahendu urutau purahéi.	Jaikóva ka’aguy ypype ñahendu urutau purahéi.	NOCHANGE
Pũrũrũgui (tyapu oikóva ñande jurúpe ñamongu’írõ tembi’u atã).	Pũrũrũgui (tyapu oikóva ñande jurúpe ñamongu’írõ tembi’u atã).	NOCHANGE
Karai tera sykuéra, ha oiméva mita pyahu,	Karai tera sykuéra, ha oiméva mita pyahu,	NOCHANGE
Mba’éichapa ikatu oñembohape	Mba’éichapa ikatu oñembohape	NOCHANGE
Mbo’erã kapi’i guýpe	Mbo’erã kapi’i guýpe	NOCHANGE
Avei mba’ejave, térã mba’é ára jave.	Avei mba’ejave, térã mba’é ára jave.	NOCHANGE
... peteĩ che kompañéro de traváhope.	... peteĩ che kompañéro de traváhope.	NOCHANGE
Ambue guyra purahéi.	Ambue guyra purahéi.	NOCHANGE
Pyhare, ku ijapyra’ỹva	Pyhare, ku ijapyra’ỹva	NOCHANGE
Mba’e vai térã ombohekokatujeýva tapicha ojeharuva’ekuépe, ha ko’ãvape	Mba’e vai térã ombohekokatujeýva tapicha ojeharuva’ekuépe, ha ko’ãvape	NOCHANGE
Arandukuaa ha’e tembipuru oipurúva mbo’ehárakuéra ojapokatuĩhaguã mbo’ehárakuéra háma, ojapokatuĩvaerã mbo’ehárakuéra	Arandukuaa ha’e tembipuru oipurúva mbo’ehárakuéra ojapokatuĩhaguã mbo’ehárakuéra háma, ojapokatuĩvaerã mbo’ehárakuéra	NOCHANGE
Mba’éichapa mitã rusu oiko vaerã	Mba’éichapa mitã rusu oiko vaerã	NOCHANGE
Ñe’ẽ atýra guive kóicha meméva,	Ñe’ẽ atýra guive kóicha meméva,	NOCHANGE
Ha’e ohecha ko yvy ári ojehúva,	Ha’e ohecha ko yvy ári ojehúva,	NOCHANGE
Ko’aicha mba’éko mitá mboriahúpe rasa ombovy’áva,	Ko’aicha mba’éko mitá mboriahúpe rasa ombovy’áva,	NOCHANGE
Umi yrembe’ykuéra porã porã oñemyatyrõ kuri avei yguasu rembe’ýpe oñeñembosaraihagã opáichagua deporte ýpe oñeha’ãva.	Umi yrembe’ykuéra porã porã oñemyatyrõ kuri avei yguasu rembe’ýpe oñeñembosaraihagã opáichagua deporte ýpe oñeha’ãva.	NOCHANGE
Akã jeremi ko tetãre.	Akã jeremi ko tetãre.	NOCHANGE
Ñe’ẽ ha rekotee oñemombareteve	Ñe’ẽ ha rekotee oñemombareteve	NOCHANGE
Ojepyta ha mba’épepa ojeguevi	Ojepyta ha mba’épepa ojeguevi	NOCHANGE
Je’ejey ojehu tekotevẽramo ojepurujeyjey peteĩ ñe’ẽ hesakaporãve hagua pe oje’eséva.	Je’ejey ojehu tekotevẽramo ojepurujeyjey peteĩ ñe’ẽ hesakaporãve hagua pe oje’eséva.	NOCHANGE
Temimbo’e kuéra ojuhu hína internépe momarãnduha ha momarãndupy. ko’ã arýpe oĩ heta mbo’ehao oiporavo omba’apo tic reheve imbo’ekotýpe.	Temimbo’e kuéra ojuhu hína internépe momarãnduha ha momarãndupy. ko’ã arýpe oĩ heta mbo’ehao oiporavo omba’apo tic reheve imbo’ekotýpe.	NOCHANGE
Ani reipota, ha oikota nde hegui yvypóra imba’e hetavéva ko yvy ape ári	Ani reipota, ha oikota nde hegui yvypóra imba’e hetavéva ko yvy ape ári	NOCHANGE
Topa mboriahu ko yvy ári.	Topa mboriahu ko yvy ári.	NOCHANGE
Kuarahyresẽ aguĩgua	Kuarahyresẽ aguĩgua	NOCHANGE
Kuéra he’iháicha inciso tenondegua.	Kuéra he’iháicha inciso tenondegua.	NOCHANGE
Ñemyakã’i tenonde peguáicha.	Ñemyakã’i tenonde peguáicha.	NOCHANGE
. ko yvy ári jahasáva,	. ko yvy ári jahasáva,	NOCHANGE
Ha ára ha ára ojeruréva oréve	Ha ára ha ára ojeruréva oréve	NOCHANGE
Aregua ha’e peteĩ táva neporãmbajepéva oñangarekóva ogakuéra porã ymaite guare orekóva óga jereguasu iporãva.	Aregua ha’e peteĩ táva neporãmbajepéva oñangarekóva ogakuéra porã ymaite guare orekóva óga jereguasu iporãva.	NOCHANGE
Paraguaýpe ha upe ára guive opytu’úma ñane retãme.	Paraguaýpe ha upe ára guive opytu’úma ñane retãme.	NOCHANGE
Ha’ekuéra oguerovámi oñesũmi	Ha’ekuéra oguerovámi oñesũmi	NOCHANGE
Ndaikatupyrymo’ãiha hetã ñe’ẽ tee	Ndaikatupyrymo’ãiha hetã ñe’ẽ tee	NOCHANGE
Ãga ha ára romanohápe.	Ãga ha ára romanohápe.	NOCHANGE
Tembiapo imbaretevéva upépe ha’e mymba ñemongakuaa.	Tembiapo imbaretevéva upépe ha’e mymba ñemongakuaa.	NOCHANGE
Aguata’i ndaje kova’erã re	Aguata’i ndaje kova’erã re	NOCHANGE
Ñande ko ñande	Ñande ko ñande	NOCHANGE
Ohecha ha oñandu teko’asy ha poriahuverekópe ha péva omoheñói	Ohecha ha oñandu teko’asy ha poriahuverekópe ha péva omoheñói	NOCHANGE
Ka’akupépe tupãsy	Ka’akupépe tupãsy	NOCHANGE
Ne irũnguéra no’õmby rejuhúrõ sapy’a,	Ne irũnguéra no’õmby rejuhúrõ sapy’a,	NOCHANGE
Chavuku nomba’apóigui ndoguerekói hi’upyrã, upehaguére oñepyrũ omymbajukareipa, jepémo naiñembyahýi.	Chavuku nomba’apóigui ndoguerekói hi’upyrã, upehaguére oñepyrũ omymbajukareipa, jepémo naiñembyahýi.	NOCHANGE
Jaikóvo ha’éicha oñondivepa.	Jaikóvo ha’éicha oñondivepa.	NOCHANGE
Paraguáipe.	Paraguáipe.	NOCHANGE
Mba’apo araka’eve ndojapoiva’erã tembiguái avavégui.	Mba’apo araka’eve ndojapoiva’erã tembiguái avavégui.	NOCHANGE
Heñóivo ko’ẽ ñane retãpýre oikóma oguata,	Heñóivo ko’ẽ ñane retãpýre oikóma oguata,	NOCHANGE
Ha’éva sy, túva	Ha’éva sy, túva	NOCHANGE
Ñande jahypyiva’ekue ñamoirũva’ekue	Ñande jahypyiva’ekue ñamoirũva’ekue	NOCHANGE
Nhamoĩmba’i mavy, jaupi. ha’e ramigua py nhambo’a aguã ha’eve.	Nhamoĩmba’i mavy, jaupi. ha’e ramigua py nhambo’a aguã ha’eve.	NOCHANGE
Tatajuecha hi’ã hápe,	Tatajuecha hi’ã hápe,	NOCHANGE
Ñande ñe’ẽ eiretépe rombojoyvy purajhei,	Ñande ñe’ẽ eiretépe rombojoyvy purajhei,	NOCHANGE
Mburuvicha ojapo aiguéva ombohovái va’erã .	Mburuvicha ojapo aiguéva ombohovái va’erã .	NOCHANGE
Ohayhúre ñande yvy.	Ohayhúre ñande yvy.	NOCHANGE
Jagua ha paraguái itínova.	Jagua ha paraguái itínova.	NOCHANGE
Mburuvichakuéra ministerio-gua.	Mburuvichakuéra ministerio-gua.	NOCHANGE
Umi mba’ekuera arekova apytepe iporãveva, arekogueteri ñe’ê nda’eíva araka’eve.	Umi mba’ekuera arekova apytepe iporãveva, arekogueteri ñe’ê nda’eíva araka’eve.	NOCHANGE
Uperiremínte oho hendapekuéra iñangirû ra’y. ohechávo chupe, upe mitâ’i ojepete yvyre ha upéikatu ipojaipojái yvate.	Uperiremínte oho hendapekuéra iñangirû ra’y. ohechávo chupe, upe mitâ’i ojepete yvyre ha upéikatu ipojaipojái yvate.	NOCHANGE
Ñemotenonde, (aprovechar) nohê mba’e	Ñemotenonde, (aprovechar) nohê mba’e	NOCHANGE
Osẽ haguã tetãygua oikóva vida democrática ha convivencia humana-pe. upe tekombo’e	Osẽ haguã tetãygua oikóva vida democrática ha convivencia humana-pe. upe tekombo’e	NOCHANGE
Pehẽngue ome’ẽva ichupe mba’ekuaaita. oipurúva oguerokañy	Pehẽngue ome’ẽva ichupe mba’ekuaaita. oipurúva oguerokañy	NOCHANGE
Opyta ñande rehe.	Opyta ñande rehe.	NOCHANGE
Ojeroviáta tupã tapicha ha yvypóra rehe.	Ojeroviáta tupã tapicha ha yvypóra rehe.	NOCHANGE
Mba’e ikatúva tuicha ombyai	Mba’e ikatúva tuicha ombyai	NOCHANGE
Oĩgui óga porã.	Oĩgui óga porã.	NOCHANGE
Ha che, yguasu, che kerayvoty ñe’ẽyvotýpe guarã.	Ha che, yguasu, che kerayvoty ñe’ẽyvotýpe guarã.	NOCHANGE
Na eitymi po’ápe ko che rekove	Na eitymi po’ápe ko che rekove	NOCHANGE
. che ãnga kyrỹire ojejakutúma mandu’a kyse.	. che ãnga kyrỹire ojejakutúma mandu’a kyse.	NOCHANGE
Ko yvy tuichakue javeve	Ko yvy tuichakue javeve	NOCHANGE
Guaraniñe’ẽ chemopu’ãjey va’erã che ñe’ẽteete,	Guaraniñe’ẽ chemopu’ãjey va’erã che ñe’ẽteete,	NOCHANGE
Peteĩ díante voi.	Peteĩ díante voi.	NOCHANGE
Ko yvy ape ári	Ko yvy ape ári	NOCHANGE
Ha umi kaysã ruguáre ñahendu guyra ñe’ẽ.	Ha umi kaysã ruguáre ñahendu guyra ñe’ẽ.	NOCHANGE
Mitãkaria’ýpe ha’e... upe hetekue omoko’ẽukákuri hogami korapýpe. casiano	Mitãkaria’ýpe ha’e... upe hetekue omoko’ẽukákuri hogami korapýpe. casiano	NOCHANGE
Ha’ekuéra oryryietereirasa omomorãitereirasa	Ha’ekuéra oryryietereirasa omomorãitereirasa	NOCHANGE
Ñembo’e jeroky	Ñembo’e jeroky	NOCHANGE
Kuaapy, purahéi, temiandu,	Kuaapy, purahéi, temiandu,	NOCHANGE
Ñaimo’ã upéicha jave oñemondoróva	Ñaimo’ã upéicha jave oñemondoróva	NOCHANGE
Tetãminimegua, opyta ipoguýpe.	Tetãminimegua, opyta ipoguýpe.	NOCHANGE
Oñembohepypa umi so’o ko’aga.	Oñembohepypa umi so’o ko’aga.	NOCHANGE
Upégui mbohapy ko’ëme oje’ói jey hikuái. mba’eve nombopúi.	Upégui mbohapy ko’ëme oje’ói jey hikuái. mba’eve nombopúi.	NOCHANGE
Misiones tetãvore argentina-pe. itavusu hérava posadas.	Misiones tetãvore argentina-pe. itavusu hérava posadas.	NOCHANGE
Ñe’ẽ kuimba’e ha kuña oipurúva	Ñe’ẽ kuimba’e ha kuña oipurúva	NOCHANGE
Erekohaguere tekombo’e porã, ko árape ha’e peteĩ pa’ã, ne mboyke heta mba’egui	Erekohaguere tekombo’e porã, ko árape ha’e peteĩ pa’ã, ne mboyke heta mba’egui	NOCHANGE
Oñembota ápe ha pépe	Oñembota ápe ha pépe	NOCHANGE
Ojehekombo’e guaraníme tetã mba’apoharakuérape	Ojehekombo’e guaraníme tetã mba’apoharakuérape	NOCHANGE
Ko ñemohenda ojejapo iñe’ẽpehẽ retakua rupive.	Ko ñemohenda ojejapo iñe’ẽpehẽ retakua rupive.	NOCHANGE
Ka’aguy ha ñu porã ahechase katuínte,	Ka’aguy ha ñu porã ahechase katuínte,	NOCHANGE
Ha chupe oñemomba’éva	Ha chupe oñemomba’éva	NOCHANGE
Ambue tetãre oiko porã.	Ambue tetãre oiko porã.	NOCHANGE
Ojapo imba’erã	Ojapo imba’erã	NOCHANGE
Che ñe’ã angapýre rekororõ	Che ñe’ã angapýre rekororõ	NOCHANGE
Ñande ra’y jeayurã i	Ñande ra’y jeayurã i	NOCHANGE
Maymáva amo mombyry.	Maymáva amo mombyry.	NOCHANGE
Añemboheteve avañe’ẽme	Añemboheteve avañe’ẽme	NOCHANGE
Oñemondéva so’o ñemuhára aópe,	Oñemondéva so’o ñemuhára aópe,	NOCHANGE
Jahayhuva’erã ñande rapichápe	Jahayhuva’erã ñande rapichápe	NOCHANGE
Táva paraguaýpe	Táva paraguaýpe	NOCHANGE
Oñomoirũ jey tembiapópe uruguái ndive.	Oñomoirũ jey tembiapópe uruguái ndive.	NOCHANGE
Heñóiva’ekue aña retãgui	Heñóiva’ekue aña retãgui	NOCHANGE
Mbo’ehára oipuru itahai.	Mbo’ehára oipuru itahai.	NOCHANGE
Hesãkãvo ko’ẽtĩ	Hesãkãvo ko’ẽtĩ	NOCHANGE
Apurahéita ndéve ko che mba’e pota.	Apurahéita ndéve ko che mba’e pota.	NOCHANGE
Ha karai oiko ichugui kuéra.	Ha karai oiko ichugui kuéra.	NOCHANGE
Iporâite ñamomorã ha jaikuauka hekove ha hembiapoita ohai va’ekue ko haihára katupyryete ha sa’iete mbo’ehaope mitanguérape ojeikuaaukáva	Iporâite ñamomorã ha jaikuauka hekove ha hembiapoita ohai va’ekue ko haihára katupyryete ha sa’iete mbo’ehaope mitanguérape ojeikuaaukáva	NOCHANGE
Térã yvy puru’ã ru’ãre pyhare omburea,	Térã yvy puru’ã ru’ãre pyhare omburea,	NOCHANGE
Karai, tera sykuéra, ha oiméva mita pyahu,	Karai, tera sykuéra, ha oiméva mita pyahu,	NOCHANGE
Nde ikatu rehechase upe jeikove ipaha, hérava avei mano.	Nde ikatu rehechase upe jeikove ipaha, hérava avei mano.	NOCHANGE
Opa ñembo’e,	Opa ñembo’e,	NOCHANGE
Añemondyi ha upéicha avei, úpete guive, ambopaha	Añemondyi ha upéicha avei, úpete guive, ambopaha	NOCHANGE
Oguãhẽ, oheka tukumbo ha oñapytĩ ka’ípe yvyra po-	Oguãhẽ, oheka tukumbo ha oñapytĩ ka’ípe yvyra po-	NOCHANGE
Opukavy ñane ñe’ã ha ipotĩ ñande ruguy,	Opukavy ñane ñe’ã ha ipotĩ ñande ruguy,	NOCHANGE
Peñemombe’u pa’ípe, angaipa guasu apóre, remanotaramo ha avei tupãpyhýi mboyve.	Peñemombe’u pa’ípe, angaipa guasu apóre, remanotaramo ha avei tupãpyhýi mboyve.	NOCHANGE
Ñane retâ mba’ete	Ñane retâ mba’ete	NOCHANGE
Ñe’ẽ ha jehai ava mba’etee isã so’ỹ va’erã. opáva opaichave ikatu oikuahauka ipahaite peve	Ñe’ẽ ha jehai ava mba’etee isã so’ỹ va’erã. opáva opaichave ikatu oikuahauka ipahaite peve	NOCHANGE
Ojapómi aty guasu ijatyhápe ñe’êporâhaihára ha puraheihára. péicha ha’e oñakârapu’â	Ojapómi aty guasu ijatyhápe ñe’êporâhaihára ha puraheihára. péicha ha’e oñakârapu’â	NOCHANGE
Oñemoañete maymávape iderécho oñeme’êvo chupe marandu añeteguáva ha hendápe porâ oje’éva.	Oñemoañete maymávape iderécho oñeme’êvo chupe marandu añeteguáva ha hendápe porâ oje’éva.	NOCHANGE
Ñemby ñemuha (guarani)	Ñemby ñemuha (guarani)	NOCHANGE
Tesakã, r, h, ñe’	Tesakã, r, h, ñe’	NOCHANGE
Ha ome’ẽ chéve pytu’u.	Ha ome’ẽ chéve pytu’u.	NOCHANGE
Tapichápe ombyai, ko’ãva iguaraniñe’ẽ	Tapichápe ombyai, ko’ãva iguaraniñe’ẽ	NOCHANGE
Mario mba’yru oveve omotimbo pe tape yvyku’i yvy pytã	Mario mba’yru oveve omotimbo pe tape yvyku’i yvy pytã	NOCHANGE
Tape ojeapa apa yvy’ã kupere yvate peve a’eva’e rovai re amboae yvy rami.	Tape ojeapa apa yvy’ã kupere yvate peve a’eva’e rovai re amboae yvy rami.	NOCHANGE
Ko ñe’ẽpoty porãite	Ko ñe’ẽpoty porãite	NOCHANGE
Ha péina ñahendupáma mba’épa he’i ko karai. ñande âva â mba’e jaikuaa voi ha jaikuaa yma.	Ha péina ñahendupáma mba’épa he’i ko karai. ñande âva â mba’e jaikuaa voi ha jaikuaa yma.	NOCHANGE
Ndaipóri va’erã, ambue mba’e	Ndaipóri va’erã, ambue mba’e	NOCHANGE
Oñembohéra paje apoha morotĩva. pe paje morotĩ apohára ndaikatúi ojapo paje	Oñembohéra paje apoha morotĩva. pe paje morotĩ apohára ndaikatúi ojapo paje	NOCHANGE
Kambyryrujere. tero-téra ha ñe’ẽtéva	Kambyryrujere. tero-téra ha ñe’ẽtéva	NOCHANGE
Chive hembirekópe oñe’ẽ mbegue	Chive hembirekópe oñe’ẽ mbegue	NOCHANGE
Mokõivéva tetã ñe’ẽ tee ha upéichape	Mokõivéva tetã ñe’ẽ tee ha upéichape	NOCHANGE
Ñame’ẽrõmante oñeme’ẽta ñandéve	Ñame’ẽrõmante oñeme’ẽta ñandéve	NOCHANGE
Nemandu’ápa yvyraty oñongatúva ñane mba’epota ha...	Nemandu’ápa yvyraty oñongatúva ñane mba’epota ha...	NOCHANGE
Che ñe’ẽ nde cuatiápe ndeve ojhó i vendejharé.	Che ñe’ẽ nde cuatiápe ndeve ojhó i vendejharé.	NOCHANGE
Eme’ẽ opa erekóva	Eme’ẽ opa erekóva	NOCHANGE
Ha ñaipohano tokuera jevy ko ñane retã.	Ha ñaipohano tokuera jevy ko ñane retã.	NOCHANGE
Peikuaa haguã ha’éva.	Peikuaa haguã ha’éva.	NOCHANGE
Jave ha, upérõ, ohai ñe’ẽ vore mbykymíva. iñirũnguéra oñepyrũma	Jave ha, upérõ, ohai ñe’ẽ vore mbykymíva. iñirũnguéra oñepyrũma	NOCHANGE
Añetehápe, oĩ oporomongueráva yvy, y térã katu oporopohãnóva ñembo’e rupive.	Añetehápe, oĩ oporomongueráva yvy, y térã katu oporopohãnóva ñembo’e rupive.	NOCHANGE
Ndaiporichene ko yvy ape ári	Ndaiporichene ko yvy ape ári	NOCHANGE
Ko’ẽjúicha iporo’yva - chave upéichante hi’ãva	Ko’ẽjúicha iporo’yva - chave upéichante hi’ãva	NOCHANGE
Peheja ava tokororõ ñe’ẽ guaranípe.	Peheja ava tokororõ ñe’ẽ guaranípe.	NOCHANGE
Noha’arõ rañẽi ore oroñe’ẽ.	Noha’arõ rañẽi ore oroñe’ẽ.	NOCHANGE
Mba’erepa upeichaite ñamboyke hekópe.	Mba’erepa upeichaite ñamboyke hekópe.	NOCHANGE
Upéicha avei ñande	Upéicha avei ñande	NOCHANGE
Aropurahéita che ñe’ã mbytégui aikóva añandu.	Aropurahéita che ñe’ã mbytégui aikóva añandu.	NOCHANGE
Pe pu’ã ñamoñe’ẽ ñande poyvi potĩ sakãme,	Pe pu’ã ñamoñe’ẽ ñande poyvi potĩ sakãme,	NOCHANGE
Yvyporakuéra, ha’e umi ovechaícha, omuña akointe hendotapavẽpe , jehureípe iporãhagotyo	Yvyporakuéra, ha’e umi ovechaícha, omuña akointe hendotapavẽpe , jehureípe iporãhagotyo	NOCHANGE
Ipyahúva purahéi.	Ipyahúva purahéi.	NOCHANGE
Arapytukuéra ko tetãvorépe ndahakuetéi ha katu he’õ hetaite oĩre ko’árupi ñu karuguakuéra, ysyry ha avei ysyryguasu ombohykuéva ko yvy.	Arapytukuéra ko tetãvorépe ndahakuetéi ha katu he’õ hetaite oĩre ko’árupi ñu karuguakuéra, ysyry ha avei ysyryguasu ombohykuéva ko yvy.	NOCHANGE
Ha upéva, upéva oĩ porã.	Ha upéva, upéva oĩ porã.	NOCHANGE
Che retã oguerekóva	Che retã oguerekóva	NOCHANGE
Nde réra oikóva ku eíra saitéicha che hay’okuápe	Nde réra oikóva ku eíra saitéicha che hay’okuápe	NOCHANGE
Y ñe’ẽ opararã ohasávo yvykuáre	Y ñe’ẽ opararã ohasávo yvykuáre	NOCHANGE
Pyko’ẽ che ñe’ã kuápe.	Pyko’ẽ che ñe’ã kuápe.	NOCHANGE
Ava’ayvu ñahendu omboryrýi omopu’ã ñane retã	Ava’ayvu ñahendu omboryrýi omopu’ã ñane retã	NOCHANGE
Ha eikuaa avei mokõi mbyja ko’ẽicha	Ha eikuaa avei mokõi mbyja ko’ẽicha	NOCHANGE
Maravichu, kujererâ ha ambue ñembosarái rupi,	Maravichu, kujererâ ha ambue ñembosarái rupi,	NOCHANGE
Ombohekoviáne umívape nomomarãi guive umi oje’éva ko constitución-pe.	Ombohekoviáne umívape nomomarãi guive umi oje’éva ko constitución-pe.	NOCHANGE
- ma’ẽrã. -ojehesa popira ha oma’ẽva.	- ma’ẽrã. -ojehesa popira ha oma’ẽva.	NOCHANGE
Ñe’ẽndýi ñe’ẽteja ñe’ẽtéva teroja tero	Ñe’ẽndýi ñe’ẽteja ñe’ẽtéva teroja tero	NOCHANGE
Ha’ekuéra oguerosapukái oguerotĩ	Ha’ekuéra oguerosapukái oguerotĩ	NOCHANGE
Tekopypegua, ojehechaukahápe hetãnguéra imba’e teeha.	Tekopypegua, ojehechaukahápe hetãnguéra imba’e teeha.	NOCHANGE
Ogueru ko’ã mba’e,	Ogueru ko’ã mba’e,	NOCHANGE
Ani tesarái ou ne mbyai, ko’ẽju poty.	Ani tesarái ou ne mbyai, ko’ẽju poty.	NOCHANGE
Che remimbo’ekuérape	Che remimbo’ekuérape	NOCHANGE
Peguarãite, ha ojedecidi haguã añoite.	Peguarãite, ha ojedecidi haguã añoite.	NOCHANGE
Ore nde ra’yetaite	Ore nde ra’yetaite	NOCHANGE
Karai arandu ñe’ẽ kuaa	Karai arandu ñe’ẽ kuaa	NOCHANGE
Mymba ipy poteĩ	Mymba ipy poteĩ	NOCHANGE
Kuatirana juehegua.	Kuatirana juehegua.	NOCHANGE
Ha notĩri ko añakuéra,	Ha notĩri ko añakuéra,	NOCHANGE
Ojapo rupi upéva, oiko chuguikuéra pekadór ha ñandejára omosẽ chupekuéra pe hardíngui.	Ojapo rupi upéva, oiko chuguikuéra pekadór ha ñandejára omosẽ chupekuéra pe hardíngui.	NOCHANGE
Oĩme mba’épa che resaráiva, ndajapóiva,	Oĩme mba’épa che resaráiva, ndajapóiva,	NOCHANGE
Añetehápe, ndentevoi upe rejekuaaporâ’ỹva ndejupe, upe hekokatu’ỹva, ndentevoi, avave ndaikatúi ojapo umi mba’e nderérape	Añetehápe, ndentevoi upe rejekuaaporâ’ỹva ndejupe, upe hekokatu’ỹva, ndentevoi, avave ndaikatúi ojapo umi mba’e nderérape	NOCHANGE
Kuimba’ekuéra ojegueraha porãva kuñakuéra ndive ha’e umi oikuaáva mba’eichápa jeikove hese’ỹkuéra	Kuimba’ekuéra ojegueraha porãva kuñakuéra ndive ha’e umi oikuaáva mba’eichápa jeikove hese’ỹkuéra	NOCHANGE
. ko’ãga mombyry	. ko’ãga mombyry	NOCHANGE
Ñande reko.	Ñande reko.	NOCHANGE
Mba’eve ndaha’ei hendape’ỹ oĩramo sa ñemuharakuéra oñemopy’apeteĩva ojapohaguã	Mba’eve ndaha’ei hendape’ỹ oĩramo sa ñemuharakuéra oñemopy’apeteĩva ojapohaguã	NOCHANGE
Ñane angaipa rehe.	Ñane angaipa rehe.	NOCHANGE
Varjãore terã ka’aguýre año oroikotevẽ, oroikotevẽ ave yvy romba’apo haguã, yvy potĩ roñotỹ haguã ore rembi’urã.	Varjãore terã ka’aguýre año oroikotevẽ, oroikotevẽ ave yvy romba’apo haguã, yvy potĩ roñotỹ haguã ore rembi’urã.	NOCHANGE
Re. upéicharamo, ojeheja sapy’áramo	Re. upéicharamo, ojeheja sapy’áramo	NOCHANGE
Upéicha sa’i sa’ípe	Upéicha sa’i sa’ípe	NOCHANGE
Peteĩ kuña oñeme’ẽramo he’ise ipu’akahague	Peteĩ kuña oñeme’ẽramo he’ise ipu’akahague	NOCHANGE
Oñemboykeháicha oúvo ndaha’éi ohapejokónteva,	Oñemboykeháicha oúvo ndaha’éi ohapejokónteva,	NOCHANGE
Ko’ápe ha pépe jahecha yvypóra	Ko’ápe ha pépe jahecha yvypóra	NOCHANGE
Pohã juehegua.	Pohã juehegua.	NOCHANGE
Oñe’ême’êháme, ore rupive, omoañetetaha ha oykekotaha ko tembipota,	Oñe’ême’êháme, ore rupive, omoañetetaha ha oykekotaha ko tembipota,	NOCHANGE
Nahi’ãiva’ekue che ñe’ẽ oguahẽ avave apysápe	Nahi’ãiva’ekue che ñe’ẽ oguahẽ avave apysápe	NOCHANGE
Ha ohasáva umi ára	Ha ohasáva umi ára	NOCHANGE
Upépe ae nesãsóta ha upépe ae revy’áne.	Upépe ae nesãsóta ha upépe ae revy’áne.	NOCHANGE
Ñambogua ha ja’u.	Ñambogua ha ja’u.	NOCHANGE
Ñande py’ápe	Ñande py’ápe	NOCHANGE
Apurahéimi haguã.	Apurahéimi haguã.	NOCHANGE
Pe mba’e noñemohesakãiva ichupekuéra	Pe mba’e noñemohesakãiva ichupekuéra	NOCHANGE
Tavetã joaju pegua	Tavetã joaju pegua	NOCHANGE
Taipoty popu ñanemba’éva.	Taipoty popu ñanemba’éva.	NOCHANGE
Tetã ñe’ẽ teépe, upéichape umi tapicha	Tetã ñe’ẽ teépe, upéichape umi tapicha	NOCHANGE
(peteĩ tecñaukápe.)	(peteĩ tecñaukápe.)	NOCHANGE
Haguã, ha hembiapo kuéra ombohape mbareteha opa yvypóra yvy ape ári	Haguã, ha hembiapo kuéra ombohape mbareteha opa yvypóra yvy ape ári	NOCHANGE
Kóva peteĩ mba’e he’ẽ hypy’ũ ha hetereíva osẽva oñembojývo arro vaka kambýpe, ojejapóva hekópe porã.	Kóva peteĩ mba’e he’ẽ hypy’ũ ha hetereíva osẽva oñembojývo arro vaka kambýpe, ojejapóva hekópe porã.	NOCHANGE
Oikove jey ñande ava ñe’ẽ hapeguy kañýva	Oikove jey ñande ava ñe’ẽ hapeguy kañýva	NOCHANGE
Ñe’ê ojeporúva porandu hypy’ûvévare.	Ñe’ê ojeporúva porandu hypy’ûvévare.	NOCHANGE
Pehẽnguekuéra heta ombyasy upe ojejapova’ekue hese. upéicha opákuri karai	Pehẽnguekuéra heta ombyasy upe ojejapova’ekue hese. upéicha opákuri karai	NOCHANGE
Upe rire ojeheka máva mávapa umi ikatútava omotenonde ko	Upe rire ojeheka máva mávapa umi ikatútava omotenonde ko	NOCHANGE
Omohesakãvaerã chupe tape porãme.	Omohesakãvaerã chupe tape porãme.	NOCHANGE
Tavýgui ha umi ñañágui, ndojehechakuaáiva’ekue mangorépe umi hembiapokatu.	Tavýgui ha umi ñañágui, ndojehechakuaáiva’ekue mangorépe umi hembiapokatu.	NOCHANGE
Ojepuru guarani ñe’ẽ umi médio	Ojepuru guarani ñe’ẽ umi médio	NOCHANGE
Anicheva’erã voi, guarani ñande rekópe	Anicheva’erã voi, guarani ñande rekópe	NOCHANGE
Iporãranguéramo, hekopotĩnte ha’e oipotave	Iporãranguéramo, hekopotĩnte ha’e oipotave	NOCHANGE
Omyenondeva’erã kuaareka mba’éichapa ojepuruhína paraguay retâ ñe’ẽnguéra.	Omyenondeva’erã kuaareka mba’éichapa ojepuruhína paraguay retâ ñe’ẽnguéra.	NOCHANGE
Ha’ekuéra niko	Ha’ekuéra niko	NOCHANGE
Ha’e kuéra ndoikuaái.	Ha’e kuéra ndoikuaái.	NOCHANGE
Omohu’âva’ekue itápe	Omohu’âva’ekue itápe	NOCHANGE
. upéicha avei noĩchéne mba’apo’ỹre ohasáva	. upéicha avei noĩchéne mba’apo’ỹre ohasáva	NOCHANGE
Ñandy ha juky.	Ñandy ha juky.	NOCHANGE
Che mborayhu rembiasakuekuérape peteĩ jey angeko oguahevaekue upei, ko’ágã oguahe mboyve	Che mborayhu rembiasakuekuérape peteĩ jey angeko oguahevaekue upei, ko’ágã oguahe mboyve	NOCHANGE
Tekombo’e ha’e tembiaporape ohejáva ojehupyty hetavéva temiandu ragẽ	Tekombo’e ha’e tembiaporape ohejáva ojehupyty hetavéva temiandu ragẽ	NOCHANGE
Ñande yvy imarãtaha,	Ñande yvy imarãtaha,	NOCHANGE
Ha’e ojekoha oñemiha	Ha’e ojekoha oñemiha	NOCHANGE
Maria ru omuña mondahápe ha ombohayvi hi’ári ita.	Maria ru omuña mondahápe ha ombohayvi hi’ári ita.	NOCHANGE
Opytáne upérõ umi mokõi candato oguereko va’ekue hetave voto tenonderãme ha sapy’a	Opytáne upérõ umi mokõi candato oguereko va’ekue hetave voto tenonderãme ha sapy’a	NOCHANGE
Ñe’ẽpehẽtai ha ñe’ẽriregua purukuaa	Ñe’ẽpehẽtai ha ñe’ẽriregua purukuaa	NOCHANGE
Heñói ha okakuaáva	Heñói ha okakuaáva	NOCHANGE
Oñembosako’i guarani ñe’ẽaty, ñe’ẽasa ha ñe’ẽjere ára peteĩha	Oñembosako’i guarani ñe’ẽaty, ñe’ẽasa ha ñe’ẽjere ára peteĩha	NOCHANGE
Ára purahéi.	Ára purahéi.	NOCHANGE
Reikoha che ñe’âitépe mbyja ko’ê kypy’y.	Reikoha che ñe’âitépe mbyja ko’ê kypy’y.	NOCHANGE
Ava guarani hi’upyrã ogunohẽ yva ñembyatýgui, mymba jejukágui, pira kutuhágui ha oñemitỹkuégui.	Ava guarani hi’upyrã ogunohẽ yva ñembyatýgui, mymba jejukágui, pira kutuhágui ha oñemitỹkuégui.	NOCHANGE
-nerembopo’íriramo, ñañani chendive jahecha mava raẽpa oguahẽ amo kurupa’y rakã guasu ho’ava’ekue ári oguapy.	-nerembopo’íriramo, ñañani chendive jahecha mava raẽpa oguahẽ amo kurupa’y rakã guasu ho’ava’ekue ári oguapy.	NOCHANGE
Mburuvichakuéra omohembi’u umi tapichakuérape opytava’ekue óga’yre.	Mburuvichakuéra omohembi’u umi tapichakuérape opytava’ekue óga’yre.	NOCHANGE
Ñe’ẽhaihára	Ñe’ẽhaihára	NOCHANGE
Ijatyguasu jepivegua ojejapova’ekue paraguaýpe,	Ijatyguasu jepivegua ojejapova’ekue paraguaýpe,	NOCHANGE
(oñembyaty ohóvo marandu opa mymba ha yvyraty oĩva ko yvy ape ári rehegua)	(oñembyaty ohóvo marandu opa mymba ha yvyraty oĩva ko yvy ape ári rehegua)	NOCHANGE
Umi heñói ha omanúva apytépe na iñambueguasúi ko’árupi ko’ã ára rupi.	Umi heñói ha omanúva apytépe na iñambueguasúi ko’árupi ko’ã ára rupi.	NOCHANGE
Ohohápe mavave ndoipe’ái ichupe hóga rokẽ. maymávante oñembotavypa ichugui. ipahaitépe, oguahẽ peteĩ tujami rógape.	Ohohápe mavave ndoipe’ái ichupe hóga rokẽ. maymávante oñembotavypa ichugui. ipahaitépe, oguahẽ peteĩ tujami rógape.	NOCHANGE
Ajopy ajora amboty avañe’ẽme,	Ajopy ajora amboty avañe’ẽme,	NOCHANGE
Jajuhu ógape, ka’aguýre, ýpe ha mba’e.	Jajuhu ógape, ka’aguýre, ýpe ha mba’e.	NOCHANGE
Ñane rekosã’ỹre, ñane ñe’ẽngatúre	Ñane rekosã’ỹre, ñane ñe’ẽngatúre	NOCHANGE
Iiviguasu, ipuere vaerã jokuaeguire oiko piaguive	Iiviguasu, ipuere vaerã jokuaeguire oiko piaguive	NOCHANGE
Tavayguakuéra oñembosako’i	Tavayguakuéra oñembosako’i	NOCHANGE
Ñangareko me’ẽ umi hasykatúvape.	Ñangareko me’ẽ umi hasykatúvape.	NOCHANGE
Ndaikatúi oguata, ipychâimbaitéko.	Ndaikatúi oguata, ipychâimbaitéko.	NOCHANGE
Pikaia, peteĩ mymba sã atukupépe ymaguare.	Pikaia, peteĩ mymba sã atukupépe ymaguare.	NOCHANGE
Ko tekove ha’e peteĩ tasyo ha mayma hasývare oñembojara tembipotapy omoambuehaguã hupa	Ko tekove ha’e peteĩ tasyo ha mayma hasývare oñembojara tembipotapy omoambuehaguã hupa	NOCHANGE
Apopy, oñeme’ê ha oñemyasãi jojahápe pe tekopykuaa jopara he’iséva	Apopy, oñeme’ê ha oñemyasãi jojahápe pe tekopykuaa jopara he’iséva	NOCHANGE
Yvy ha yvága	Yvy ha yvága	NOCHANGE
Umi rupi ojehúva.	Umi rupi ojehúva.	NOCHANGE
Ñande reko,	Ñande reko,	NOCHANGE
Moroti ha oñepyru oipyaha. ojapo upéicha petei mba’e neporãmbajepéva, ka’aguy	Moroti ha oñepyru oipyaha. ojapo upéicha petei mba’e neporãmbajepéva, ka’aguy	NOCHANGE
Ko mba’e nomboykéi maskoy-kuéra jerovia, umi jeroviápe oñemoĩveva’erã ojegueroviaha ã opytaha yvágape oĩhápe peteĩ tenda kóichagua.	Ko mba’e nomboykéi maskoy-kuéra jerovia, umi jeroviápe oñemoĩveva’erã ojegueroviaha ã opytaha yvágape oĩhápe peteĩ tenda kóichagua.	NOCHANGE
Ñane ñe’ẽ guaraní yvytúre ojupi omyanyhẽ	Ñane ñe’ẽ guaraní yvytúre ojupi omyanyhẽ	NOCHANGE
Nde japu hína.	Nde japu hína.	NOCHANGE
Ne ñe’ã ruguápe ipoty ko’ẽ.	Ne ñe’ã ruguápe ipoty ko’ẽ.	NOCHANGE
Ko oportunida porãite.	Ko oportunida porãite.	NOCHANGE
Mbaraka purahéipe.	Mbaraka purahéipe.	NOCHANGE
Tembipuru ojejapova’ekue	Tembipuru ojejapova’ekue	NOCHANGE
Mitãkuña omoheñói peteĩ mitãkuña’íme ha omano. upe mitãkuña’i, hérava mani, ombovy’a kuri oĩháicha avakuérape.	Mitãkuña omoheñói peteĩ mitãkuña’íme ha omano. upe mitãkuña’i, hérava mani, ombovy’a kuri oĩháicha avakuérape.	NOCHANGE
Heñóima ko’ãga ñande apytépe mborayhu jekopyty	Heñóima ko’ãga ñande apytépe mborayhu jekopyty	NOCHANGE
Iporãvéva po’a	Iporãvéva po’a	NOCHANGE
Tetã paraguay ryepýpe, ha’eténte ojeráva mandu’a mangore rembiapokuére. aveíko ojehecharamojey pe héra ha umi ipumbasy.	Tetã paraguay ryepýpe, ha’eténte ojeráva mandu’a mangore rembiapokuére. aveíko ojehecharamojey pe héra ha umi ipumbasy.	NOCHANGE
Imbareteve haguã, oñembotuichavéva heta tembiasakue rupive ha jopói	Imbareteve haguã, oñembotuichavéva heta tembiasakue rupive ha jopói	NOCHANGE
Ñe’ê mba’asy rehegua ojeporuvéva	Ñe’ê mba’asy rehegua ojeporuvéva	NOCHANGE
Rehe gueteri ñe’ẽ ñane retãme.	Rehe gueteri ñe’ẽ ñane retãme.	NOCHANGE
Oñehenóine peteĩ convención-pe oguerekóva umi representante ojeporavo va’ekue tetãygua pyvéi	Oñehenóine peteĩ convención-pe oguerekóva umi representante ojeporavo va’ekue tetãygua pyvéi	NOCHANGE
Emba’apo ñaneñe’ẽre emopu’ã porãite.	Emba’apo ñaneñe’ẽre emopu’ã porãite.	NOCHANGE
Rekombo’épe iñe’ênguéra, imba’e porãnguéra ha iñarandukuéra,	Rekombo’épe iñe’ênguéra, imba’e porãnguéra ha iñarandukuéra,	NOCHANGE
Ava imba’epotáva ha ava hekokatúva	Ava imba’epotáva ha ava hekokatúva	NOCHANGE
Che katu ko’ápe ko’ẽ mboyvemi ajetypekáma	Che katu ko’ápe ko’ẽ mboyvemi ajetypekáma	NOCHANGE
Heta porã oguatarire oguahẽ ñu rembe’ýpe. ko’ápe opyta oñemongeta.	Heta porã oguatarire oguahẽ ñu rembe’ýpe. ko’ápe opyta oñemongeta.	NOCHANGE
Hupi’a porãva, mitã ñandejára	Hupi’a porãva, mitã ñandejára	NOCHANGE
Ahechahápe amba’y ha’e inga, granada, mburukuja ha urumbe yvy pytâháre	Ahechahápe amba’y ha’e inga, granada, mburukuja ha urumbe yvy pytâháre	NOCHANGE
Oútava oñemondévo ha’e tembireko oikovévare.	Oútava oñemondévo ha’e tembireko oikovévare.	NOCHANGE
Katuete orekóva ome’ẽva’erã.	Katuete orekóva ome’ẽva’erã.	NOCHANGE
Ñane mba’e teete	Ñane mba’e teete	NOCHANGE
Ha ñande poyvi oñuambaitéma ko ñane retã.	Ha ñande poyvi oñuambaitéma ko ñane retã.	NOCHANGE
Ndaikuaái mba’épa ajapóta	Ndaikuaái mba’épa ajapóta	NOCHANGE
Vakáre, ysokuéra oñemohyguatãkuri imandyjutýpe. upeichaite jekoraka’e	Vakáre, ysokuéra oñemohyguatãkuri imandyjutýpe. upeichaite jekoraka’e	NOCHANGE
Rehendu hi’ãva ñe’ẽ porãita,	Rehendu hi’ãva ñe’ẽ porãita,	NOCHANGE
Opavave ojepy’apy tĩatĩkuérare, avei kypekuéra opa ohóvo	Opavave ojepy’apy tĩatĩkuérare, avei kypekuéra opa ohóvo	NOCHANGE
Hese ko’ẽ porã mboyve. oipy’apy asy chupe.	Hese ko’ẽ porã mboyve. oipy’apy asy chupe.	NOCHANGE
Ñañe mbosarairãmo ñande rekoharehe	Ñañe mbosarairãmo ñande rekoharehe	NOCHANGE
Nde ryke’y kuéra nerenduvaerã	Nde ryke’y kuéra nerenduvaerã	NOCHANGE
Nde py’ápe,	Nde py’ápe,	NOCHANGE
Umi nde ati’y kuarahy rata ohapy asýva	Umi nde ati’y kuarahy rata ohapy asýva	NOCHANGE
Tupã oñemboja ha he’i	Tupã oñemboja ha he’i	NOCHANGE
Ñe’ẽtéva, ha	Ñe’ẽtéva, ha	NOCHANGE
Haperãme okúiva ára rekopýre ku ko’ẽ mboyve.	Haperãme okúiva ára rekopýre ku ko’ẽ mboyve.	NOCHANGE
One (un) peteĩ	One (un) peteĩ	NOCHANGE
Guyra ñe’ê ñahendúva	Guyra ñe’ê ñahendúva	NOCHANGE
Ha’ekuérante oñe’ëramo mbo’ehára opytátamava tapykue. ha ndaha’éiningo katuete upéicha. heta jey avei	Ha’ekuérante oñe’ëramo mbo’ehára opytátamava tapykue. ha ndaha’éiningo katuete upéicha. heta jey avei	NOCHANGE
Ha katu pe añeteguava oiko va’ekue, ha justicia nda hechái	Ha katu pe añeteguava oiko va’ekue, ha justicia nda hechái	NOCHANGE
Tetãnguéra joaju	Tetãnguéra joaju	NOCHANGE
Mbo’ehára ikatupyryveva’ekue ii	Mbo’ehára ikatupyryveva’ekue ii	NOCHANGE
Hi’ãite chéve ko arapokõindy pehasa porãite ha opa pene rembipota tahi’aju.	Hi’ãite chéve ko arapokõindy pehasa porãite ha opa pene rembipota tahi’aju.	NOCHANGE
Ohohápe, mavave ndoipe’ái chupe hóga rokê. maymáva oñembotavypa chugui.	Ohohápe, mavave ndoipe’ái chupe hóga rokê. maymáva oñembotavypa chugui.	NOCHANGE
Jopói porãite.	Jopói porãite.	NOCHANGE
Nde resápe.	Nde resápe.	NOCHANGE
Tetãvore paraná (tetãvore)	Tetãvore paraná (tetãvore)	NOCHANGE
Oĩ peteĩ mba’e añónte ko arapýpe ivaivéva ñeñe’ẽ nderehegui, ha upéva ha’e ñeñe’ẽ’ỹ nderehe	Oĩ peteĩ mba’e añónte ko arapýpe ivaivéva ñeñe’ẽ nderehegui, ha upéva ha’e ñeñe’ẽ’ỹ nderehe	NOCHANGE
Mburuvichápe ko constitución he’iháicha, ha avei mboguata porãve haguã umi oĩ va’ekuéma	Mburuvichápe ko constitución he’iháicha, ha avei mboguata porãve haguã umi oĩ va’ekuéma	NOCHANGE
Ñaneresãi ñande retépe ha ñane apytu’ũme.	Ñaneresãi ñande retépe ha ñane apytu’ũme.	NOCHANGE
Ñandejára jesucristo ñe’ẽ	Ñandejára jesucristo ñe’ẽ	NOCHANGE
Ñane ñe’ë jepivegua,	Ñane ñe’ë jepivegua,	NOCHANGE
Ha ára pytũ guýpe oguereko.	Ha ára pytũ guýpe oguereko.	NOCHANGE
He’ívo, hesaho sapy’a aguaráre oñemboja mbegue	He’ívo, hesaho sapy’a aguaráre oñemboja mbegue	NOCHANGE
Omohu’âva’ekue ipehênguekuéra ndive	Omohu’âva’ekue ipehênguekuéra ndive	NOCHANGE
Tuvakuéra ha tyvyrakuéra oikové paraguaýpe.	Tuvakuéra ha tyvyrakuéra oikové paraguaýpe.	NOCHANGE
Kavaju ipysãpe guasu.	Kavaju ipysãpe guasu.	NOCHANGE
Ha’e oguatáva itáva rupi.	Ha’e oguatáva itáva rupi.	NOCHANGE
Tetâ ruvichakuéra ndive, oñemosêkuri ñane retâgui ha upeichahápe oikundaha heta	Tetâ ruvichakuéra ndive, oñemosêkuri ñane retâgui ha upeichahápe oikundaha heta	NOCHANGE
Oguahẽma pytu’u ichupe.	Oguahẽma pytu’u ichupe.	NOCHANGE
Ha ñande rapicháre	Ha ñande rapicháre	NOCHANGE
Tavakuairetã chína momorãhéi	Tavakuairetã chína momorãhéi	NOCHANGE
Ñe’ê rusu oúva ahy’o ñembotýgui	Ñe’ê rusu oúva ahy’o ñembotýgui	NOCHANGE
Apu’ã yevýne peteĩ ko’ẽme	Apu’ã yevýne peteĩ ko’ẽme	NOCHANGE
Ñane retãgua hese tokambu. ha tomomorã.	Ñane retãgua hese tokambu. ha tomomorã.	NOCHANGE
Katu ja’emanteva’erã araka’eve	Katu ja’emanteva’erã araka’eve	NOCHANGE
Ko’ápe oimévare ñande py’a karãi.	Ko’ápe oimévare ñande py’a karãi.	NOCHANGE
Ko’ã túvakuéra oñe’ëmonde ita’yrakuérape.	Ko’ã túvakuéra oñe’ëmonde ita’yrakuérape.	NOCHANGE
Mayma ñande ypykuéra,	Mayma ñande ypykuéra,	NOCHANGE
Che ndaha’ei oipotáva moñera’ỹnte. che ha’e oipotáva moñera’ỹ ikyre’ỹva. aĩ añeha’ã haguãícha py’aguapyre	Che ndaha’ei oipotáva moñera’ỹnte. che ha’e oipotáva moñera’ỹ ikyre’ỹva. aĩ añeha’ã haguãícha py’aguapyre	NOCHANGE
Topu’ã ñane retã	Topu’ã ñane retã	NOCHANGE
Opaite mba’épe.	Opaite mba’épe.	NOCHANGE
Ñe’ẽ ñe’ẽpehẽtai	Ñe’ẽ ñe’ẽpehẽtai	NOCHANGE
Investigaciones administrativas oñepyrũ va’erã omba’apo hembiapokuérape añetehápe, ha	Investigaciones administrativas oñepyrũ va’erã omba’apo hembiapokuérape añetehápe, ha	NOCHANGE
Mmm, ko terere ho’ysã porã.	Mmm, ko terere ho’ysã porã.	NOCHANGE
Oveve ápe ha pépe	Oveve ápe ha pépe	NOCHANGE
O ñembyahýi.	O ñembyahýi.	NOCHANGE
Opaite ára ary pegua	Opaite ára ary pegua	NOCHANGE
Ha che mitãrõ, che, ñe’ẽyvoty yguasúpe,	Ha che mitãrõ, che, ñe’ẽyvoty yguasúpe,	NOCHANGE
Kuarahy ra’y, mitã pireju, porã rerekuára	Kuarahy ra’y, mitã pireju, porã rerekuára	NOCHANGE
Ha’e ohapyhína omboguehína	Ha’e ohapyhína omboguehína	NOCHANGE
Peteĩ ñe’ẽ ha’e peteĩ ñe’ẽnunga ikatúva oguereko guaranihára aty	Peteĩ ñe’ẽ ha’e peteĩ ñe’ẽnunga ikatúva oguereko guaranihára aty	NOCHANGE
Ñe’ẽpaparakuéra ityarõ’ỹ va oporohekora’ã, ñe’ẽpaparakuéra ityarõva katu omonda	Ñe’ẽpaparakuéra ityarõ’ỹ va oporohekora’ã, ñe’ẽpaparakuéra ityarõva katu omonda	NOCHANGE
Peteĩ kavure guasu ho’a ñúhãme.	Peteĩ kavure guasu ho’a ñúhãme.	NOCHANGE
Kanindeju ha’e peteĩ tetãvore avakuéra tendagua hetaveha omba’apóva kokuépe, péicha poapy ava pa pa’ũgui oiko okaháre ha mokõi tavaháre.	Kanindeju ha’e peteĩ tetãvore avakuéra tendagua hetaveha omba’apóva kokuépe, péicha poapy ava pa pa’ũgui oiko okaháre ha mokõi tavaháre.	NOCHANGE
Araka’eve ndaikatúi omomboriahúvo	Araka’eve ndaikatúi omomboriahúvo	NOCHANGE
Nde ra’y hesukirito rendaguépe	Nde ra’y hesukirito rendaguépe	NOCHANGE
Ñepytyvõ ha mborayhu,	Ñepytyvõ ha mborayhu,	NOCHANGE
Ñande ára pyahu	Ñande ára pyahu	NOCHANGE
Peteĩ ára, anguja ohendu ongyryry vaipaitéva.	Peteĩ ára, anguja ohendu ongyryry vaipaitéva.	NOCHANGE
Ha upéi tembiguái.	Ha upéi tembiguái.	NOCHANGE
Ha upéicha ohtirauka...	Ha upéicha ohtirauka...	NOCHANGE
Pohâ ñana mbosako’i rehegua.	Pohâ ñana mbosako’i rehegua.	NOCHANGE
Ha’eñónte omohe’ẽ	Ha’eñónte omohe’ẽ	NOCHANGE
Ha’ekuéra oiko porã	Ha’ekuéra oiko porã	NOCHANGE
Nde yvykuarã.	Nde yvykuarã.	NOCHANGE
Rehejava’ekue rehoite mboyve.	Rehejava’ekue rehoite mboyve.	NOCHANGE
Ñe’ẽpyahu ñemohenda	Ñe’ẽpyahu ñemohenda	NOCHANGE
Tetãguasu rehegua jeporu, avei umi garantía ha derecho oĩva mokõivépe.	Tetãguasu rehegua jeporu, avei umi garantía ha derecho oĩva mokõivépe.	NOCHANGE
Katuete iporãva osẽva’erã	Katuete iporãva osẽva’erã	NOCHANGE
P. táva ava kuéra tetãvore	P. táva ava kuéra tetãvore	NOCHANGE
Ñaimo’ã tyre’ỹmimi.	Ñaimo’ã tyre’ỹmimi.	NOCHANGE
Ko ñe’ẽ kóva omoĩ.	Ko ñe’ẽ kóva omoĩ.	NOCHANGE
Upevere ndojokói chupe ára haku, ama, ni yvytu vai.	Upevere ndojokói chupe ára haku, ama, ni yvytu vai.	NOCHANGE
Ojejerurehápe, terã opa ary.	Ojejerurehápe, terã opa ary.	NOCHANGE
Che ra’ykuéra oje’ói tetã ambuére.	Che ra’ykuéra oje’ói tetã ambuére.	NOCHANGE
Acosta ñu ñorairõ	Acosta ñu ñorairõ	NOCHANGE
Ojepaga ojeporu va’ekue.	Ojepaga ojeporu va’ekue.	NOCHANGE
Pyhare poty, paraguái retã rehesapepáva	Pyhare poty, paraguái retã rehesapepáva	NOCHANGE
Avei oñembokuatiávo iñe’ẽ teépe.	Avei oñembokuatiávo iñe’ẽ teépe.	NOCHANGE
Jajapo jehovápe ko purahéi pyahu.	Jajapo jehovápe ko purahéi pyahu.	NOCHANGE
Ha upéi jasapukái.	Ha upéi jasapukái.	NOCHANGE
Nañandúiva araka’eve péicha nde popo	Nañandúiva araka’eve péicha nde popo	NOCHANGE
Peteĩ ñe’ẽndy ha’e opaitéva arapy achegety ñemohendaicha	Peteĩ ñe’ẽndy ha’e opaitéva arapy achegety ñemohendaicha	NOCHANGE
Ajapo aína che rembi’urã.	Ajapo aína che rembi’urã.	NOCHANGE
Iporã ojegueromandu’a tetãyguakuéra	Iporã ojegueromandu’a tetãyguakuéra	NOCHANGE
Ha’ekuéra ojerokymo’ã omondoromo’ã	Ha’ekuéra ojerokymo’ã omondoromo’ã	NOCHANGE
Che kerayvotýpe ahecha py’aguapy ko yvórape,	Che kerayvotýpe ahecha py’aguapy ko yvórape,	NOCHANGE
Ko tendápe oñembohysýi kuatiañe’ê iguerekopýpe ndaipórivape mba’eve guarani ñe’ê rehegua.	Ko tendápe oñembohysýi kuatiañe’ê iguerekopýpe ndaipórivape mba’eve guarani ñe’ê rehegua.	NOCHANGE
Amandáu ho’ava’ekue ombyai kogakuéra kokuépegua.	Amandáu ho’ava’ekue ombyai kogakuéra kokuépegua.	NOCHANGE
Rajymi hasykatuetéva ndive, ha ha’e omonguerákuri ichupe. upéramo	Rajymi hasykatuetéva ndive, ha ha’e omonguerákuri ichupe. upéramo	NOCHANGE
Mba’ére ndape’úi penerembi’u ko asajépe.	Mba’ére ndape’úi penerembi’u ko asajépe.	NOCHANGE
Reikuaaporã ramo temiandu’yta ñe’ẽkuéra osẽ ha’ẽño	Reikuaaporã ramo temiandu’yta ñe’ẽkuéra osẽ ha’ẽño	NOCHANGE
Mba’ére ko mba’e mbyasy	Mba’ére ko mba’e mbyasy	NOCHANGE
Mbohovaikuéra iguapóva ha’e umi ombohapéva porandu pyahu	Mbohovaikuéra iguapóva ha’e umi ombohapéva porandu pyahu	NOCHANGE
Upévare ha’e peteĩ táva javy’aha ndaiporihápe tyapu vai, ikatuhaguãicha mbohupakuéra oñemoguahẽ porã.	Upévare ha’e peteĩ táva javy’aha ndaiporihápe tyapu vai, ikatuhaguãicha mbohupakuéra oñemoguahẽ porã.	NOCHANGE
Ha mitãkuña,	Ha mitãkuña,	NOCHANGE
Opáma tagë, heñói tetia’e.	Opáma tagë, heñói tetia’e.	NOCHANGE
Ha’evemante jake, ha maymáva paraguái,	Ha’evemante jake, ha maymáva paraguái,	NOCHANGE
Avañe’ë ryapu jojápe omombe’u ñandéve hembiecha ha hembiasakue, ohechaukapotávo ñane ñe’ëtépe ikatuha japurahéi puku avei.	Avañe’ë ryapu jojápe omombe’u ñandéve hembiecha ha hembiasakue, ohechaukapotávo ñane ñe’ëtépe ikatuha japurahéi puku avei.	NOCHANGE
Ko tenda ojehecha porâve	Ko tenda ojehecha porâve	NOCHANGE
Ha mayma nde joyke’ykuéra	Ha mayma nde joyke’ykuéra	NOCHANGE
Ahecha rei va’ekue,	Ahecha rei va’ekue,	NOCHANGE
Ojupe peñomombarete va’erã	Ojupe peñomombarete va’erã	NOCHANGE
Ko ñe’ẽ aipyaháva	Ko ñe’ẽ aipyaháva	NOCHANGE
Umi mitã ikatupyry ñe’ẽme ojehechakuaa	Umi mitã ikatupyry ñe’ẽme ojehechakuaa	NOCHANGE
Mayma ñemuhãme ha’e oñepohãno	Mayma ñemuhãme ha’e oñepohãno	NOCHANGE
Ñanduti resãi ñemombe’u	Ñanduti resãi ñemombe’u	NOCHANGE
Ñane retã purahéi guasu	Ñane retã purahéi guasu	NOCHANGE
Ñembyasy amono’õ,	Ñembyasy amono’õ,	NOCHANGE
Omba’apo terã aporte ojapo va’ekue upevarã ojererekóne mba’evérõ.	Omba’apo terã aporte ojapo va’ekue upevarã ojererekóne mba’evérõ.	NOCHANGE
Tetãnguéra káukaso pegua.	Tetãnguéra káukaso pegua.	NOCHANGE
Ojapyhýkuri imba’erã oñandúgui ipype mávapa oheja ichupe. upe ka’arúpe,	Ojapyhýkuri imba’erã oñandúgui ipype mávapa oheja ichupe. upe ka’arúpe,	NOCHANGE
Ha nde ruguýpe heñói	Ha nde ruguýpe heñói	NOCHANGE
Ha’ekuéra ojekoha oñemiha	Ha’ekuéra ojekoha oñemiha	NOCHANGE
Ñane ko’êmba peve.	Ñane ko’êmba peve.	NOCHANGE
Mombe’ugua’u ha’e jeroviamarãngatu avavema ogueroviave’ỹva	Mombe’ugua’u ha’e jeroviamarãngatu avavema ogueroviave’ỹva	NOCHANGE
Ha’ekuéra ohovereve ohetũve	Ha’ekuéra ohovereve ohetũve	NOCHANGE
Tojejapo ne rembipota ko yvy ári, yvagapeguáicha.	Tojejapo ne rembipota ko yvy ári, yvagapeguáicha.	NOCHANGE
Karaícha hete ñembo’y,	Karaícha hete ñembo’y,	NOCHANGE
Kuarahy resê guive roheka py’aguapy yvóra tuichakuépe.	Kuarahy resê guive roheka py’aguapy yvóra tuichakuépe.	NOCHANGE
Ha ogue’ẽhápe	Ha ogue’ẽhápe	NOCHANGE
Ha reimo’ã’ỹháguẽ oguahẽ	Ha reimo’ã’ỹháguẽ oguahẽ	NOCHANGE
Avei, katupyrýpe.	Avei, katupyrýpe.	NOCHANGE
Añónte gueteri. upéicha avei, umi indigenakuéra	Añónte gueteri. upéicha avei, umi indigenakuéra	NOCHANGE
Oñeñemomaranduve ha ua ñe’ẽñeme’ẽ rehegua, ikatukuaa oñemoñe’ẽ upe ñepyrũmby tekojoja ha	Oñeñemomaranduve ha ua ñe’ẽñeme’ẽ rehegua, ikatukuaa oñemoñe’ẽ upe ñepyrũmby tekojoja ha	NOCHANGE
Ñe’ẽpehẽtai ñemohenda	Ñe’ẽpehẽtai ñemohenda	NOCHANGE
. taropurahéi nde juru mboypýri nde ratypykua.	. taropurahéi nde juru mboypýri nde ratypykua.	NOCHANGE
Topytamíkena(ha’ekuéra) tombyatymíkena(ha’ekuéra)	Topytamíkena(ha’ekuéra) tombyatymíkena(ha’ekuéra)	NOCHANGE
Nde juru mbytégui amo che ñe’âkuápe	Nde juru mbytégui amo che ñe’âkuápe	NOCHANGE
Pokarẽme oporoha’ãva, ndoipótaivoi ñande rapicha	Pokarẽme oporoha’ãva, ndoipótaivoi ñande rapicha	NOCHANGE
He’i va’erã mba’éichapa ojeporúne terã oñevendéne yvy tetãmini mba’e.	He’i va’erã mba’éichapa ojeporúne terã oñevendéne yvy tetãmini mba’e.	NOCHANGE
Mba’ekuéra jaikuaa porãvéva ha’e umi araka’eve jaikuaapyhyvaekue	Mba’ekuéra jaikuaa porãvéva ha’e umi araka’eve jaikuaapyhyvaekue	NOCHANGE
Ko yvy ápe ári	Ko yvy ápe ári	NOCHANGE
Temimbo’ekuéra	Temimbo’ekuéra	NOCHANGE
Ñande ra’ykuérape ñame’ẽne	Ñande ra’ykuérape ñame’ẽne	NOCHANGE
Peve ñembosaráirõ, ñande sy ha ñande ru ombohoságui ñandéve ha upekuévo	Peve ñembosaráirõ, ñande sy ha ñande ru ombohoságui ñandéve ha upekuévo	NOCHANGE
(oñembohapejeýva pernambuco (tetãvore))	(oñembohapejeýva pernambuco (tetãvore))	NOCHANGE
(avati’i oñemitỹva oñangareko va’erã avei arapytu rehe)	(avati’i oñemitỹva oñangareko va’erã avei arapytu rehe)	NOCHANGE
Ñembyasy ha vy’ápe ñaime oñondive	Ñembyasy ha vy’ápe ñaime oñondive	NOCHANGE
Ha peteĩ mbarakaja ombohovái sapukáipe, guataha kyhyje, pya’e opiãva ka’arúre.	Ha peteĩ mbarakaja ombohovái sapukáipe, guataha kyhyje, pya’e opiãva ka’arúre.	NOCHANGE
Ñemby ñemuha	Ñemby ñemuha	NOCHANGE
A yvy aty hesa re.	A yvy aty hesa re.	NOCHANGE
Oñemombarete pe jehai porã ha arte apo, opavavete ohupyty ha oguerovy’a	Oñemombarete pe jehai porã ha arte apo, opavavete ohupyty ha oguerovy’a	NOCHANGE
Ojehechakuaa heta mba’e iporãva.	Ojehechakuaa heta mba’e iporãva.	NOCHANGE
Nomanomo’ãi guarani ñe’ê.... cheñe’ê oikove	Nomanomo’ãi guarani ñe’ê.... cheñe’ê oikove	NOCHANGE
Ha’ekuéra oguahẽtama.	Ha’ekuéra oguahẽtama.	NOCHANGE
Ñemotĩ niko ha’u,	Ñemotĩ niko ha’u,	NOCHANGE
Tapichakuéra ha’e toryja oipotavo térã ojejapórõ pe ndaha’eíva	Tapichakuéra ha’e toryja oipotavo térã ojejapórõ pe ndaha’eíva	NOCHANGE
Taitachu omoñe’ẽ ijaguara’ýpe.	Taitachu omoñe’ẽ ijaguara’ýpe.	NOCHANGE
Omotenondeve ñane avañe’ê.	Omotenondeve ñane avañe’ê.	NOCHANGE
Oĩ mba’e renda guasu	Oĩ mba’e renda guasu	NOCHANGE
Ne ñe’ẽ opyta che akãme	Ne ñe’ẽ opyta che akãme	NOCHANGE
Opaichagua, terã avei umi ñe’ẽ me’ẽ jehaipyre omoañetéva tembe’y rehegua, omomarandu jevy	Opaichagua, terã avei umi ñe’ẽ me’ẽ jehaipyre omoañetéva tembe’y rehegua, omomarandu jevy	NOCHANGE
Tekovekuaaty ñemohenda	Tekovekuaaty ñemohenda	NOCHANGE
Ñane retã árape	Ñane retã árape	NOCHANGE
Mba’e ñemboro’yra ano’a va’égy	Mba’e ñemboro’yra ano’a va’égy	NOCHANGE
Ndaikuaái ojehúva chéve, che ko’ênte sapy’a	Ndaikuaái ojehúva chéve, che ko’ênte sapy’a	NOCHANGE
Aguara ohasáramo taperã rupi, pe máva oñedesatina, oikuaa porãramo jepe tape.	Aguara ohasáramo taperã rupi, pe máva oñedesatina, oikuaa porãramo jepe tape.	NOCHANGE
Ha so’o repyrãitére katuĩnte neypytũ.	Ha so’o repyrãitére katuĩnte neypytũ.	NOCHANGE
Hembiapohápe, oĩ aja upe gobernador omoĩ va’ekue ichupe.	Hembiapohápe, oĩ aja upe gobernador omoĩ va’ekue ichupe.	NOCHANGE
Porã rerekua ko’ẽ potyju ne ma’ẽ mimbíva,	Porã rerekua ko’ẽ potyju ne ma’ẽ mimbíva,	NOCHANGE
Tetã andorra	Tetã andorra	NOCHANGE
Ndamáko henda porã.	Ndamáko henda porã.	NOCHANGE
Ko mymba osapukáikatu hatã.	Ko mymba osapukáikatu hatã.	NOCHANGE
Umi hembiapokue apytépe oĩ ñe’ẽpoty ha’e ohaiva’ekue ha avei	Umi hembiapokue apytépe oĩ ñe’ẽpoty ha’e ohaiva’ekue ha avei	NOCHANGE
Ndéngo avei táva ypykue ko ñane retâme ha	Ndéngo avei táva ypykue ko ñane retâme ha	NOCHANGE
Upe tesorero ndopagái va’erã mba’eve, ndaha’éirõ contador oipota va’ekue	Upe tesorero ndopagái va’erã mba’eve, ndaha’éirõ contador oipota va’ekue	NOCHANGE
Japaymi, ha ñapu’ã, ha upéi jasapukái.	Japaymi, ha ñapu’ã, ha upéi jasapukái.	NOCHANGE
Ndaikatuiva’ekue oñemoarandu tetã ñe’ẽ	Ndaikatuiva’ekue oñemoarandu tetã ñe’ẽ	NOCHANGE
Nde purahéi.	Nde purahéi.	NOCHANGE
Okúirõ constitución reko rehegua, opa omba’apóva hérape, ha’etérõ guáicha, ojerereko va’erã	Okúirõ constitución reko rehegua, opa omba’apóva hérape, ha’etérõ guáicha, ojerereko va’erã	NOCHANGE
Prénsa omoherakuãva upe rupi, ñe’ẽ niko	Prénsa omoherakuãva upe rupi, ñe’ẽ niko	NOCHANGE
Re oma’ẽ rã imbo’y oĩ ramo.	Re oma’ẽ rã imbo’y oĩ ramo.	NOCHANGE
Mba’e vai jajapóva ndoguerui py’aro ha a’e’ỹ ogueruhaícha ñande rembiapo porã	Mba’e vai jajapóva ndoguerui py’aro ha a’e’ỹ ogueruhaícha ñande rembiapo porã	NOCHANGE
Oiko porã i anguã.	Oiko porã i anguã.	NOCHANGE
Ka’apiky rovyû asy heñói che korapýpe.	Ka’apiky rovyû asy heñói che korapýpe.	NOCHANGE
Ha ñande, maymáva,	Ha ñande, maymáva,	NOCHANGE
Ha umi ore joyke’y kuimba’e ha kuñándi oikóva tekove rembe’ýre,	Ha umi ore joyke’y kuimba’e ha kuñándi oikóva tekove rembe’ýre,	NOCHANGE
Mitãnguérape oñembo’e mbo’ehaópe mba’éichapa oñangarekova’erã hetére.	Mitãnguérape oñembo’e mbo’ehaópe mba’éichapa oñangarekova’erã hetére.	NOCHANGE
Oipytyvõvaoeerã avei oñemyesakã hagua opa mbaoee	Oipytyvõvaoeerã avei oñemyesakã hagua opa mbaoee	NOCHANGE
Mba’éichapa mbo’ehára che rera kevin	Mba’éichapa mbo’ehára che rera kevin	NOCHANGE
Oikepaite mba’e tavarandugua oñemombytáva ñane apytu’ũme, tekotevẽ’ỹre jahecha	Oikepaite mba’e tavarandugua oñemombytáva ñane apytu’ũme, tekotevẽ’ỹre jahecha	NOCHANGE
Nañaromandu’ái arakuéra, ñaromandu’a sapy’aguakuéra	Nañaromandu’ái arakuéra, ñaromandu’a sapy’aguakuéra	NOCHANGE
Kóva ko che ayvu atýpe	Kóva ko che ayvu atýpe	NOCHANGE
Ko táva hernandarias rehe ojere ysyry guasu parana ha akaray.	Ko táva hernandarias rehe ojere ysyry guasu parana ha akaray.	NOCHANGE
Nde réra oikóva	Nde réra oikóva	NOCHANGE
Kóva hina tau ha kerana memby poteĩha. oje’e ao ao oikoha	Kóva hina tau ha kerana memby poteĩha. oje’e ao ao oikoha	NOCHANGE
Porã mba’épepa ombyaí aiguéne tekohápe.	Porã mba’épepa ombyaí aiguéne tekohápe.	NOCHANGE
Ha’éicha aturuñe’ẽ	Ha’éicha aturuñe’ẽ	NOCHANGE
Che ñe’ã mbytetépe nde rehe.	Che ñe’ã mbytetépe nde rehe.	NOCHANGE
Mburikao reguerokañyva’ekue kuehe che vy’a’ỹ	Mburikao reguerokañyva’ekue kuehe che vy’a’ỹ	NOCHANGE
(ojehechauka tembiapokuéra ka’a rehegua jovere távaygua kuéra pe)	(ojehechauka tembiapokuéra ka’a rehegua jovere távaygua kuéra pe)	NOCHANGE
Jasyapýpe jajupaite jeýma mbo’ehaópe.	Jasyapýpe jajupaite jeýma mbo’ehaópe.	NOCHANGE
Umi ndaikatuíva oje’e oñeguerokirirĩvaerã	Umi ndaikatuíva oje’e oñeguerokirirĩvaerã	NOCHANGE
Iberoamericana-pe, oñembohape haguã pe iberoamérica kuatia ñe’ê	Iberoamericana-pe, oñembohape haguã pe iberoamérica kuatia ñe’ê	NOCHANGE
Ombojegua ko táva,	Ombojegua ko táva,	NOCHANGE
Ñembyahýi ha vare’a.	Ñembyahýi ha vare’a.	NOCHANGE
Opárupi tavaygua peguarã. mburuvicha kuéra omba’apo va’erã upéicha. avave mburuvicha	Opárupi tavaygua peguarã. mburuvicha kuéra omba’apo va’erã upéicha. avave mburuvicha	NOCHANGE
Ha iporã che róga ára pyharépe	Ha iporã che róga ára pyharépe	NOCHANGE
Oñembyasýva ko yvy apére oĩ aja,	Oñembyasýva ko yvy apére oĩ aja,	NOCHANGE
Ha umi ambue kuéra vicho okyhyje voi guasúgui.	Ha umi ambue kuéra vicho okyhyje voi guasúgui.	NOCHANGE
Kóva ohechauka mávapa ñe’ẽtéva omoandúva apohare.	Kóva ohechauka mávapa ñe’ẽtéva omoandúva apohare.	NOCHANGE
Ojehechaukáva opáicha rei.pe iberoamérica renda oñemombarete haguã ojehechakuaa va’erã umi	Ojehechaukáva opáicha rei.pe iberoamérica renda oñemombarete haguã ojehechakuaa va’erã umi	NOCHANGE
(aty guasu oñemba’apo haguã so’o paraguaigua rehe)	(aty guasu oñemba’apo haguã so’o paraguaigua rehe)	NOCHANGE
Oñepyrũ ko tetãme	Oñepyrũ ko tetãme	NOCHANGE
Hyakuãvu paraguay, ko yvága ja’eha.	Hyakuãvu paraguay, ko yvága ja’eha.	NOCHANGE
Upévare ára ha ára	Upévare ára ha ára	NOCHANGE
-aipórõ piko mokõive ojoja imbaretekuépe -he’i upe oñe’ẽva- upéicharõ nenupãjeyva’erã hikuái jahechávo mávapa oinupã hatãve.	-aipórõ piko mokõive ojoja imbaretekuépe -he’i upe oñe’ẽva- upéicharõ nenupãjeyva’erã hikuái jahechávo mávapa oinupã hatãve.	NOCHANGE
Ha ñande resápe	Ha ñande resápe	NOCHANGE
Pévare ñe’ẽporã añoiténte ãngagui ñanohẽ va’erã.	Pévare ñe’ẽporã añoiténte ãngagui ñanohẽ va’erã.	NOCHANGE
Omoi ka’i ijyva guýpe ha oipykúi hóga rape. oguãhê, oheka	Omoi ka’i ijyva guýpe ha oipykúi hóga rape. oguãhê, oheka	NOCHANGE
Oñeñangareko va’erã óga ojejapo va’ekue upevarã anihaguáicha oñembyai hete ha iñakã rehegua.	Oñeñangareko va’erã óga ojejapo va’ekue upevarã anihaguáicha oñembyai hete ha iñakã rehegua.	NOCHANGE
Heñói ha okakuaa,	Heñói ha okakuaa,	NOCHANGE
Ha akóinte neresâita...	Ha akóinte neresâita...	NOCHANGE
Hi’a ko tape pyahu vokóinte ñaroguahe.	Hi’a ko tape pyahu vokóinte ñaroguahe.	NOCHANGE
Tetã rekuái	Tetã rekuái	NOCHANGE
. kunu’ũ heñói hague mainumby jerokyha	. kunu’ũ heñói hague mainumby jerokyha	NOCHANGE
Ipype omohe’õ	Ipype omohe’õ	NOCHANGE
Ku ko’ẽ pytã jave,	Ku ko’ẽ pytã jave,	NOCHANGE
Ore retâ, ore ñe’â,	Ore retâ, ore ñe’â,	NOCHANGE
Ha che katu ndajuhúi umi ñe’ê	Ha che katu ndajuhúi umi ñe’ê	NOCHANGE
Y oveve ñe’ẽicha ome’ẽ tekove	Y oveve ñe’ẽicha ome’ẽ tekove	NOCHANGE
Upépe katu oñembohoryvéma hese hikuái, ova ova yvyra rakãre, opuka ha oiporavo yva iporãvéva tujamíme ohechauka.	Upépe katu oñembohoryvéma hese hikuái, ova ova yvyra rakãre, opuka ha oiporavo yva iporãvéva tujamíme ohechauka.	NOCHANGE
Mavave mburuvicha nidkatúi omomarã upe táva autonomía-pe, oĩva ko constitución-pe, ha sapy’a	Mavave mburuvicha nidkatúi omomarã upe táva autonomía-pe, oĩva ko constitución-pe, ha sapy’a	NOCHANGE
. anichéva’erã tapykue opyta imba’eteéva	. anichéva’erã tapykue opyta imba’eteéva	NOCHANGE
Ojereraha tupão ka’akupépe. ko’ága peve pe ta’anga oime tupão ka’akupépe ha upepeve	Ojereraha tupão ka’akupépe. ko’ága peve pe ta’anga oime tupão ka’akupépe ha upepeve	NOCHANGE
. upete guive ha’ára pa’ikuéra arapýpe	. upete guive ha’ára pa’ikuéra arapýpe	NOCHANGE
Ko táva oñemohenda peteĩ tenda yvatépe ha ojerepa hese yvytyeta omoporãmba jepéva.	Ko táva oñemohenda peteĩ tenda yvatépe ha ojerepa hese yvytyeta omoporãmba jepéva.	NOCHANGE
Ha’ekuéra ojapouka onohẽuka	Ha’ekuéra ojapouka onohẽuka	NOCHANGE
Hu’itĩ ñaikotevẽ soparã	Hu’itĩ ñaikotevẽ soparã	NOCHANGE
Umi mba’e jahasáva rupive jahechakuaa	Umi mba’e jahasáva rupive jahechakuaa	NOCHANGE
Pehechaukáramo peikotevẽha oimeraẽ mba’e, noñeme’ẽmo’ai peẽme mba’eve. jejapohaguã pirapire heta ñeikotevẽ pejejapo iviruhetávaramo	Pehechaukáramo peikotevẽha oimeraẽ mba’e, noñeme’ẽmo’ai peẽme mba’eve. jejapohaguã pirapire heta ñeikotevẽ pejejapo iviruhetávaramo	NOCHANGE
Ku mitã kambúicha herekua ku’áre.	Ku mitã kambúicha herekua ku’áre.	NOCHANGE
Méhiko pyahu, tetãvore joapykuéra	Méhiko pyahu, tetãvore joapykuéra	NOCHANGE
. che ñe’ãme purahéi hokyva’ekue	. che ñe’ãme purahéi hokyva’ekue	NOCHANGE
Peteĩ ñemuha viru omba’eapo añónteva ha’e peteĩ ñemuha mboriahu	Peteĩ ñemuha viru omba’eapo añónteva ha’e peteĩ ñemuha mboriahu	NOCHANGE
Kóva niko ñande ára	Kóva niko ñande ára	NOCHANGE
Roguerohory. iporã chéve. hechapyrã.	Roguerohory. iporã chéve. hechapyrã.	NOCHANGE
Yvy ha yvága nde rehechapa,	Yvy ha yvága nde rehechapa,	NOCHANGE
Opa mburuvicha tekotevẽ omombe’u opa kuatia ñe’ẽ japu ha tembiapo aigue oñemoherakuãva	Opa mburuvicha tekotevẽ omombe’u opa kuatia ñe’ẽ japu ha tembiapo aigue oñemoherakuãva	NOCHANGE
Mba’éichapa oñemonguerakuaa	Mba’éichapa oñemonguerakuaa	NOCHANGE
Ñe’ẽ, paraguái ñe’ẽ teeháicha, ojepuru	Ñe’ẽ, paraguái ñe’ẽ teeháicha, ojepuru	NOCHANGE
Ary... eterno ary.	Ary... eterno ary.	NOCHANGE
Tapicha marina-guápe.	Tapicha marina-guápe.	NOCHANGE
Ro’y ha mbyry’ái ohasáva ohóvo,	Ro’y ha mbyry’ái ohasáva ohóvo,	NOCHANGE
Ñe’ẽriregua jaipurukuaa opaichagua ñe’ẽ ndive ha omohesakã mba’éicha, araka’e, mamo, mba’ére ojehu ñe’ẽ ijykeregua omoandúva.	Ñe’ẽriregua jaipurukuaa opaichagua ñe’ẽ ndive ha omohesakã mba’éicha, araka’e, mamo, mba’ére ojehu ñe’ẽ ijykeregua omoandúva.	NOCHANGE
Vy’apavẽ ha’e mba’etee opave’ỹva reñembojapu porãgui rupi	Vy’apavẽ ha’e mba’etee opave’ỹva reñembojapu porãgui rupi	NOCHANGE
Nde rehaiguýva hese.	Nde rehaiguýva hese.	NOCHANGE
Avei topopo umi ñe’ẽ topo toikove	Avei topopo umi ñe’ẽ topo toikove	NOCHANGE
Kame oho ojogua hagua peteĩ jopói	Kame oho ojogua hagua peteĩ jopói	NOCHANGE
Heseguakuéra hína chamakóko ha moro (ajoréo).	Heseguakuéra hína chamakóko ha moro (ajoréo).	NOCHANGE
Tetãmini tuichakue peve oñeme’ẽne ñeha’ã ikatu haguã oñemomýi, guahẽ oiko haguã ha’eñõ umi	Tetãmini tuichakue peve oñeme’ẽne ñeha’ã ikatu haguã oñemomýi, guahẽ oiko haguã ha’eñõ umi	NOCHANGE
Guasu óga kupépe oĩva rehe.	Guasu óga kupépe oĩva rehe.	NOCHANGE
Ko che ñe’âkuápekatu taipoty	Ko che ñe’âkuápekatu taipoty	NOCHANGE
Ñanembohasy ramo (envenenamiento oje’éva chupe), ñande py’águi ñañeñandu vai ramo , kuña	Ñanembohasy ramo (envenenamiento oje’éva chupe), ñande py’águi ñañeñandu vai ramo , kuña	NOCHANGE
Atyñe’ẽ oñemongeta haguã tembiapokuéra ka’arehegua)	Atyñe’ẽ oñemongeta haguã tembiapokuéra ka’arehegua)	NOCHANGE
Ju’i, kururu, karuguáre oñe’ê.	Ju’i, kururu, karuguáre oñe’ê.	NOCHANGE
Che ñe’ẽmi kuatiápe	Che ñe’ẽmi kuatiápe	NOCHANGE
Ñemiháme. oikóje ohapera’arõ mitãkuña osẽva asajerei hógagui, kurupi ojuráne katuete ha ogueraha	Ñemiháme. oikóje ohapera’arõ mitãkuña osẽva asajerei hógagui, kurupi ojuráne katuete ha ogueraha	NOCHANGE
Che retã, ku yvotytýpe, opytáva mombyry.	Che retã, ku yvotytýpe, opytáva mombyry.	NOCHANGE
Ñemongakuaa ojupe, oñeme’ê memehápe mba’e porã jehechauka	Ñemongakuaa ojupe, oñeme’ê memehápe mba’e porã jehechauka	NOCHANGE
Ha tahendu yvytu jurúpe ñe’ẽ ñane mondýiva.	Ha tahendu yvytu jurúpe ñe’ẽ ñane mondýiva.	NOCHANGE
Tesarái mboyve.	Tesarái mboyve.	NOCHANGE
Hagua omanóvape), hembipurukuéra yvy, ita ha kanguégui ijapopyréva.	Hagua omanóvape), hembipurukuéra yvy, ita ha kanguégui ijapopyréva.	NOCHANGE
Opa mba’e rerekóvape,	Opa mba’e rerekóvape,	NOCHANGE
Mba’asykuérape guarâ.	Mba’asykuérape guarâ.	NOCHANGE
Ombokuatia ha oñekuave’ẽ	Ombokuatia ha oñekuave’ẽ	NOCHANGE
Ikatuva’erã nipo che ichugui añembyesarái.	Ikatuva’erã nipo che ichugui añembyesarái.	NOCHANGE
Tohekýimba’e (ha’ekuéra) tomoĩmba’e (ha’ekuéra)	Tohekýimba’e (ha’ekuéra) tomoĩmba’e (ha’ekuéra)	NOCHANGE
Pya’e ajohéipata che ao.	Pya’e ajohéipata che ao.	NOCHANGE
Opáichagua yvoty ombojegua che róga.	Opáichagua yvoty ombojegua che róga.	NOCHANGE
Kame oho hagua ojogua peteĩ jopói	Kame oho hagua ojogua peteĩ jopói	NOCHANGE
Ojeguerekóva upérõ paraguaýpe (paraguaýpe) oipytyvõva ichupe ijeho	Ojeguerekóva upérõ paraguaýpe (paraguaýpe) oipytyvõva ichupe ijeho	NOCHANGE
He’iséva. mymba okambúva, oikóva so’óre, ipyapê ha hâi mbaretéva.	He’iséva. mymba okambúva, oikóva so’óre, ipyapê ha hâi mbaretéva.	NOCHANGE
Oĩramo tekotevê tuichava, oĩ tapicha ogueroviahãguaicha opa mba’e	Oĩramo tekotevê tuichava, oĩ tapicha ogueroviahãguaicha opa mba’e	NOCHANGE
Ñembo’e rangua.	Ñembo’e rangua.	NOCHANGE
Ko’ã ñe’ẽriregua ojoaju’arã ñe’ẽ ijykereguáre.	Ko’ã ñe’ẽriregua ojoaju’arã ñe’ẽ ijykereguáre.	NOCHANGE
Ñande ypykuéra ka’aguygua ojesarekóva iñe’ê rehe.	Ñande ypykuéra ka’aguygua ojesarekóva iñe’ê rehe.	NOCHANGE
Opavave tekotevê jaikuaa ko arapy tuichaitépe opa mba’e oñepyrûva ijapyva’erâ.	Opavave tekotevê jaikuaa ko arapy tuichaitépe opa mba’e oñepyrûva ijapyva’erâ.	NOCHANGE
Ha oikytĩ ñande resa	Ha oikytĩ ñande resa	NOCHANGE
Tetãnguéra joaju poyvi	Tetãnguéra joaju poyvi	NOCHANGE
Ñe’ẽriregua -iñe’ẽpehẽtei ha iñe’ẽpehẽ’etáva- ojepuru ha ojehai jave, katuete ohova’erã peteĩ ñe’ẽ rire.	Ñe’ẽriregua -iñe’ẽpehẽtei ha iñe’ẽpehẽ’etáva- ojepuru ha ojehai jave, katuete ohova’erã peteĩ ñe’ẽ rire.	NOCHANGE
Heta ára ohasa rire pe tupãsy ra’anga michĩvéva oguereko’ákue hógape hose,	Heta ára ohasa rire pe tupãsy ra’anga michĩvéva oguereko’ákue hógape hose,	NOCHANGE
He’iséva ñembojarupe gua nda ha’eteeiva.	He’iséva ñembojarupe gua nda ha’eteeiva.	NOCHANGE
Ko tetã pytuhẽ.	Ko tetã pytuhẽ.	NOCHANGE
Ha’ekuéra ojapo kuri kuehe.	Ha’ekuéra ojapo kuri kuehe.	NOCHANGE
Che ndaha’éi pa’i ni pa’irã, nde ndaha’eihaicha pa’ikue ni pa’i rãngue. mokõivéva rasa ñande reko vai. che uvei niko akaru rupi	Che ndaha’éi pa’i ni pa’irã, nde ndaha’eihaicha pa’ikue ni pa’i rãngue. mokõivéva rasa ñande reko vai. che uvei niko akaru rupi	NOCHANGE
Tekoayhu ndaha’ei ñeme’ẽ, hákatu ñorairõ joja’ỹrekópe	Tekoayhu ndaha’ei ñeme’ẽ, hákatu ñorairõ joja’ỹrekópe	NOCHANGE
Ha ñande rehegua.	Ha ñande rehegua.	NOCHANGE
Kirito omano ñande angaipakuérare. ñañanimanepa jaheja mba’e vai apo ha jajapo tekotevẽ’ỹ ijehasa asyete	Kirito omano ñande angaipakuérare. ñañanimanepa jaheja mba’e vai apo ha jajapo tekotevẽ’ỹ ijehasa asyete	NOCHANGE
Nde juru pytã	Nde juru pytã	NOCHANGE
Materiais - mba’e ha’erã	Materiais - mba’e ha’erã	NOCHANGE
Ko’ã mba’e porãita	Ko’ã mba’e porãita	NOCHANGE
Ivi iporã yoguirekovae retape, oñemboete vaerã	Ivi iporã yoguirekovae retape, oñemboete vaerã	NOCHANGE
Omboypáma ko tetã.	Omboypáma ko tetã.	NOCHANGE
Joyke’y paraguái, iporãma	Joyke’y paraguái, iporãma	NOCHANGE
Heñoi... sapy’a ñande ava ñe’ẽ purahéi joyvýpe	Heñoi... sapy’a ñande ava ñe’ẽ purahéi joyvýpe	NOCHANGE
Heñói ha oikove	Heñói ha oikove	NOCHANGE
Ñe’ẽasãihára ypykuérava omoherakuãporãseve iñe’ẽ ha iñarandupykuéra	Ñe’ẽasãihára ypykuérava omoherakuãporãseve iñe’ẽ ha iñarandupykuéra	NOCHANGE
Ohóva tetã ambuére oguerekóva, opaite ojehechaukaháicha, tuichamba’e	Ohóva tetã ambuére oguerekóva, opaite ojehechaukaháicha, tuichamba’e	NOCHANGE
Guive iñe’ẽ ypykuépe, isy ñe’ẽme ha	Guive iñe’ẽ ypykuépe, isy ñe’ẽme ha	NOCHANGE
Hetaite ñe’ẽpoty poravopyre kuña ñe’ãme oñongatu porãva	Hetaite ñe’ẽpoty poravopyre kuña ñe’ãme oñongatu porãva	NOCHANGE
Pe tekopykuaa mba’e porã ojeporu joáramo, hosã katuete ha opavave	Pe tekopykuaa mba’e porã ojeporu joáramo, hosã katuete ha opavave	NOCHANGE
Ani nde resarái che ñe’ẽgui,	Ani nde resarái che ñe’ẽgui,	NOCHANGE
Ma’ẽrã oikóta ñane ko’ẽrõ ñamyakãsã guive umi peky	Ma’ẽrã oikóta ñane ko’ẽrõ ñamyakãsã guive umi peky	NOCHANGE
Ára ha pyhare.	Ára ha pyhare.	NOCHANGE
Táva guasu tohuguãitĩ,	Táva guasu tohuguãitĩ,	NOCHANGE
Tetã paraguái momorãhéi	Tetã paraguái momorãhéi	NOCHANGE
Kuérape. ijapyte kuéra guágui ojeporavo va’erã peteĩ presidente, oñembopyahúva opa ary.	Kuérape. ijapyte kuéra guágui ojeporavo va’erã peteĩ presidente, oñembopyahúva opa ary.	NOCHANGE
Ohechauka chéve ija’eha cherehe amo karai.	Ohechauka chéve ija’eha cherehe amo karai.	NOCHANGE
-mba’ére peju péicha.oi orendive kuña ha mitá .pepytána ñañemongeta.	-mba’ére peju péicha.oi orendive kuña ha mitá .pepytána ñañemongeta.	NOCHANGE
Ko kokue apu’a’ípe	Ko kokue apu’a’ípe	NOCHANGE
Pohã ñana, mba’éichapa ojeipuru	Pohã ñana, mba’éichapa ojeipuru	NOCHANGE
Tetãmini ha táva mba’e.	Tetãmini ha táva mba’e.	NOCHANGE
(che agueroviáta gueterei, jepémo tapichakuéra ndojeroviavéi.	(che agueroviáta gueterei, jepémo tapichakuéra ndojeroviavéi.	NOCHANGE
I ñembyahýi.	I ñembyahýi.	NOCHANGE
Oguerekoje ipoguýpe umi karugua guasu, tuju ha y renda ojepysóva ñúre.	Oguerekoje ipoguýpe umi karugua guasu, tuju ha y renda ojepysóva ñúre.	NOCHANGE
Ko’êrõ ka’aru eñembopoja tereho kokuépe	Ko’êrõ ka’aru eñembopoja tereho kokuépe	NOCHANGE
Ñande ypykuéra ojapo mboguaha ha ombohéra yrupê.	Ñande ypykuéra ojapo mboguaha ha ombohéra yrupê.	NOCHANGE
Ojejohéi jey umi yva y ro’ysãme, ojejopy vevuimiva’erã pevarã peteĩteĩ ha ojeity jey y ro’ysã upe mboyve oñemoĩ haguépema eira hũ.	Ojejohéi jey umi yva y ro’ysãme, ojejopy vevuimiva’erã pevarã peteĩteĩ ha ojeity jey y ro’ysã upe mboyve oñemoĩ haguépema eira hũ.	NOCHANGE
Marandu ciencia reheguáva avei.	Marandu ciencia reheguáva avei.	NOCHANGE
Upéva hína omomoyiva ñane rembiapo.	Upéva hína omomoyiva ñane rembiapo.	NOCHANGE
Tenonderãrupi jepeve, ndaha’éirõ caso de urgencia ha oikuahauka va’erã upe ñehenóime	Tenonderãrupi jepeve, ndaha’éirõ caso de urgencia ha oikuahauka va’erã upe ñehenóime	NOCHANGE
Tembipurukuéra apytépe oikotevẽva ára ha ára oĩ, kytĩha, kytĩha tuicha ha hácha, péicha avei mboka. oñembojoapy arco ha macana.	Tembipurukuéra apytépe oikotevẽva ára ha ára oĩ, kytĩha, kytĩha tuicha ha hácha, péicha avei mboka. oñembojoapy arco ha macana.	NOCHANGE
Ohechaukáva yvyra ñemoingove ko tetãme ha ijyvyporápe.	Ohechaukáva yvyra ñemoingove ko tetãme ha ijyvyporápe.	NOCHANGE
Upéi, pyhareve peteĩ, kuarahy aku guahẽme, ára pa-	Upéi, pyhareve peteĩ, kuarahy aku guahẽme, ára pa-	NOCHANGE
Ombojeguáva nde reko.	Ombojeguáva nde reko.	NOCHANGE
Táva guasu tohuguatĩ,	Táva guasu tohuguatĩ,	NOCHANGE
Paraguaigua oguereko gueteri pe sasõ ypykue rehegua. isasõ guive hyepýpe oĩporãma.	Paraguaigua oguereko gueteri pe sasõ ypykue rehegua. isasõ guive hyepýpe oĩporãma.	NOCHANGE
Maravichu ,kujererã ha heta mba’e. aha’ãro ko tembiapo oikũmby	Maravichu ,kujererã ha heta mba’e. aha’ãro ko tembiapo oikũmby	NOCHANGE
Ha upéi peteĩ ára che symíndie asẽ aha	Ha upéi peteĩ ára che symíndie asẽ aha	NOCHANGE
(oñembohapejeýva paraýva (tetãvore))	(oñembohapejeýva paraýva (tetãvore))	NOCHANGE
Ava rembiasakue yvy ape ári heñói guive	Ava rembiasakue yvy ape ári heñói guive	NOCHANGE
Tacurú puku oñembohéra va’ekue ko tenda, hetaite rupi isarambi ko’árupi umi kupi’ikuéra oĩhetaitéva ha omopu’ãva ápe ha pépe hogarã.	Tacurú puku oñembohéra va’ekue ko tenda, hetaite rupi isarambi ko’árupi umi kupi’ikuéra oĩhetaitéva ha omopu’ãva ápe ha pépe hogarã.	NOCHANGE
Ojapo peteĩ kaguy, upevarã ombojehe’a yvope a, eíra, avati térã kurapepẽ ha oha’ãrõ hái.	Ojapo peteĩ kaguy, upevarã ombojehe’a yvope a, eíra, avati térã kurapepẽ ha oha’ãrõ hái.	NOCHANGE
Ore rejava mba’e mbyasýpe	Ore rejava mba’e mbyasýpe	NOCHANGE
Ko’ãva katu heñói mokõi térã hetave ñe’ẽgui. jepémo sapy’ánte ñe’ẽ ha he’iséva tuicha ojoavy hemiandúpe.	Ko’ãva katu heñói mokõi térã hetave ñe’ẽgui. jepémo sapy’ánte ñe’ẽ ha he’iséva tuicha ojoavy hemiandúpe.	NOCHANGE
Oúma opyta.	Oúma opyta.	NOCHANGE
Ñandejára ko che mboúva.	Ñandejára ko che mboúva.	NOCHANGE
Omba’apova’ekue upe atýpe	Omba’apova’ekue upe atýpe	NOCHANGE
Peteĩ kuña oporomomembýva.	Peteĩ kuña oporomomembýva.	NOCHANGE
Ñembojoaju mokõi tekove tekorã rupive.	Ñembojoaju mokõi tekove tekorã rupive.	NOCHANGE
O ñembosarái she rehe.	O ñembosarái she rehe.	NOCHANGE
Ko arapýpe ndojejuhúi ha’eichagua ikatupyrýva pumbasy apópe. iporã ha iporãvéva ojapo, ohupi yvateve pumbasy oikotevẽva mbarakakatepu.	Ko arapýpe ndojejuhúi ha’eichagua ikatupyrýva pumbasy apópe. iporã ha iporãvéva ojapo, ohupi yvateve pumbasy oikotevẽva mbarakakatepu.	NOCHANGE
Ojapyhy ñandejára ñe’ẽ ha omoĩ nderekovépe.	Ojapyhy ñandejára ñe’ẽ ha omoĩ nderekovépe.	NOCHANGE
Tape guasu táva mbukarétepe.	Tape guasu táva mbukarétepe.	NOCHANGE
Topami pe ñembyahýi mba’epota	Topami pe ñembyahýi mba’epota	NOCHANGE
Tavakuéra ha tenda ambuéva mauritáñame	Tavakuéra ha tenda ambuéva mauritáñame	NOCHANGE
Oyvárapy mba’ekuaágui,	Oyvárapy mba’ekuaágui,	NOCHANGE
Arapasu hovy tetãvore parana, pindorama.	Arapasu hovy tetãvore parana, pindorama.	NOCHANGE
Ha’ekuérakatu añeteguáicha, ombohovái ha opukavymi.	Ha’ekuérakatu añeteguáicha, ombohovái ha opukavymi.	NOCHANGE
Peteĩ hendápe imbaretejoa.	Peteĩ hendápe imbaretejoa.	NOCHANGE
Ára pukukue.	Ára pukukue.	NOCHANGE
Ndaipóri guasu ñe’ê oñepyrûva ko tai ndive.	Ndaipóri guasu ñe’ê oñepyrûva ko tai ndive.	NOCHANGE
Tetã rehegua	Tetã rehegua	NOCHANGE
- ko’ága guive oikóta ndehegui yvyra porupyrã.	- ko’ága guive oikóta ndehegui yvyra porupyrã.	NOCHANGE
Ndaipóri mba’e mbyasy	Ndaipóri mba’e mbyasy	NOCHANGE
Ka’aguýpe ojejapo ha tupâópe opa	Ka’aguýpe ojejapo ha tupâópe opa	NOCHANGE
Ñande rekove ombogue,	Ñande rekove ombogue,	NOCHANGE
Nde rupive ko ñane retâme opavavete oikuaa	Nde rupive ko ñane retâme opavavete oikuaa	NOCHANGE
Ko yvóra ha’égui umi ipy’aguasúva mba’énte.	Ko yvóra ha’égui umi ipy’aguasúva mba’énte.	NOCHANGE
Temimbo’e apouka reheguáicha, amokuave’ê ko che	Temimbo’e apouka reheguáicha, amokuave’ê ko che	NOCHANGE
Chéve ome’ẽ tasẽse.	Chéve ome’ẽ tasẽse.	NOCHANGE
Ñe’ẽrembyre ñe’ẽjopara	Ñe’ẽrembyre ñe’ẽjopara	NOCHANGE
Ijojaha’ỹva porãgui, araka’eve ojehecha’ỹva’ekue mamove.	Ijojaha’ỹva porãgui, araka’eve ojehecha’ỹva’ekue mamove.	NOCHANGE
Umi oguerekóva imombopyrã.	Umi oguerekóva imombopyrã.	NOCHANGE
Táva tuichavéva	Táva tuichavéva	NOCHANGE
Ituja heko asyvéva, ha ojeheja va’ekue ha’eñõme, upévarã ha’eite terã ambue pyvéi	Ituja heko asyvéva, ha ojeheja va’ekue ha’eñõme, upévarã ha’eite terã ambue pyvéi	NOCHANGE
Jojaha -kuimba’ekuéra ha kuñakuérai- oha’ãrõ katuete.	Jojaha -kuimba’ekuéra ha kuñakuérai- oha’ãrõ katuete.	NOCHANGE
(oñembohapejeýva tuichave tetãyguakuéra tetã rehe)	(oñembohapejeýva tuichave tetãyguakuéra tetã rehe)	NOCHANGE
Ñavõ ka’aru oñembyatypáva ku ne rembe’ýre	Ñavõ ka’aru oñembyatypáva ku ne rembe’ýre	NOCHANGE
Oikove ñúre, opaite yvóra renda. ko mymba aty ohaitypo guasuhápe. haity guasu apopyre yvyra, ita, ha ambueva.	Oikove ñúre, opaite yvóra renda. ko mymba aty ohaitypo guasuhápe. haity guasu apopyre yvyra, ita, ha ambueva.	NOCHANGE
Mboriahúnte omyatãva ñane retã paraguái.	Mboriahúnte omyatãva ñane retã paraguái.	NOCHANGE
Yvy jave re,	Yvy jave re,	NOCHANGE
Takuarembo (táva)	Takuarembo (táva)	NOCHANGE
Ombohovái umi mba’e iñypytũ, hypy’ũ, jahecha’ỹ ha jaikuaaporã’ỹva, jepémo	Ombohovái umi mba’e iñypytũ, hypy’ũ, jahecha’ỹ ha jaikuaaporã’ỹva, jepémo	NOCHANGE
Tenda ojehechaukahápe máva rembiapo ñeha’ãnga.	Tenda ojehechaukahápe máva rembiapo ñeha’ãnga.	NOCHANGE
Umi mba’asy tekove rasẽ ñe’ẽ	Umi mba’asy tekove rasẽ ñe’ẽ	NOCHANGE
Ohechaporãkuaáva ha’e pe ogueroviava mba’ekuéra ndaikatuiha ivaíve	Ohechaporãkuaáva ha’e pe ogueroviava mba’ekuéra ndaikatuiha ivaíve	NOCHANGE
Oñemongaraiva’ekue. ha’e ojapo ta’anga tupãope guarã.	Oñemongaraiva’ekue. ha’e ojapo ta’anga tupãope guarã.	NOCHANGE
Peteĩ jagua ogueraha ijurúpe so’o pehẽngue guasu.	Peteĩ jagua ogueraha ijurúpe so’o pehẽngue guasu.	NOCHANGE
Mymbakuéra vare’águi ndaikatúi oñani.	Mymbakuéra vare’águi ndaikatúi oñani.	NOCHANGE
Ikatu hupytyrã ndaha’ei ko’árape jeikua mba’epa ñande, hákatu ñembotove pe ñande ha’eva	Ikatu hupytyrã ndaha’ei ko’árape jeikua mba’epa ñande, hákatu ñembotove pe ñande ha’eva	NOCHANGE
Mba’éichapa ndepyhare	Mba’éichapa ndepyhare	NOCHANGE
Ha’e haguã ndéve ko che purahéipe	Ha’e haguã ndéve ko che purahéipe	NOCHANGE
Okáguio ojeporu kangue rasýpe guarâ ha mba’asykuéra ñande pire reheguápe.	Okáguio ojeporu kangue rasýpe guarâ ha mba’asykuéra ñande pire reheguápe.	NOCHANGE
Umi tapicha oñemoaranduva’ekue	Umi tapicha oñemoaranduva’ekue	NOCHANGE
Tekove tetã peteĩ reko amérikagua pegua	Tekove tetã peteĩ reko amérikagua pegua	NOCHANGE
. térã yvyra guýpe mymba apytépe	. térã yvyra guýpe mymba apytépe	NOCHANGE
Ary oiko távapy paraguaýpe.	Ary oiko távapy paraguaýpe.	NOCHANGE
Péicha, ko’âichagua tembiapo rupive, ñamopu’â ñane avañe’ême yvate yvateve.	Péicha, ko’âichagua tembiapo rupive, ñamopu’â ñane avañe’ême yvate yvateve.	NOCHANGE
Opa oñepirö ani ramo oyeopia chugui aguiye	Opa oñepirö ani ramo oyeopia chugui aguiye	NOCHANGE
Pe oikova’ekue omoñe’ëngu umi mitãkaria’ýpe.	Pe oikova’ekue omoñe’ëngu umi mitãkaria’ýpe.	NOCHANGE
Ko’ãga mombyry	Ko’ãga mombyry	NOCHANGE
Pe tembiapo oĩ hagua hekopete tekotevẽ oñemoakã, oñembohete ha oñemohu’ãkuaa.	Pe tembiapo oĩ hagua hekopete tekotevẽ oñemoakã, oñembohete ha oñemohu’ãkuaa.	NOCHANGE
Ambue techapyrâ nde táva ikatútava ojapo oipe’a jave hape tavayguápe	Ambue techapyrâ nde táva ikatútava ojapo oipe’a jave hape tavayguápe	NOCHANGE
Adoptar v. ñemomba’e, ñembojára,	Adoptar v. ñemomba’e, ñembojára,	NOCHANGE
Sa’ive mboguejyrã’i ñembohekopyahu	Sa’ive mboguejyrã’i ñembohekopyahu	NOCHANGE
G- ñe’ẽasa ha ñemyesakã rembiapo rehegua oikuaaukáta opavavépe ñe’ẽ ñemyasãi rupi.	G- ñe’ẽasa ha ñemyesakã rembiapo rehegua oikuaaukáta opavavépe ñe’ẽ ñemyasãi rupi.	NOCHANGE
Tomyenyhẽ che ñe’ã ãngapyhy yma guare.	Tomyenyhẽ che ñe’ã ãngapyhy yma guare.	NOCHANGE
Tetã peteĩ reko amérikagua táva	Tetã peteĩ reko amérikagua táva	NOCHANGE
Tetãvorekuéra ñembyatypyre mikyonésiagua	Tetãvorekuéra ñembyatypyre mikyonésiagua	NOCHANGE
Itujáva ñemomba’e.	Itujáva ñemomba’e.	NOCHANGE
Ohapejoko kavaju ho’ava mba’yru guatápe.	Ohapejoko kavaju ho’ava mba’yru guatápe.	NOCHANGE
Pe mba’e ñambyasyetéva	Pe mba’e ñambyasyetéva	NOCHANGE
Pe tape ipukuetéva reipykúi ko’ẽ mboyve,	Pe tape ipukuetéva reipykúi ko’ẽ mboyve,	NOCHANGE
Añemyrõ upe karai ndive, hetaite ijapuhaguére chéve.	Añemyrõ upe karai ndive, hetaite ijapuhaguére chéve.	NOCHANGE
Mba’éichapa	Mba’éichapa	NOCHANGE
Ko aty ha’e upe ojehe’avéva ndaha’éiva heseguáre, ambue aty te’ỹi rehegua oikóva chaco yvytuaku gotyogua napéichai.	Ko aty ha’e upe ojehe’avéva ndaha’éiva heseguáre, ambue aty te’ỹi rehegua oikóva chaco yvytuaku gotyogua napéichai.	NOCHANGE
Nde rerakuemi aropurahéivo ou che py’ápe	Nde rerakuemi aropurahéivo ou che py’ápe	NOCHANGE
Peteĩ angirũ che rekovepe	Peteĩ angirũ che rekovepe	NOCHANGE
Ko yvyra okakuaa porã.	Ko yvyra okakuaa porã.	NOCHANGE
Ha’ete ka’a porã	Ha’ete ka’a porã	NOCHANGE
Ikatúne oho ha’e	Ikatúne oho ha’e	NOCHANGE
Ha nde upépe ha’arõbo neypytu ha nde ko’ẽ.	Ha nde upépe ha’arõbo neypytu ha nde ko’ẽ.	NOCHANGE
Upe ojejerurévare, ha kóva oñeme’ẽ ikatu haguã ombohovái ichupe kuéra.	Upe ojejerurévare, ha kóva oñeme’ẽ ikatu haguã ombohovái ichupe kuéra.	NOCHANGE
Ha’ekuéra ojahu pokã ndahetái rupi y, sapy’ante ipukueterei rupi kyve’ỹ. ijahoja ky’ava’erã ojehecha chupekuéra.	Ha’ekuéra ojahu pokã ndahetái rupi y, sapy’ante ipukueterei rupi kyve’ỹ. ijahoja ky’ava’erã ojehecha chupekuéra.	NOCHANGE
Tavayguakuéra omba’apo mbarete ojapóvo tembiapo ñai’ũgui.	Tavayguakuéra omba’apo mbarete ojapóvo tembiapo ñai’ũgui.	NOCHANGE
Ha tuicha rire ndahuguáiri.	Ha tuicha rire ndahuguáiri.	NOCHANGE
Reikuaapaitéva che mba’embyasy	Reikuaapaitéva che mba’embyasy	NOCHANGE
Ha ndahupytýi mba’eve	Ha ndahupytýi mba’eve	NOCHANGE
Ndaikuaaivoínte ko chéve ojehúva.	Ndaikuaaivoínte ko chéve ojehúva.	NOCHANGE
Ã. oñemyasãi ha oñemombarete guarani jekuaa ha jeporu paraguáipe.	Ã. oñemyasãi ha oñemombarete guarani jekuaa ha jeporu paraguáipe.	NOCHANGE
Ha’ekuéra opitarasa omohe’õrasa	Ha’ekuéra opitarasa omohe’õrasa	NOCHANGE
Guasu yvy hi’a’ỹva.	Guasu yvy hi’a’ỹva.	NOCHANGE
Che rete remóimba, ndaikuaái mba’épa upéva.	Che rete remóimba, ndaikuaái mba’épa upéva.	NOCHANGE
Nde ikatu eiko pára siémpre ko yvy ape ári	Nde ikatu eiko pára siémpre ko yvy ape ári	NOCHANGE
Ñande rehe.	Ñande rehe.	NOCHANGE
Ndajahayhuivoi chupekuéra. ha’ekuéra ndaha’éi mba’eve. ha’ekuéra ndaha’éi ñande	Ndajahayhuivoi chupekuéra. ha’ekuéra ndaha’éi mba’eve. ha’ekuéra ndaha’éi ñande	NOCHANGE
Ha akóinte che moiru.	Ha akóinte che moiru.	NOCHANGE
Hógape opyta itúva ha isy	Hógape opyta itúva ha isy	NOCHANGE
Ha umi documento oñembyaty va’ekue instrucción-pe. upe acusado ou va’erã ijeheguínte, terã	Ha umi documento oñembyaty va’ekue instrucción-pe. upe acusado ou va’erã ijeheguínte, terã	NOCHANGE
Nde syva ry’ái rupi ruhupytýta ne rembi’urã ára ha ára.	Nde syva ry’ái rupi ruhupytýta ne rembi’urã ára ha ára.	NOCHANGE
Mitã ñembosaraipavẽ	Mitã ñembosaraipavẽ	NOCHANGE
Upéagui orojapo retomada pyahu. péa ko ore rekonte voi. ore oroguata va’erã tekotevẽ ramo, oroikove haguã.	Upéagui orojapo retomada pyahu. péa ko ore rekonte voi. ore oroguata va’erã tekotevẽ ramo, oroikove haguã.	NOCHANGE
Mbo’ehaópe avañe’ẽre mborayhu ipotypa jahechakuaa	Mbo’ehaópe avañe’ẽre mborayhu ipotypa jahechakuaa	NOCHANGE
Jagurete’i pire ojeguerohory tetã ambuépe ha oñembojegua pype óga iporãva.	Jagurete’i pire ojeguerohory tetã ambuépe ha oñembojegua pype óga iporãva.	NOCHANGE
Ko táva kóvape oñemba’apo avei mba’eporãkuéra ñai’ũgui jejapopyre, ko tembiapo omohendáva heta tapichápe.	Ko táva kóvape oñemba’apo avei mba’eporãkuéra ñai’ũgui jejapopyre, ko tembiapo omohendáva heta tapichápe.	NOCHANGE
Jekupyty niko peteĩ temiandu,	Jekupyty niko peteĩ temiandu,	NOCHANGE
Mba’e iporãva	Mba’e iporãva	NOCHANGE
Ipu’aka ome’ẽ’ỹva katuete tetãguasúpe.	Ipu’aka ome’ẽ’ỹva katuete tetãguasúpe.	NOCHANGE
Jepiguáicha pe nde áva, oguejývo nde ati’yre,	Jepiguáicha pe nde áva, oguejývo nde ati’yre,	NOCHANGE
Tupã ojapo ichupe tekoporã, ndaichaguái mborayhúre.	Tupã ojapo ichupe tekoporã, ndaichaguái mborayhúre.	NOCHANGE
Omoñe’ẽrasa umi oikuaasemíva guive.	Omoñe’ẽrasa umi oikuaasemíva guive.	NOCHANGE
Ãnduavy paha ha’e ñeimo’a ñehundi opáva ãnduavykuéra	Ãnduavy paha ha’e ñeimo’a ñehundi opáva ãnduavykuéra	NOCHANGE
Che niko ndaikuaái mba’eve upe pejévagui mama. mba’e piko reipota amombe’u ndéve.	Che niko ndaikuaái mba’eve upe pejévagui mama. mba’e piko reipota amombe’u ndéve.	NOCHANGE
Hesekuéra rehehápe napenekangýiva’erã	Hesekuéra rehehápe napenekangýiva’erã	NOCHANGE
Toipyahâ ko’ê pyahu.	Toipyahâ ko’ê pyahu.	NOCHANGE
Opavave mitãkuimba’e ,mitãkuña ha ikakuavéva rehe oñeha’ã	Opavave mitãkuimba’e ,mitãkuña ha ikakuavéva rehe oñeha’ã	NOCHANGE
Pe korea yvyapy, oguerekóva ipype umi mokõi tetã.	Pe korea yvyapy, oguerekóva ipype umi mokõi tetã.	NOCHANGE
Katupyrýpe mbo’ehaópe	Katupyrýpe mbo’ehaópe	NOCHANGE
Mba’e porã ha mba’e porã jehechauka ohenonde’áva ha ohasáva pe	Mba’e porã ha mba’e porã jehechauka ohenonde’áva ha ohasáva pe	NOCHANGE
Mbo’ehára ikatupyryveva’ekue iñirûnguéra apytépe	Mbo’ehára ikatupyryveva’ekue iñirûnguéra apytépe	NOCHANGE
Ha anive oñe’ẽmbarei guaraníre.	Ha anive oñe’ẽmbarei guaraníre.	NOCHANGE
He’iséva ñeme’ê hi’upyrâ térâ ambue mba’e mávape tavaguasu rupi.	He’iséva ñeme’ê hi’upyrâ térâ ambue mba’e mávape tavaguasu rupi.	NOCHANGE
Araka’eve ndojekuaái mondaháramo hikuái. heko porãgui hikuéi ojeguerohory ambue tetãyguáre ha oñemu imba’erepykuéra.	Araka’eve ndojekuaái mondaháramo hikuái. heko porãgui hikuéi ojeguerohory ambue tetãyguáre ha oñemu imba’erepykuéra.	NOCHANGE
Ohómiva’erã umi vy’aha térã jerokyha rupi. upéi ave, ndojerokykuaaivoi ha	Ohómiva’erã umi vy’aha térã jerokyha rupi. upéi ave, ndojerokykuaaivoi ha	NOCHANGE
Ñanduti mba’epyahu	Ñanduti mba’epyahu	NOCHANGE
Porã. ivýro ha ijejapo. ojaposéva ojapo upe tava’ípe ha hi’ariete	Porã. ivýro ha ijejapo. ojaposéva ojapo upe tava’ípe ha hi’ariete	NOCHANGE
Tuichaitéva umi táva rehe,	Tuichaitéva umi táva rehe,	NOCHANGE
. rehóva’erã katuete	. rehóva’erã katuete	NOCHANGE
Kurusu ra’ãnga marangatu rehe, nde orepysyrõ orerayhú’ỹvagui. tupã orejára. túva, ta’ýra ha pytu marangatu rerapýpe. ta’upéicha hesu.	Kurusu ra’ãnga marangatu rehe, nde orepysyrõ orerayhú’ỹvagui. tupã orejára. túva, ta’ýra ha pytu marangatu rerapýpe. ta’upéicha hesu.	NOCHANGE
Jarohory ñanemba’éva,	Jarohory ñanemba’éva,	NOCHANGE
Ko arapy kuápe.	Ko arapy kuápe.	NOCHANGE
Temimbo’ekuéra ohova’ekue posadas guive	Temimbo’ekuéra ohova’ekue posadas guive	NOCHANGE
Ajépango ñambyasy mba’e vaiete ojehúva	Ajépango ñambyasy mba’e vaiete ojehúva	NOCHANGE
Ome’ẽ ojupe kyre’ỹ pokatu porã omyasãi techapyrã	Ome’ẽ ojupe kyre’ỹ pokatu porã omyasãi techapyrã	NOCHANGE
Ne’ĩraha ko ñe’ẽ oho omanóvo.	Ne’ĩraha ko ñe’ẽ oho omanóvo.	NOCHANGE
Oha’ãrõva ñembohovái katupyry.	Oha’ãrõva ñembohovái katupyry.	NOCHANGE
Che ména amyrỹi ahechaga’úva, heta cheipytyvõva’ekue, ára ha ára ojepytasómiva’ekue che ykére.	Che ména amyrỹi ahechaga’úva, heta cheipytyvõva’ekue, ára ha ára ojepytasómiva’ekue che ykére.	NOCHANGE
Nde kóga pono ho’u	Nde kóga pono ho’u	NOCHANGE
Ko jehaipyre ndahekopyahuvéima, upévare hetepy ikatu ndoikovéima.	Ko jehaipyre ndahekopyahuvéima, upévare hetepy ikatu ndoikovéima.	NOCHANGE
O ñembosarái hese.	O ñembosarái hese.	NOCHANGE
Aropurahéine che mbarakapúpe mba’e iporãitéva,	Aropurahéine che mbarakapúpe mba’e iporãitéva,	NOCHANGE
Ñande, yvypóra,	Ñande, yvypóra,	NOCHANGE
Che ru hái rasy ha oipohanóva’erã.	Che ru hái rasy ha oipohanóva’erã.	NOCHANGE
Nde sy ha nde ru ani oikuaa mba’eveichavérõ	Nde sy ha nde ru ani oikuaa mba’eveichavérõ	NOCHANGE
Pe ipaíno rógape niko oiko avei mokõi karia’y ndohayhúiva pychãime. mokõive ndoikuaaseivoi a’eve pychãigui, kóvape ohayhuvégui paíno.	Pe ipaíno rógape niko oiko avei mokõi karia’y ndohayhúiva pychãime. mokõive ndoikuaaseivoi a’eve pychãigui, kóvape ohayhuvégui paíno.	NOCHANGE
Ipotĩetéva ha iporãngáva kuña porã peteĩha imara’ỹva.	Ipotĩetéva ha iporãngáva kuña porã peteĩha imara’ỹva.	NOCHANGE
Mitã ome’ẽ ñandéve	Mitã ome’ẽ ñandéve	NOCHANGE
Ñande ha’e avañe’ẽjára ha ñande pytu oñe’ẽ	Ñande ha’e avañe’ẽjára ha ñande pytu oñe’ẽ	NOCHANGE
Ohókuri omba’apo peteĩ mandyjutýpe. mbeguekatúpe ojoguajeýkuri tupa, apyka,	Ohókuri omba’apo peteĩ mandyjutýpe. mbeguekatúpe ojoguajeýkuri tupa, apyka,	NOCHANGE
Jepémo ñemihápemi.	Jepémo ñemihápemi.	NOCHANGE
Tetã jehayhu purahéi	Tetã jehayhu purahéi	NOCHANGE
Upéichante va’erã voi.	Upéichante va’erã voi.	NOCHANGE
Nde syry sarakípe hakuéte jave.	Nde syry sarakípe hakuéte jave.	NOCHANGE
Pindo karai arateĩ	Pindo karai arateĩ	NOCHANGE
Oñemongaraiva’ekue. ha’e ojapo ta’anga tupãope guarã. petei jey oho yvyra	Oñemongaraiva’ekue. ha’e ojapo ta’anga tupãope guarã. petei jey oho yvyra	NOCHANGE
Ko yvy hekópe ojere,	Ko yvy hekópe ojere,	NOCHANGE
Oñembohãimbiti ha oisu’úvo ichupe opyta omanórõ guáicha.	Oñembohãimbiti ha oisu’úvo ichupe opyta omanórõ guáicha.	NOCHANGE
Tyekue ha py’a mba’asykuéra. ojepuru sevo’i oñepohano hagua. okáguio ojepuru oñepohano hagua	Tyekue ha py’a mba’asykuéra. ojepuru sevo’i oñepohano hagua. okáguio ojepuru oñepohano hagua	NOCHANGE
Ñe’ẽ porã guaraníme ne mba’erã che aipyaha	Ñe’ẽ porã guaraníme ne mba’erã che aipyaha	NOCHANGE
Umi peteĩha tapykuere opytáva hi’ári	Umi peteĩha tapykuere opytáva hi’ári	NOCHANGE
Paraguáype hetaiteve oĩ tapicha hasykatu jave oñepohãnoukáva pohãnohára chaépe	Paraguáype hetaiteve oĩ tapicha hasykatu jave oñepohãnoukáva pohãnohára chaépe	NOCHANGE
- ha mba’éiko ajapóta...apurahéi -ñakyrã ombohovái	- ha mba’éiko ajapóta...apurahéi -ñakyrã ombohovái	NOCHANGE
Ha ko’ẽrõ tupãópe	Ha ko’ẽrõ tupãópe	NOCHANGE
Taguato akãtĩ	Taguato akãtĩ	NOCHANGE
Ha ndojokói chupe ára haku,	Ha ndojokói chupe ára haku,	NOCHANGE
Name’ẽi tupãmba’e. na che mboriahuetereigui ame’ẽ haguã	Name’ẽi tupãmba’e. na che mboriahuetereigui ame’ẽ haguã	NOCHANGE
Parana (tetãvore) táva	Parana (tetãvore) táva	NOCHANGE
Upéicha che ra’y, ha opaite mba’e rechaharekuéra avei.	Upéicha che ra’y, ha opaite mba’e rechaharekuéra avei.	NOCHANGE
Hi’ánga ijaperekuéra	Hi’ánga ijaperekuéra	NOCHANGE
Ñande jajatygua’u ñambopugua’u	Ñande jajatygua’u ñambopugua’u	NOCHANGE
Ñane ãnga memby ñane ñe’ẽ ha’e ñane korasõ ñe’ẽma	Ñane ãnga memby ñane ñe’ẽ ha’e ñane korasõ ñe’ẽma	NOCHANGE
Upe ára pukukue mymba kuera isaraki,	Upe ára pukukue mymba kuera isaraki,	NOCHANGE
Mba’apo ñanemohesâi	Mba’apo ñanemohesâi	NOCHANGE
Paraguái oñeha’ãva mboriahu reko’yre, techaukarã maymávape.	Paraguái oñeha’ãva mboriahu reko’yre, techaukarã maymávape.	NOCHANGE
Chipa atã ndaikatúi jaisu’u.	Chipa atã ndaikatúi jaisu’u.	NOCHANGE
Che korapýpe oĩ yvyrã ha’eño.	Che korapýpe oĩ yvyrã ha’eño.	NOCHANGE
Techarãme ojehechauka peteĩ jaguarete juehegua, ku jaguaretetĩ.	Techarãme ojehechauka peteĩ jaguarete juehegua, ku jaguaretetĩ.	NOCHANGE
(hetave tera sa’ive yvyramatakuéra)	(hetave tera sa’ive yvyramatakuéra)	NOCHANGE
Mitã ñembosarairã.	Mitã ñembosarairã.	NOCHANGE
Ojehechakuaa avei iporãha oñembohape tembiapo ogueru va’erã tekojoja	Ojehechakuaa avei iporãha oñembohape tembiapo ogueru va’erã tekojoja	NOCHANGE
Ñe’ẽmi imarã’ỹva	Ñe’ẽmi imarã’ỹva	NOCHANGE
Ñane avañe’ë, ñande purahéi,	Ñane avañe’ë, ñande purahéi,	NOCHANGE
Peteĩ kuña rete.	Peteĩ kuña rete.	NOCHANGE
Oúma temimbo’ekuéra	Oúma temimbo’ekuéra	NOCHANGE
Che rapichakuéra heko porã.	Che rapichakuéra heko porã.	NOCHANGE
Omoĩ ka’i ijyva guýpe ha oipykúi hóga rape.	Omoĩ ka’i ijyva guýpe ha oipykúi hóga rape.	NOCHANGE
Ha ojekuaa mba’éichapa	Ha ojekuaa mba’éichapa	NOCHANGE
Tupã ñemoñare jeroviapy.	Tupã ñemoñare jeroviapy.	NOCHANGE
Kuña reko hasyeterei, oñomoñondive haguére kuimba’ekuéra ndive	Kuña reko hasyeterei, oñomoñondive haguére kuimba’ekuéra ndive	NOCHANGE
Avakuéra. (personajes) ha’e umi oñemombe’úva apohára.	Avakuéra. (personajes) ha’e umi oñemombe’úva apohára.	NOCHANGE
- mba’eháiko nderejeruréi aipo pira’ípe peteĩ ña’ẽ pyahu chéve guara, kóva niko ituja ha ojekapáma.	- mba’eháiko nderejeruréi aipo pira’ípe peteĩ ña’ẽ pyahu chéve guara, kóva niko ituja ha ojekapáma.	NOCHANGE
Oremyenyhê mborayhu, py’aguapy ha vy’apavêgui.	Oremyenyhê mborayhu, py’aguapy ha vy’apavêgui.	NOCHANGE
Ohekýi haguã ko che korasõgui mba’e mbyasy	Ohekýi haguã ko che korasõgui mba’e mbyasy	NOCHANGE
Yvy ojoka opu’ã iñe’ẽ ha yvypo ãnga toñe’ẽ	Yvy ojoka opu’ã iñe’ẽ ha yvypo ãnga toñe’ẽ	NOCHANGE
Ñerenohe jevy, ha upe soberanía jerereko paite ojerespetávo umi upépe oikóvape, ha umi	Ñerenohe jevy, ha upe soberanía jerereko paite ojerespetávo umi upépe oikóvape, ha umi	NOCHANGE
Maymáva aipota pe jehesarekomi sapy’aite	Maymáva aipota pe jehesarekomi sapy’aite	NOCHANGE
Upepeténtevoi omopu’ã tapyi’imi ha oiko ipype ha’eño petei. arañavõ omomorã imemby	Upepeténtevoi omopu’ã tapyi’imi ha oiko ipype ha’eño petei. arañavõ omomorã imemby	NOCHANGE
Méhiko - tetã peteĩ reko mehikogua	Méhiko - tetã peteĩ reko mehikogua	NOCHANGE
Heta ñe’ẽ kirirĩ	Heta ñe’ẽ kirirĩ	NOCHANGE
Kamba paraguái, ava paraguái	Kamba paraguái, ava paraguái	NOCHANGE
Opurahéiva pe amo yvate.	Opurahéiva pe amo yvate.	NOCHANGE
Hetaite mba’e iporãva	Hetaite mba’e iporãva	NOCHANGE
Ku ára ha pyhare.	Ku ára ha pyhare.	NOCHANGE
Kanindeju ñemoarandúpe ndaha’éi oĩporãmbáva oĩ rupi avakuéra ndohóiva mbo’ehaópe, péicha rupi ñomoñe’ẽi ha ndohaikuaái avei.	Kanindeju ñemoarandúpe ndaha’éi oĩporãmbáva oĩ rupi avakuéra ndohóiva mbo’ehaópe, péicha rupi ñomoñe’ẽi ha ndohaikuaái avei.	NOCHANGE
Ndaje, peteĩ ko’ẽ, ojuhu hikuái juky iñasãiva hóga jerére. osẽ ha ohohápente,	Ndaje, peteĩ ko’ẽ, ojuhu hikuái juky iñasãiva hóga jerére. osẽ ha ohohápente,	NOCHANGE
Pira mimoĩ reve ro’u aguã ha’é,	Pira mimoĩ reve ro’u aguã ha’é,	NOCHANGE
Peteĩ mburuvicha.	Peteĩ mburuvicha.	NOCHANGE
Ña’e chararã, mbohyapuha - pires.	Ña’e chararã, mbohyapuha - pires.	NOCHANGE
Ñande jyva, ñande rekove,	Ñande jyva, ñande rekove,	NOCHANGE
Ha’ekuéra ojahe’óraka’e ombovóraka’e	Ha’ekuéra ojahe’óraka’e ombovóraka’e	NOCHANGE
. oĩmérõ iporãva ko yvy apére	. oĩmérõ iporãva ko yvy apére	NOCHANGE
Ñambyaty viru, ñe’ã tahory,	Ñambyaty viru, ñe’ã tahory,	NOCHANGE
Opyta oguereko opaite mb’ae aporã reheve.	Opyta oguereko opaite mb’ae aporã reheve.	NOCHANGE
Ñaimo’ã ku tyre’ỹ,	Ñaimo’ã ku tyre’ỹ,	NOCHANGE
Mandi’o, avati, kurapepẽ ha karanda’y ru’ã omomimói ýrõ katu ombichy. mymba kamby ndo’úi, oimo’ãgui ovataha hesekuéra upe mymba reko.	Mandi’o, avati, kurapepẽ ha karanda’y ru’ã omomimói ýrõ katu ombichy. mymba kamby ndo’úi, oimo’ãgui ovataha hesekuéra upe mymba reko.	NOCHANGE
Kóva. jprd.	Kóva. jprd.	NOCHANGE
Oipurukuaaha umi ñe’ë ombojoajúva ijeheguivoi.	Oipurukuaaha umi ñe’ë ombojoajúva ijeheguivoi.	NOCHANGE
Opu’ã ha ikaria’ývo arandúpe ojesape.	Opu’ã ha ikaria’ývo arandúpe ojesape.	NOCHANGE
Upépe ñembo’yhápe	Upépe ñembo’yhápe	NOCHANGE
Che apysa ohendúva ñe’ê pu rory	Che apysa ohendúva ñe’ê pu rory	NOCHANGE
Jaipurukatu hagua muanduhe tĩgua tekotevẽ jaikuaa máva mávapa umi taipu tĩgua. upéva rehe ñanemandu’araẽta umíva rehe.	Jaipurukatu hagua muanduhe tĩgua tekotevẽ jaikuaa máva mávapa umi taipu tĩgua. upéva rehe ñanemandu’araẽta umíva rehe.	NOCHANGE
Ndaha’éi ha’éva vvy ñane mba’e.	Ndaha’éi ha’éva vvy ñane mba’e.	NOCHANGE
Ko che ñembo’emi	Ko che ñembo’emi	NOCHANGE
Tembi’urã ijatypáva peteĩ hendápe. upémarõ, kirirĩháme, oñemboja ha omboguejy	Tembi’urã ijatypáva peteĩ hendápe. upémarõ, kirirĩháme, oñemboja ha omboguejy	NOCHANGE
Tosunu tahayvi ñe’ẽ ñe’ãre taheñoimbaite	Tosunu tahayvi ñe’ẽ ñe’ãre taheñoimbaite	NOCHANGE
Ko’ẽ rire ae osẽ oho mitãnguéra.	Ko’ẽ rire ae osẽ oho mitãnguéra.	NOCHANGE
Chemombáy va’ekue	Chemombáy va’ekue	NOCHANGE
Amomorãnte chupe.	Amomorãnte chupe.	NOCHANGE
Ñamenda mba’e haguã.	Ñamenda mba’e haguã.	NOCHANGE
Ha peteĩ rósape ijapaitérõ jasyrundy	Ha peteĩ rósape ijapaitérõ jasyrundy	NOCHANGE
Aguyjevete hína ñande ypykuéra, ñande sy, ñande ru...	Aguyjevete hína ñande ypykuéra, ñande sy, ñande ru...	NOCHANGE
Rapykuéri ojehecha mba’éichapa	Rapykuéri ojehecha mba’éichapa	NOCHANGE
Hekoha rehe, hapichakuéra rekove rehe, hemikotevë rehe, heko	Hekoha rehe, hapichakuéra rekove rehe, hemikotevë rehe, heko	NOCHANGE
Ndo’uva’erâi avei heviñembyaíva.	Ndo’uva’erâi avei heviñembyaíva.	NOCHANGE
Ta’ãnga, marangatukuéra ra’ãnga, kurusu, y karaipyre, juky, akãrague, kangue,	Ta’ãnga, marangatukuéra ra’ãnga, kurusu, y karaipyre, juky, akãrague, kangue,	NOCHANGE
Mba’e porã ikatu oñemyatã me’ẽmby, mba’e vai nahániri	Mba’e porã ikatu oñemyatã me’ẽmby, mba’e vai nahániri	NOCHANGE
Oĩ peteĩntechagua tesa porã ha’e umi oma’ẽva nderehe kunu’ũrekope	Oĩ peteĩntechagua tesa porã ha’e umi oma’ẽva nderehe kunu’ũrekope	NOCHANGE
Jekupyty niko ñande rekove sã.	Jekupyty niko ñande rekove sã.	NOCHANGE
Ha opaite ñanderehe.	Ha opaite ñanderehe.	NOCHANGE
Haguâ, ñemby ñemuha ryepýpe.	Haguâ, ñemby ñemuha ryepýpe.	NOCHANGE
Ñasê jaheka py’aguapy. ñasê jaheka.	Ñasê jaheka py’aguapy. ñasê jaheka.	NOCHANGE
Oñemomba’e marina-kuére.	Oñemomba’e marina-kuére.	NOCHANGE
Ñande yvy ryepýpe...	Ñande yvy ryepýpe...	NOCHANGE
(ojehecha heta guyra kuéra chácope)	(ojehecha heta guyra kuéra chácope)	NOCHANGE
Pa’ikuéra tupâópe	Pa’ikuéra tupâópe	NOCHANGE
Ojupi tuñe’ẽ karuguáre.	Ojupi tuñe’ẽ karuguáre.	NOCHANGE
Ha ñanekangypaitéma.	Ha ñanekangypaitéma.	NOCHANGE
Nde py’a emohãtã	Nde py’a emohãtã	NOCHANGE
Umi hese ojeroviáva peguarã.	Umi hese ojeroviáva peguarã.	NOCHANGE
Ojapova’ekue	Ojapova’ekue	NOCHANGE
He’iséva ava aty oikóva’ekue ñane retãme.	He’iséva ava aty oikóva’ekue ñane retãme.	NOCHANGE
Ohejava’ekue ñandéve hekovia ko arapýpe	Ohejava’ekue ñandéve hekovia ko arapýpe	NOCHANGE
Maitei horyvéva opavavépe ha ñamoñe’êke ko arandu porâite, ipype jajuhúta heta mba’e porâ ikatúta ñanesâmbyhy tekokatu rapare.	Maitei horyvéva opavavépe ha ñamoñe’êke ko arandu porâite, ipype jajuhúta heta mba’e porâ ikatúta ñanesâmbyhy tekokatu rapare.	NOCHANGE
Ñe’ẽndy óga rehegua	Ñe’ẽndy óga rehegua	NOCHANGE
Ohechaukahápe hikuái ijeroviakatu ñande	Ohechaukahápe hikuái ijeroviakatu ñande	NOCHANGE
Ojepuru’arã upe ka’avo pyahu, hérava ka’a, opytava’ekue mokõivéva poguýpe.	Ojepuru’arã upe ka’avo pyahu, hérava ka’a, opytava’ekue mokõivéva poguýpe.	NOCHANGE
Oñembohãimbiti ha oisu’úvo chupe opyta omanorõguáicha.	Oñembohãimbiti ha oisu’úvo chupe opyta omanorõguáicha.	NOCHANGE
Ayvu rapyta rã i oikuaá	Ayvu rapyta rã i oikuaá	NOCHANGE
Ñe’ẽ ñendua mirĩ	Ñe’ẽ ñendua mirĩ	NOCHANGE
Ogueru ko ko’etĩ	Ogueru ko ko’etĩ	NOCHANGE
Kóva ndapejoguáirõ ndapejoguavéima kiritópe he’i tapicha,	Kóva ndapejoguáirõ ndapejoguavéima kiritópe he’i tapicha,	NOCHANGE
Pyharé ha ára romoirú haguã.	Pyharé ha ára romoirú haguã.	NOCHANGE
Péva ha’ehína	Péva ha’ehína	NOCHANGE
Ha’e ombohova pyahu ñe’ẽpoty guarani ojesarekóvo ndaha’éi he’íva añóre, avei ijysajáre ha hi’ári ombojuky ha ombohe’ẽ ñane ñe’ẽ guarani.	Ha’e ombohova pyahu ñe’ẽpoty guarani ojesarekóvo ndaha’éi he’íva añóre, avei ijysajáre ha hi’ári ombojuky ha ombohe’ẽ ñane ñe’ẽ guarani.	NOCHANGE
He’iséva. ñembovy’a ha jeguerohory mávape.	He’iséva. ñembovy’a ha jeguerohory mávape.	NOCHANGE
Oñeñangareko ha oñemongakuaa haguã arandu jopara ha mba’e porã	Oñeñangareko ha oñemongakuaa haguã arandu jopara ha mba’e porã	NOCHANGE
Ka’aguy oñuâmba	Ka’aguy oñuâmba	NOCHANGE
Ha ohecharamo porâreko oguerekóva opaite mba’e.	Ha ohecharamo porâreko oguerekóva opaite mba’e.	NOCHANGE
Ñande yvy ruguypotĩre oikovéva mba’apópe	Ñande yvy ruguypotĩre oikovéva mba’apópe	NOCHANGE
Terã umi poguasu nde javeve.	Terã umi poguasu nde javeve.	NOCHANGE
Mávakuéra rovatavy ou pe ojeguerekogui mbohovái opa mba’epeguarã. mombe’uapy’ã arandu ou oguerekógui ñeporandu opa mba’epeguarã	Mávakuéra rovatavy ou pe ojeguerekogui mbohovái opa mba’epeguarã. mombe’uapy’ã arandu ou oguerekógui ñeporandu opa mba’epeguarã	NOCHANGE
Okañy va’ekue	Okañy va’ekue	NOCHANGE
Po mbo’esyry ha oñembokatupyry sa	Po mbo’esyry ha oñembokatupyry sa	NOCHANGE
Te’ímahina hikuái mba’épa oikuaámavoi, mba’épa ha’ekuéra oikuaaseve, mba’éichapa ha’ekuéra oñandu upe	Te’ímahina hikuái mba’épa oikuaámavoi, mba’épa ha’ekuéra oikuaaseve, mba’éichapa ha’ekuéra oñandu upe	NOCHANGE
Peteĩ ijeroviaha.	Peteĩ ijeroviaha.	NOCHANGE
Ñambyasy ñane retãme ko’ãichagua ñaña guaraní ñe’ẽre ojejapóva. oĩko oñotỹséva ñane ñoha’ãnga, oipytyvõrãngue.	Ñambyasy ñane retãme ko’ãichagua ñaña guaraní ñe’ẽre ojejapóva. oĩko oñotỹséva ñane ñoha’ãnga, oipytyvõrãngue.	NOCHANGE
Mba’e kuaa rehehápe.	Mba’e kuaa rehehápe.	NOCHANGE
Pe kosereva oñeñongatu areséramo oñemoĩva’erã pype, oñembosako’i aja, hetave asuka ha eira hũ.	Pe kosereva oñeñongatu areséramo oñemoĩva’erã pype, oñembosako’i aja, hetave asuka ha eira hũ.	NOCHANGE
Ha yvýgui tapicha hesekuéra oma’ê,	Ha yvýgui tapicha hesekuéra oma’ê,	NOCHANGE
Omboguapy kuatiápe peteĩ ñe’ẽñeme’ẽ	Omboguapy kuatiápe peteĩ ñe’ẽñeme’ẽ	NOCHANGE
Oipuruky’aséva chupe katuete ojejuhúne. ohopotápe he’íva’ekue, iporãvéne, ñanepyahẽrãngue iporãvéne japurahéi ñamanomeve.	Oipuruky’aséva chupe katuete ojejuhúne. ohopotápe he’íva’ekue, iporãvéne, ñanepyahẽrãngue iporãvéne japurahéi ñamanomeve.	NOCHANGE
Ñe’ême. ipahápe, pachín centurión imbaraka reheve, ohenduka opavavépe purahéi	Ñe’ême. ipahápe, pachín centurión imbaraka reheve, ohenduka opavavépe purahéi	NOCHANGE
Mbo’eharakuéra pyahu	Mbo’eharakuéra pyahu	NOCHANGE
Che táva guasu.	Che táva guasu.	NOCHANGE
Ha ñanepytuhê avei.	Ha ñanepytuhê avei.	NOCHANGE
Térã ñañeme’ẽ ñamano peve.	Térã ñañeme’ẽ ñamano peve.	NOCHANGE
Ha’ekuéra kuri omaña hese.	Ha’ekuéra kuri omaña hese.	NOCHANGE
Ha nde jyva ári tasapymi, ko’ẽju poty.	Ha nde jyva ári tasapymi, ko’ẽju poty.	NOCHANGE
. nañanduva’erãi aipo kane’õ.	. nañanduva’erãi aipo kane’õ.	NOCHANGE
Mitã taryrýicha che pojái pya’eva ha aipehe’ã	Mitã taryrýicha che pojái pya’eva ha aipehe’ã	NOCHANGE
Nde pukavy kangy ha nde áva apopê sa’yju asy	Nde pukavy kangy ha nde áva apopê sa’yju asy	NOCHANGE
Apañuãi vaivéva oñepyrũ peteĩ yvypóra ikatuvóve ojapo ha’e he’ihaícha	Apañuãi vaivéva oñepyrũ peteĩ yvypóra ikatuvóve ojapo ha’e he’ihaícha	NOCHANGE
Umi mba’e iporãveva ko ñande rekovepe ndaha’ei umi ikuta jajogua	Umi mba’e iporãveva ko ñande rekovepe ndaha’ei umi ikuta jajogua	NOCHANGE
Ha mba’erãpa reisu’úta,	Ha mba’erãpa reisu’úta,	NOCHANGE
Hekopete, ko yvy ape ári	Hekopete, ko yvy ape ári	NOCHANGE
Purahéi rei.	Purahéi rei.	NOCHANGE
Oje’e haguã oje’eséva ha ikatu haguã maymáva tetã oike pe arandu rekópe,	Oje’e haguã oje’eséva ha ikatu haguã maymáva tetã oike pe arandu rekópe,	NOCHANGE
. upévako hína pe chéve ojehúva	. upévako hína pe chéve ojehúva	NOCHANGE
Máva ohekáva porayhu mba’e porã japohaguere, oikuaane tembiechakuaa’ỹ	Máva ohekáva porayhu mba’e porã japohaguere, oikuaane tembiechakuaa’ỹ	NOCHANGE
Oñemoĩsevérõ kesu, ikatúnte avei.	Oñemoĩsevérõ kesu, ikatúnte avei.	NOCHANGE
Tembiapo guasu ñemohu’â.	Tembiapo guasu ñemohu’â.	NOCHANGE
Heta jeýningo mbo’ehára oñe’ëve pe ombo’e aja, sa’imínte oñe’ë temimbo’ekuéra. ha’ete voi ku	Heta jeýningo mbo’ehára oñe’ëve pe ombo’e aja, sa’imínte oñe’ë temimbo’ekuéra. ha’ete voi ku	NOCHANGE
Che sy porã yvoty	Che sy porã yvoty	NOCHANGE
Tapichakuéra kuatia guarani ñe’ẽme,	Tapichakuéra kuatia guarani ñe’ẽme,	NOCHANGE
Che vaka oike korapy chemba’e’yvape.	Che vaka oike korapy chemba’e’yvape.	NOCHANGE
Jahupyty va’ekue oñondive.	Jahupyty va’ekue oñondive.	NOCHANGE
Ha péicha avei heta oime upérupi oikundaháva	Ha péicha avei heta oime upérupi oikundaháva	NOCHANGE
Mitãnguéra oñemongeta mbo’ehára ndive.	Mitãnguéra oñemongeta mbo’ehára ndive.	NOCHANGE
Anichéne niko che memby ojapo, ko ouva’ekue omombe’u chéve ha upéi oñeno oke ko’ëmbaite peve.	Anichéne niko che memby ojapo, ko ouva’ekue omombe’u chéve ha upéi oñeno oke ko’ëmbaite peve.	NOCHANGE
Ñandejára péva oguerohory.	Ñandejára péva oguerohory.	NOCHANGE
Ñañembo’e omanova’ekue anguerehe...	Ñañembo’e omanova’ekue anguerehe...	NOCHANGE
Upépe oikéva guive.	Upépe oikéva guive.	NOCHANGE
(ojeguerekóma pirapire oñemba’apo haguã arapytúrehe)	(ojeguerekóma pirapire oñemba’apo haguã arapytúrehe)	NOCHANGE
I porã ñane retã paraguai	I porã ñane retã paraguai	NOCHANGE
- jahekávo oñondive ambue tape iporãvéva ha omoakãrapu’ãva opa ara ite okarayguápe opa rei’ỹ haguãicha.	- jahekávo oñondive ambue tape iporãvéva ha omoakãrapu’ãva opa ara ite okarayguápe opa rei’ỹ haguãicha.	NOCHANGE
Aha jepi pe tenda yvy porãitépe	Aha jepi pe tenda yvy porãitépe	NOCHANGE
Tetã oĩva tekorãty hetatetãgua hekopegua.	Tetã oĩva tekorãty hetatetãgua hekopegua.	NOCHANGE
Nde yvoty porãite osẽmi,	Nde yvoty porãite osẽmi,	NOCHANGE
Ayvu rapyta rã i oikuaá ma vy ojeupe,	Ayvu rapyta rã i oikuaá ma vy ojeupe,	NOCHANGE
Ára ha’e apoha iporãvéva, akóinte otopa paha iporã jepéva	Ára ha’e apoha iporãvéva, akóinte otopa paha iporã jepéva	NOCHANGE
. oje’óiva ojeheka hi’ãitégui chupekuérã,	. oje’óiva ojeheka hi’ãitégui chupekuérã,	NOCHANGE
Opyta ijurujái ojehai porãiteréigui, ko ñe’ẽpoty guive oguahẽ itáva	Opyta ijurujái ojehai porãiteréigui, ko ñe’ẽpoty guive oguahẽ itáva	NOCHANGE
Kokue akãme henói heta ka’arë ra’ýi.	Kokue akãme henói heta ka’arë ra’ýi.	NOCHANGE
Ndaikuaaivoínte ko chéve ojehúva	Ndaikuaaivoínte ko chéve ojehúva	NOCHANGE
Opa mba’e avañe’ẽme emysakã añete	Opa mba’e avañe’ẽme emysakã añete	NOCHANGE
Upe guarini hekomarãvape oñotỹ hikuái peteĩ ka’aguy mombyrýva upégui ha jatápe katu oñotỹ hikuái peteĩ ysyry iporãva rembe’ýpe.	Upe guarini hekomarãvape oñotỹ hikuái peteĩ ka’aguy mombyrýva upégui ha jatápe katu oñotỹ hikuái peteĩ ysyry iporãva rembe’ýpe.	NOCHANGE
Hyjúi pytu ha hatã.	Hyjúi pytu ha hatã.	NOCHANGE
Ahendusemínte ñe’ẽngatu katupyry pokatuñe’ẽ oguerekóva	Ahendusemínte ñe’ẽngatu katupyry pokatuñe’ẽ oguerekóva	NOCHANGE
Ñemuha guasu táva marrakech-pe	Ñemuha guasu táva marrakech-pe	NOCHANGE
Temimbo’ekuéra ndive ii	Temimbo’ekuéra ndive ii	NOCHANGE
Hetaitéma ko tetãre, oikóva okaru rei.	Hetaitéma ko tetãre, oikóva okaru rei.	NOCHANGE
Ko mba’e oñemohesakã porãvéntema	Ko mba’e oñemohesakã porãvéntema	NOCHANGE
Ko yvy ojere	Ko yvy ojere	NOCHANGE
Administrativa ejercicio rehegua, oñekotevẽ’ỹre umi ambue derecho ñemomarã, ha oma’ẽ va’erã	Administrativa ejercicio rehegua, oñekotevẽ’ỹre umi ambue derecho ñemomarã, ha oma’ẽ va’erã	NOCHANGE
Ka’aguy porã.	Ka’aguy porã.	NOCHANGE
Kokue ha yvyra. kokue ha yvyramata.	Kokue ha yvyra. kokue ha yvyramata.	NOCHANGE
Yvága ha yvy,	Yvága ha yvy,	NOCHANGE
Kuatiarogue ñemyanyhẽ iporã ha ipya’evéva oipurúva sa’ive mandu’arenda ne mohendahápe.	Kuatiarogue ñemyanyhẽ iporã ha ipya’evéva oipurúva sa’ive mandu’arenda ne mohendahápe.	NOCHANGE
Rapaikuéra jepe omochamame ñane mba’éva ijapytepekuéra	Rapaikuéra jepe omochamame ñane mba’éva ijapytepekuéra	NOCHANGE
Guaraní ñemoñare ñande yvýre ojeroviáva ha oñeha’ãva.	Guaraní ñemoñare ñande yvýre ojeroviáva ha oñeha’ãva.	NOCHANGE
Nde rejápe.	Nde rejápe.	NOCHANGE
Ñemba’apokuaha ha upéva oñepyrũ haguã. tekombo’ẽ oheka upéva pyvéi to jepyta ijyvýpe ha to	Ñemba’apokuaha ha upéva oñepyrũ haguã. tekombo’ẽ oheka upéva pyvéi to jepyta ijyvýpe ha to	NOCHANGE
Oiko hesekuéra. mba’e vai rire, mba’e porã manteva’erã, péicha niko	Oiko hesekuéra. mba’e vai rire, mba’e porã manteva’erã, péicha niko	NOCHANGE
. ahendúvo upéicha nde juru oñe’ẽ,	. ahendúvo upéicha nde juru oñe’ẽ,	NOCHANGE
Ñembotavy( guarani)	Ñembotavy( guarani)	NOCHANGE
Cheñuã mba’embyasy.	Cheñuã mba’embyasy.	NOCHANGE
Tembiaporeko ñane retãnguérape, jopói apytépe, ohupyty haguã opavavépe.	Tembiaporeko ñane retãnguérape, jopói apytépe, ohupyty haguã opavavépe.	NOCHANGE
Oñembyakúva’erã ñandy térã ñandyry ha pype ojýva’erã sevói hykupa peve, oñemoĩ chupe juky, ojeipe’a tatágui ha ojehejáva’erã oñemboho’ysã.	Oñembyakúva’erã ñandy térã ñandyry ha pype ojýva’erã sevói hykupa peve, oñemoĩ chupe juky, ojeipe’a tatágui ha ojehejáva’erã oñemboho’ysã.	NOCHANGE
Táva guasu ha tava’ieta	Táva guasu ha tava’ieta	NOCHANGE
Oje’e ñe’ëmbeguépe hasy vaiha pe mitã.	Oje’e ñe’ëmbeguépe hasy vaiha pe mitã.	NOCHANGE
Hi’ânte iko’êmo he’i ñandejára	Hi’ânte iko’êmo he’i ñandejára	NOCHANGE
Avyu ha vy’ápe mitã iñapesã	Avyu ha vy’ápe mitã iñapesã	NOCHANGE
. ha tetã rayhu niko oñohẽ.	. ha tetã rayhu niko oñohẽ.	NOCHANGE
Ñande jahesyva’erã ñamokãva’erã	Ñande jahesyva’erã ñamokãva’erã	NOCHANGE
Rape. omboha’eve ñande py’a ha omboguapy ñane rembi’u.	Rape. omboha’eve ñande py’a ha omboguapy ñane rembi’u.	NOCHANGE
Ha upéirõ ñembyasy hoy’u.	Ha upéirõ ñembyasy hoy’u.	NOCHANGE
Ame’ẽ jave chupe opa mba’e	Ame’ẽ jave chupe opa mba’e	NOCHANGE
Ko’ãga ojeitypa.	Ko’ãga ojeitypa.	NOCHANGE
Araíre pe nde pýre ojajái ñane retã.	Araíre pe nde pýre ojajái ñane retã.	NOCHANGE
Ahayhúnte mitã kuéra ha hi’ã vaerã ko’erõ	Ahayhúnte mitã kuéra ha hi’ã vaerã ko’erõ	NOCHANGE
Ñe’ê ñepyrûháme ndaipóri. ojehai ñe’ê pahápe.	Ñe’ê ñepyrûháme ndaipóri. ojehai ñe’ê pahápe.	NOCHANGE
Mbo’eharakuéra ogueraha ñaneñe’ẽ panambi ha guyráicha	Mbo’eharakuéra ogueraha ñaneñe’ẽ panambi ha guyráicha	NOCHANGE
Tetãvore itapúa, paraguay	Tetãvore itapúa, paraguay	NOCHANGE
Avakuaaty momba’eguasu ñemoarandúpe	Avakuaaty momba’eguasu ñemoarandúpe	NOCHANGE
Ha tory, vy’ápe reipykúi rehóvo mborayhu rape	Ha tory, vy’ápe reipykúi rehóvo mborayhu rape	NOCHANGE
Opuka puku hese ha oho oheka ohekáva. ojecha vai ka’i, ombojeko iñaka yvyráre ha oñembyasy.	Opuka puku hese ha oho oheka ohekáva. ojecha vai ka’i, ombojeko iñaka yvyráre ha oñembyasy.	NOCHANGE
Ku ha’e oheja ohoite mboyve.	Ku ha’e oheja ohoite mboyve.	NOCHANGE
Ñane ñe’ẽ (ñe’ẽpoty) nosso idioma - poesia	Ñane ñe’ẽ (ñe’ẽpoty) nosso idioma - poesia	NOCHANGE
Ñemombe’u techapyrã	Ñemombe’u techapyrã	NOCHANGE
Ohuã’iva’ekue mbohapy tetã ñanerundipávo	Ohuã’iva’ekue mbohapy tetã ñanerundipávo	NOCHANGE
Táva porâite.	Táva porâite.	NOCHANGE
Ojupi ha ñemomyi’ỹ hembiapópe.	Ojupi ha ñemomyi’ỹ hembiapópe.	NOCHANGE
Omyesakãgui ñandéve mba’éichapa ñaha’ãva’erã	Omyesakãgui ñandéve mba’éichapa ñaha’ãva’erã	NOCHANGE
Pe ñe’e oñembohetevo oikove ñande apytepe	Pe ñe’e oñembohetevo oikove ñande apytepe	NOCHANGE
Iro’y, hykue, hasypajoa, mitâmimi omba’ejerure tapére. mba’érepiko ojejahéi	Iro’y, hykue, hasypajoa, mitâmimi omba’ejerure tapére. mba’érepiko ojejahéi	NOCHANGE
Tekopytyjoja ha’e tera ñame’eva tetãyguakuérape ñaikotevẽramo hese	Tekopytyjoja ha’e tera ñame’eva tetãyguakuérape ñaikotevẽramo hese	NOCHANGE
Tamanakuna ipoty porã ha oĩ hetaichagua.	Tamanakuna ipoty porã ha oĩ hetaichagua.	NOCHANGE
Mokõi tupãrymbami ogueraha peteĩ ánga yvágape. hesu rape jerovia ñemohechauka.	Mokõi tupãrymbami ogueraha peteĩ ánga yvágape. hesu rape jerovia ñemohechauka.	NOCHANGE
Osẽ porã joaite.	Osẽ porã joaite.	NOCHANGE
Ñaimo’ã rehesapéva nde kuña porã juky	Ñaimo’ã rehesapéva nde kuña porã juky	NOCHANGE
Mbo’ehára ikatupyryveva’ekue i	Mbo’ehára ikatupyryveva’ekue i	NOCHANGE
Entero mba’e mboyve	Entero mba’e mboyve	NOCHANGE
Oikundaha ñane retâ tuichakue javeve ha avei oikojepe heta ary ambue tetâ	Oikundaha ñane retâ tuichakue javeve ha avei oikojepe heta ary ambue tetâ	NOCHANGE
Mbyja rerakuéra, yva he’êvéva,	Mbyja rerakuéra, yva he’êvéva,	NOCHANGE
Ka’aru pukukue javeve mitârusu ha mitâkuña oñemoarandúva upe mbo’ehaópe ohecha	Ka’aru pukukue javeve mitârusu ha mitâkuña oñemoarandúva upe mbo’ehaópe ohecha	NOCHANGE
Naiporãi eterei ko yvy ári ojepasáva,	Naiporãi eterei ko yvy ári ojepasáva,	NOCHANGE
- mba’éichapa nde réra	- mba’éichapa nde réra	NOCHANGE
Oikuaágui hikuái upéva ha’eha ava imarangatu ha hekosâsóva rapepaha.	Oikuaágui hikuái upéva ha’eha ava imarangatu ha hekosâsóva rapepaha.	NOCHANGE
Oñemyasãi haguã arandu, teko ojehechauka ha oñemopu’ã haguã, ha	Oñemyasãi haguã arandu, teko ojehechauka ha oñemopu’ã haguã, ha	NOCHANGE
I py rei pe o ñembosarái.	I py rei pe o ñembosarái.	NOCHANGE
Avañe’ẽ oipysyrõ ohóvo ñane retã ijojaha’ỹva	Avañe’ẽ oipysyrõ ohóvo ñane retã ijojaha’ỹva	NOCHANGE
Ñe’ẽmbohasa ojejapovaíva ndaha’ei ñe’ẽmbohasa	Ñe’ẽmbohasa ojejapovaíva ndaha’ei ñe’ẽmbohasa	NOCHANGE
Ñe’ẽpyahu ñemoheñói	Ñe’ẽpyahu ñemoheñói	NOCHANGE
Ñemoheñói niko mba’eguasuete umi	Ñemoheñói niko mba’eguasuete umi	NOCHANGE
Ku ko’ëguive opá kuarahy hi’ari kuéra.,	Ku ko’ëguive opá kuarahy hi’ari kuéra.,	NOCHANGE
Ha’ekuéra ojogapokatu oñe’ẽngatu	Ha’ekuéra ojogapokatu oñe’ẽngatu	NOCHANGE
Ko’ã mitakaria’y ikavaju porã ha ojerovia upévare.	Ko’ã mitakaria’y ikavaju porã ha ojerovia upévare.	NOCHANGE
Mayma tekove, táva ha tetâ.	Mayma tekove, táva ha tetâ.	NOCHANGE
Oguahẽ tavaygua ñe’ãme ha omopirĩ hekovépy ha oiporiahuvere ko	Oguahẽ tavaygua ñe’ãme ha omopirĩ hekovépy ha oiporiahuvere ko	NOCHANGE
Ñande je’ymante ñaipohanova’erã	Ñande je’ymante ñaipohanova’erã	NOCHANGE
Ñañangarekova’erã ñande chamame, ñande rapo ha ñane guarani ñe’êre	Ñañangarekova’erã ñande chamame, ñande rapo ha ñane guarani ñe’êre	NOCHANGE
Asterisco s mbyja’i.	Asterisco s mbyja’i.	NOCHANGE
(torýpe ojejapo aty guasu guyra yjere rehegua)	(torýpe ojejapo aty guasu guyra yjere rehegua)	NOCHANGE
Pe añeteguava oiko va’ekue ha justicia nda hechái	Pe añeteguava oiko va’ekue ha justicia nda hechái	NOCHANGE
Ha iñemoñare kuéra ndive avei.	Ha iñemoñare kuéra ndive avei.	NOCHANGE
Paraguái memby, o mano’yro,	Paraguái memby, o mano’yro,	NOCHANGE
Opáy karaiguasu ñane ra’ã iñe’ẽme	Opáy karaiguasu ñane ra’ã iñe’ẽme	NOCHANGE
Tekotevẽ ñamombareteve ha ñahendu avei umi ñe’ẽ poruharakuérape, ha ani ñande	Tekotevẽ ñamombareteve ha ñahendu avei umi ñe’ẽ poruharakuérape, ha ani ñande	NOCHANGE
Peteĩ mburuvicha guasuvépe upepegua omoañete haguã umi hembiapo, ha péicharõ kóva opyta	Peteĩ mburuvicha guasuvépe upepegua omoañete haguã umi hembiapo, ha péicharõ kóva opyta	NOCHANGE
Jerokyhára ha puraheihára ombohetia’eva’ekue aty guasu	Jerokyhára ha puraheihára ombohetia’eva’ekue aty guasu	NOCHANGE
Añemoñesũ avati ra’ỹi ári añe’ẽ avañe’ẽ,	Añemoñesũ avati ra’ỹi ári añe’ẽ avañe’ẽ,	NOCHANGE
Ñandu renimbóre japeposu’u.	Ñandu renimbóre japeposu’u.	NOCHANGE
Ojohayhúva ára	Ojohayhúva ára	NOCHANGE
Ha oñemyasãitahápe ñe’ẽnguéra paraguáipe,	Ha oñemyasãitahápe ñe’ẽnguéra paraguáipe,	NOCHANGE
Jahechahápe umi ñe’êmboguapy osê va’ekue ministro tekopykuaa	Jahechahápe umi ñe’êmboguapy osê va’ekue ministro tekopykuaa	NOCHANGE
Tetãnguéra, ha upeichakuévo, omboguapy ñanerenondépe hekotee.pe iberoamérica tekopykuaa mba’e porãpe ijaty mba’e ojehecháva ha	Tetãnguéra, ha upeichakuévo, omboguapy ñanerenondépe hekotee.pe iberoamérica tekopykuaa mba’e porãpe ijaty mba’e ojehecháva ha	NOCHANGE
Oikóva guive ko yvy ape ári.	Oikóva guive ko yvy ape ári.	NOCHANGE
Peteĩ ñe’ẽ ryru porã ha’e jehechaha mamo, rehekakuaaramo, retopa pe reimo’ãva	Peteĩ ñe’ẽ ryru porã ha’e jehechaha mamo, rehekakuaaramo, retopa pe reimo’ãva	NOCHANGE
Umi mokõi mitakuña oñe’ëñemihína upépe.	Umi mokõi mitakuña oñe’ëñemihína upépe.	NOCHANGE
Osẽ iñakã rehe ysypo.	Osẽ iñakã rehe ysypo.	NOCHANGE
Péicha oñemoherakuê oparupiete ko mba’e guasuete ojehuramoitéva ñane retâme.	Péicha oñemoherakuê oparupiete ko mba’e guasuete ojehuramoitéva ñane retâme.	NOCHANGE
Ma’erã piko ñandejára	Ma’erã piko ñandejára	NOCHANGE
Ape oĩ heta mba’e pene mba’erã.	Ape oĩ heta mba’e pene mba’erã.	NOCHANGE
Upémaramo mitãkuña ho’a itasãme ha oñemoangaipa.	Upémaramo mitãkuña ho’a itasãme ha oñemoangaipa.	NOCHANGE
Che jurúgui osẽ ñe’ẽ iporãva poravopyre	Che jurúgui osẽ ñe’ẽ iporãva poravopyre	NOCHANGE
Chembopotava’erã.	Chembopotava’erã.	NOCHANGE
Jekupyty niko oĩ ára ñande rapichápe ñame’ẽvape,	Jekupyty niko oĩ ára ñande rapichápe ñame’ẽvape,	NOCHANGE
Ojeroviaiteva’ekue ijehe, oñepyrũ okyhyje ha ipy’aragẽ. ojepoi upémarõ henda árigui ha ho’a pe tuju rapépe.	Ojeroviaiteva’ekue ijehe, oñepyrũ okyhyje ha ipy’aragẽ. ojepoi upémarõ henda árigui ha ho’a pe tuju rapépe.	NOCHANGE
Péicha jepi ojapo hese ko’ẽ porã mboyve. oipy’apy asy ichupe.	Péicha jepi ojapo hese ko’ẽ porã mboyve. oipy’apy asy ichupe.	NOCHANGE
Ko tetã ambue guive	Ko tetã ambue guive	NOCHANGE
Ha che ñe’â akóinte ipyahu	Ha che ñe’â akóinte ipyahu	NOCHANGE
Mba’asy escorbuto héravape guarâ ha hi’a pirekue ojepuru ñanembojuruhe hagua ha hemorróidepe	Mba’asy escorbuto héravape guarâ ha hi’a pirekue ojepuru ñanembojuruhe hagua ha hemorróidepe	NOCHANGE
Mba’éicha hesukirito	Mba’éicha hesukirito	NOCHANGE
Tetãvore concepción	Tetãvore concepción	NOCHANGE
Ndaipórirõ sapy’ánte	Ndaipórirõ sapy’ánte	NOCHANGE
Ñande paraguái.	Ñande paraguái.	NOCHANGE
Tembireko, ména, ñemoñare,	Tembireko, ména, ñemoñare,	NOCHANGE
Arahaku ára	Arahaku ára	NOCHANGE
Pyahu jersey, tetã peteĩ reko amérikagua	Pyahu jersey, tetã peteĩ reko amérikagua	NOCHANGE
Ko’ãga peve, pe ta’anga oime tupão ka’akupépe. upepeve ojeho opa tendágui poapy jasypokõipe, ojechauka haguã jerovia ha mborayhu tupãsýme.	Ko’ãga peve, pe ta’anga oime tupão ka’akupépe. upepeve ojeho opa tendágui poapy jasypokõipe, ojechauka haguã jerovia ha mborayhu tupãsýme.	NOCHANGE
Mba’ekuaarã ñemiguáva rehegua	Mba’ekuaarã ñemiguáva rehegua	NOCHANGE
Hembiapokue rehe.	Hembiapokue rehe.	NOCHANGE
Ñambotuichávo pe héra porã.	Ñambotuichávo pe héra porã.	NOCHANGE
Añe’ẽse guaraní che mitãmi guive,	Añe’ẽse guaraní che mitãmi guive,	NOCHANGE
Iporã opa mba’e.	Iporã opa mba’e.	NOCHANGE
Papa oñemoambue ho’u ára,	Papa oñemoambue ho’u ára,	NOCHANGE
Mborayhupy taruma’a ha karanda’ýpe iparaguáva,	Mborayhupy taruma’a ha karanda’ýpe iparaguáva,	NOCHANGE
Pohã ñana paraguaýpe ojeporuvéva mba’e guarãpa ipo...	Pohã ñana paraguaýpe ojeporuvéva mba’e guarãpa ipo...	NOCHANGE
Oñemosãso upe árape heta tapicha oĩva ka’irãime.	Oñemosãso upe árape heta tapicha oĩva ka’irãime.	NOCHANGE
. hi’ãnte reikuaa’ỹre	. hi’ãnte reikuaa’ỹre	NOCHANGE
Ha oikovéva guive yvy ári opaypa ha horyjoaite.	Ha oikovéva guive yvy ári opaypa ha horyjoaite.	NOCHANGE
Ñande akãvai vaerã akointe. upeváre araka’eve nañamendaivaramo’ã	Ñande akãvai vaerã akointe. upeváre araka’eve nañamendaivaramo’ã	NOCHANGE
Tavy, tyre’ỹ, poriahu, ñembyahýi pepo guýpe.	Tavy, tyre’ỹ, poriahu, ñembyahýi pepo guýpe.	NOCHANGE
Oñemombe’u chéve kokuehe	Oñemombe’u chéve kokuehe	NOCHANGE
. ñande yvy oikuáve’ẽ	. ñande yvy oikuáve’ẽ	NOCHANGE
Okáguio ojeporu kangue rasýpe, tete rasýpe, ñande pire oñembyai ramo ha akârague kúipe.	Okáguio ojeporu kangue rasýpe, tete rasýpe, ñande pire oñembyai ramo ha akârague kúipe.	NOCHANGE
Upe nerenoiva’ekuépe.	Upe nerenoiva’ekuépe.	NOCHANGE
Ha upéicha reikovéva tyre’ỹ.	Ha upéicha reikovéva tyre’ỹ.	NOCHANGE
Ha ñande rekoha.	Ha ñande rekoha.	NOCHANGE
Upehague ko’ẽme voi peteĩ mburuvicha	Upehague ko’ẽme voi peteĩ mburuvicha	NOCHANGE
Ha’ekuéra ohejámo oñemitỹmo	Ha’ekuéra ohejámo oñemitỹmo	NOCHANGE
Mba’e iporãvéva rehe ikatuva’erã omohu’u pe mitãkuña korasõ. ojuhusénte	Mba’e iporãvéva rehe ikatuva’erã omohu’u pe mitãkuña korasõ. ojuhusénte	NOCHANGE
Ohejáva neryakuãngue che ñe’ãme	Ohejáva neryakuãngue che ñe’ãme	NOCHANGE
Ha ani orerejátei roñepy’ara’ã	Ha ani orerejátei roñepy’ara’ã	NOCHANGE
Paraguay, ñemby	Paraguay, ñemby	NOCHANGE
Ojehe ko távare ha’e hague ñepyrũrã ojeiko hague távaramo paraguái retãme.	Ojehe ko távare ha’e hague ñepyrũrã ojeiko hague távaramo paraguái retãme.	NOCHANGE
Jaipotáramo ñane remimbo’e ohupyty jeikuaave jepuru hagua hekovépe jaipuruva’erã ko’ã tembipuru pyahu (tic) ñane mbo’esyrýpe.	Jaipotáramo ñane remimbo’e ohupyty jeikuaave jepuru hagua hekovépe jaipuruva’erã ko’ã tembipuru pyahu (tic) ñane mbo’esyrýpe.	NOCHANGE
Rabiar. intr. ñeko’õi, resako’õ, pochy, ñemyrõ, ñarõ.	Rabiar. intr. ñeko’õi, resako’õ, pochy, ñemyrõ, ñarõ.	NOCHANGE
Hatã y pytu ha hãimbe.	Hatã y pytu ha hãimbe.	NOCHANGE
Taropurahéi nde juru mboypýri nde ratypykua.	Taropurahéi nde juru mboypýri nde ratypykua.	NOCHANGE
He’iséva ñe’êpehê upéigua rehegua ohechaukáva hetakue tuichakuépe.	He’iséva ñe’êpehê upéigua rehegua ohechaukáva hetakue tuichakuépe.	NOCHANGE
Ta’ãngahai techapyrã	Ta’ãngahai techapyrã	NOCHANGE
Avei oĩ mokõihápe takuare’ẽ ñeñotỹ ha irundyhápe avati ñeñotỹme.	Avei oĩ mokõihápe takuare’ẽ ñeñotỹ ha irundyhápe avati ñeñotỹme.	NOCHANGE
Ha’ekuéra omoapesâ sa’i sa’ípe sevói ovende haguâ.	Ha’ekuéra omoapesâ sa’i sa’ípe sevói ovende haguâ.	NOCHANGE
Chepyhy tesarái. che yvyra opyta ha ára ohasa,	Chepyhy tesarái. che yvyra opyta ha ára ohasa,	NOCHANGE
Ko mba’e hete ñane rembi’u.	Ko mba’e hete ñane rembi’u.	NOCHANGE
Aguyjevete ndéve, teresa, maymáva ñane retãygua rérape.	Aguyjevete ndéve, teresa, maymáva ñane retãygua rérape.	NOCHANGE
Ñe’ẽ ha tekotee ñemboyke.	Ñe’ẽ ha tekotee ñemboyke.	NOCHANGE
. tesaýpe amoñe’ẽ	. tesaýpe amoñe’ẽ	NOCHANGE
Ñane retã ipytuhẽ.	Ñane retã ipytuhẽ.	NOCHANGE
Tohecha che kokuemígui ko heñóiva ka’aguýpe.	Tohecha che kokuemígui ko heñóiva ka’aguýpe.	NOCHANGE
Avave ndohechakuaaséi upe mba’e chupekuéra	Avave ndohechakuaaséi upe mba’e chupekuéra	NOCHANGE
Ñe’ẽngatujára kuimba’e ha kuña omýiva tesape oguerúva	Ñe’ẽngatujára kuimba’e ha kuña omýiva tesape oguerúva	NOCHANGE
Purahéi ñanemba’éva	Purahéi ñanemba’éva	NOCHANGE
Táva che reñói hague	Táva che reñói hague	NOCHANGE
(oñemohu’ã ohóvo temimbopo ka’a ñeñoty rembiapo rehegua)	(oñemohu’ã ohóvo temimbopo ka’a ñeñoty rembiapo rehegua)	NOCHANGE
Ñande akã hechaukaha.	Ñande akã hechaukaha.	NOCHANGE
Péicha che mopyahê.	Péicha che mopyahê.	NOCHANGE
Péicha oikohápejeko, peteĩ pyhareve omba’apo’ajáhina, ohendu ojepopetéva. osẽ ha ojuhu peteĩ kuña oñembo’ývahina ikorapýpe.	Péicha oikohápejeko, peteĩ pyhareve omba’apo’ajáhina, ohendu ojepopetéva. osẽ ha ojuhu peteĩ kuña oñembo’ývahina ikorapýpe.	NOCHANGE
Ñeñanduporã rehe, ha’e mba’éichapa kóva opoko tapichakuéra	Ñeñanduporã rehe, ha’e mba’éichapa kóva opoko tapichakuéra	NOCHANGE
Ohepyme’ẽkuri. heta pirapire ndaje oñeme’ẽkuri chupe. upégui ou rire,	Ohepyme’ẽkuri. heta pirapire ndaje oñeme’ẽkuri chupe. upégui ou rire,	NOCHANGE
Tembi’u paraguái	Tembi’u paraguái	NOCHANGE
Péicha ha’etevaichavoi aĩva	Péicha ha’etevaichavoi aĩva	NOCHANGE
Parana syrýicha oho ko yvy apére oporomoñe’ẽ.	Parana syrýicha oho ko yvy apére oporomoñe’ẽ.	NOCHANGE
Ava reko porâ niko heñóiva mba’evai tanimbukuégui	Ava reko porâ niko heñóiva mba’evai tanimbukuégui	NOCHANGE
Umi tekopykuaa ha mba’e porãnguéra apopy tekotevê añete, ojejapo ha	Umi tekopykuaa ha mba’e porãnguéra apopy tekotevê añete, ojejapo ha	NOCHANGE
Ñe’ẽ aravóre mbohapyvéva mbo’esyry	Ñe’ẽ aravóre mbohapyvéva mbo’esyry	NOCHANGE
Mitãnguéra osẽ oñembosarái.	Mitãnguéra osẽ oñembosarái.	NOCHANGE
Ñane ñe’ë ratarendy avañe’ëpoty	Ñane ñe’ë ratarendy avañe’ëpoty	NOCHANGE
Taheñoijey ñanemba’e.	Taheñoijey ñanemba’e.	NOCHANGE
Hesukrísto tupao marangatukuéra arapahapegua	Hesukrísto tupao marangatukuéra arapahapegua	NOCHANGE
Ñemby , paraguay -	Ñemby , paraguay -	NOCHANGE
Ha oguata hikuái upe gotyo.	Ha oguata hikuái upe gotyo.	NOCHANGE
Te’ỹ oñemboape ha ohasa.	Te’ỹ oñemboape ha ohasa.	NOCHANGE
Tupânói ha ñembo’e	Tupânói ha ñembo’e	NOCHANGE
Aporohetũ guaraní ñe’ẽme	Aporohetũ guaraní ñe’ẽme	NOCHANGE
Ombohory ñane ñe’ã	Ombohory ñane ñe’ã	NOCHANGE
Ha kuimba’e ndeikuaáva rembyatypa nde jehe.	Ha kuimba’e ndeikuaáva rembyatypa nde jehe.	NOCHANGE
Ha rehorõ sapy’ante hendive reñe’ẽse	Ha rehorõ sapy’ante hendive reñe’ẽse	NOCHANGE
Mbo’eharakuéra pyahu itapegua	Mbo’eharakuéra pyahu itapegua	NOCHANGE
Pya’e ñemoperõva’erã	Pya’e ñemoperõva’erã	NOCHANGE
Ñande rekove peteĩha mbytere ombyai nañderukuéra ha mokõiha mbytere ñande ra’ykuéra	Ñande rekove peteĩha mbytere ombyai nañderukuéra ha mokõiha mbytere ñande ra’ykuéra	NOCHANGE
Tekovekuaaty ñemohenda.	Tekovekuaaty ñemohenda.	NOCHANGE
Ñande rekoha tuicha mba’e	Ñande rekoha tuicha mba’e	NOCHANGE
Ko yvy tuicha javeve	Ko yvy tuicha javeve	NOCHANGE
Ñane retãnguérare, ikatu haguã oñemopu’ã mbarete pe jopói ha	Ñane retãnguérare, ikatu haguã oñemopu’ã mbarete pe jopói ha	NOCHANGE
Péichantevoiko kuimba’e yvy ári	Péichantevoiko kuimba’e yvy ári	NOCHANGE
Ija’e’y rupi pe mitâkuña ndojejuhúi.	Ija’e’y rupi pe mitâkuña ndojejuhúi.	NOCHANGE
Karai kuéra imba’eporãva jepe ou oma’ẽ mimi ore rehe ha oike imba’eyrúpy ha oho jey.	Karai kuéra imba’eporãva jepe ou oma’ẽ mimi ore rehe ha oike imba’eyrúpy ha oho jey.	NOCHANGE
Heñoihague peteĩ ára. hoky peteĩ ñande rapicha apytu’ũme (heñoisapy’a) ha péva	Heñoihague peteĩ ára. hoky peteĩ ñande rapicha apytu’ũme (heñoisapy’a) ha péva	NOCHANGE
Ysypópe ajokua, iporã, imbarete.	Ysypópe ajokua, iporã, imbarete.	NOCHANGE
Upete guive ndojehechaukavéi umi mbohapy póra. oiméne niko ñandejára oñyrõmba’e chupekuéra...	Upete guive ndojehechaukavéi umi mbohapy póra. oiméne niko ñandejára oñyrõmba’e chupekuéra...	NOCHANGE
Ko mymba oguereko peteĩ hatĩ guasu eteva itĩ ári, ikatu oreko peteĩ térã mokõi tĩ hatĩ.	Ko mymba oguereko peteĩ hatĩ guasu eteva itĩ ári, ikatu oreko peteĩ térã mokõi tĩ hatĩ.	NOCHANGE
Ha che pyhy hetaiterei jey, ha iporãitéva juayhúpe	Ha che pyhy hetaiterei jey, ha iporãitéva juayhúpe	NOCHANGE
Nde rehypyiva’ekue remoirũva’ekue	Nde rehypyiva’ekue remoirũva’ekue	NOCHANGE
Oipota rupi iporã.	Oipota rupi iporã.	NOCHANGE
Oñemomba’eguasuve, ojepuru umi tenda	Oñemomba’eguasuve, ojepuru umi tenda	NOCHANGE
A’anga i tema ãngy opytyva va’e	A’anga i tema ãngy opytyva va’e	NOCHANGE
Ha’ekuéra niko yvy jára va’ekue,	Ha’ekuéra niko yvy jára va’ekue,	NOCHANGE
Mbyja pyahu.	Mbyja pyahu.	NOCHANGE
Tetã paraguáipe	Tetã paraguáipe	NOCHANGE
(peteĩ téchaukápe).	(peteĩ téchaukápe).	NOCHANGE
Marõ oĩmiviva ko arapýpe	Marõ oĩmiviva ko arapýpe	NOCHANGE
Ha yvyrape.	Ha yvyrape.	NOCHANGE
Ka’aguy opytáva	Ka’aguy opytáva	NOCHANGE
(ogue tesapeha. hendy jey, ñasaindyporãramoguáicha).	(ogue tesapeha. hendy jey, ñasaindyporãramoguáicha).	NOCHANGE
Che retã paraguáipe,	Che retã paraguáipe,	NOCHANGE
Topytánte ha’ekuéra	Topytánte ha’ekuéra	NOCHANGE
Representante terã abogado de empresa reheguárõ, omba’apóva hepyrehe tetãguasu, tetãmini ha	Representante terã abogado de empresa reheguárõ, omba’apóva hepyrehe tetãguasu, tetãmini ha	NOCHANGE
Tembiguai ñe’ê po’ive	Tembiguai ñe’ê po’ive	NOCHANGE
Mba’emba’épepa ha moõmoõpa tekotevẽ	Mba’emba’épepa ha moõmoõpa tekotevẽ	NOCHANGE
Ha’ekuéra ápe oiko	Ha’ekuéra ápe oiko	NOCHANGE
Morotĩ opa.	Morotĩ opa.	NOCHANGE
Ñeembucú opyta ysyry paraná ha paraguái mbytépe.	Ñeembucú opyta ysyry paraná ha paraguái mbytépe.	NOCHANGE
Ha upe ára guive	Ha upe ára guive	NOCHANGE
Ko ñane retã yvýpe	Ko ñane retã yvýpe	NOCHANGE
Ñamongu’i porã ko aramirõ ha ñamoĩ pe mba’e apopyrépe heta porã imbaretemí meve. upéi ñambojehe’a upe masa hu’ũ porã meve.	Ñamongu’i porã ko aramirõ ha ñamoĩ pe mba’e apopyrépe heta porã imbaretemí meve. upéi ñambojehe’a upe masa hu’ũ porã meve.	NOCHANGE
Iñe’ẽpu ryapu asýpe opurahéiva’ekue	Iñe’ẽpu ryapu asýpe opurahéiva’ekue	NOCHANGE
Mba’etekópa hina ko pyhare.	Mba’etekópa hina ko pyhare.	NOCHANGE
Oĩ akãme omba’apóvakuéra oñeha’ãva omyanyhe haguã ñande apytu’ũ ha oĩ umi oñeha’ãva omonandi haguã. na tekotevei ja’e pe ipahague hetavéha	Oĩ akãme omba’apóvakuéra oñeha’ãva omyanyhe haguã ñande apytu’ũ ha oĩ umi oñeha’ãva omonandi haguã. na tekotevei ja’e pe ipahague hetavéha	NOCHANGE
Peteĩ ñe’ẽme tekokatúpe ombopoty py’aporã jahecha	Peteĩ ñe’ẽme tekokatúpe ombopoty py’aporã jahecha	NOCHANGE
Ha iñakã porãva.	Ha iñakã porãva.	NOCHANGE
Mboriahu anga yvy ári oisu’u ha ogueraha.	Mboriahu anga yvy ári oisu’u ha ogueraha.	NOCHANGE
Omoheñói ka’avo	Omoheñói ka’avo	NOCHANGE
Ko peteĩ osẽ háichama osẽva.	Ko peteĩ osẽ háichama osẽva.	NOCHANGE
Guarani ñe’ẽ hembiapo, ko’ẽrei omyasãiva	Guarani ñe’ẽ hembiapo, ko’ẽrei omyasãiva	NOCHANGE
Omoheñói ha okakuaa maymáva kógamimi.	Omoheñói ha okakuaa maymáva kógamimi.	NOCHANGE
Kóva niko che retâ tujaite, che ru ha che sy ypykue ha ypykuéra rekoha, ha’ekuéra oikohaguépe.	Kóva niko che retâ tujaite, che ru ha che sy ypykue ha ypykuéra rekoha, ha’ekuéra oikohaguépe.	NOCHANGE
Okakuaavévo oiko chugui kuña, kuñataĩ, ojapopaitéma tembiapo ogapýpegua, oipytyvõ isýpe.	Okakuaavévo oiko chugui kuña, kuñataĩ, ojapopaitéma tembiapo ogapýpegua, oipytyvõ isýpe.	NOCHANGE
Araka’eve nãcherembiapo hetavei ndarekoiháicha jave mba’eve ajapovaerã	Araka’eve nãcherembiapo hetavei ndarekoiháicha jave mba’eve ajapovaerã	NOCHANGE
Ñamboyke’imi ñopichãi, péva ohechauka ñande ajumahañaína.	Ñamboyke’imi ñopichãi, péva ohechauka ñande ajumahañaína.	NOCHANGE
Tupãsy ka’akupe neporãitéva	Tupãsy ka’akupe neporãitéva	NOCHANGE
Kaso ñemombe’u	Kaso ñemombe’u	NOCHANGE
Opa ñembiandupyhy ha’e ka’irãi	Opa ñembiandupyhy ha’e ka’irãi	NOCHANGE
Tupãópe oñeguahẽ haguã.	Tupãópe oñeguahẽ haguã.	NOCHANGE
Ha ipukúva rembe ári.	Ha ipukúva rembe ári.	NOCHANGE
Rehehápe ha hovy ojegueroayvúvo nane retâ rekosâso.	Rehehápe ha hovy ojegueroayvúvo nane retâ rekosâso.	NOCHANGE
. hesekuérante reikóva mba’apo ha jejopýpe	. hesekuérante reikóva mba’apo ha jejopýpe	NOCHANGE
Nde, ñe’ẽmbopotyhára,	Nde, ñe’ẽmbopotyhára,	NOCHANGE
Paraguái ñe’ê’ypy, tenondegua ha ojepyruvéva.	Paraguái ñe’ê’ypy, tenondegua ha ojepyruvéva.	NOCHANGE
Nde rekay’u’arã remohenda’arã	Nde rekay’u’arã remohenda’arã	NOCHANGE
Tupã, ñandejára, ne irũramo oiko imombe’u katupyrýre,	Tupã, ñandejára, ne irũramo oiko imombe’u katupyrýre,	NOCHANGE
Umi tekove oñemoarandu guaraníme oñe’ẽ ha ohaíma	Umi tekove oñemoarandu guaraníme oñe’ẽ ha ohaíma	NOCHANGE
Ñemiháme. oikóje ohapera’arõ mitãkuña osẽva asajerei hógagui,	Ñemiháme. oikóje ohapera’arõ mitãkuña osẽva asajerei hógagui,	NOCHANGE
Aiko porã. mba’e rejapo.	Aiko porã. mba’e rejapo.	NOCHANGE
Ahechárõ jasy ahecha ipype nde rova	Ahechárõ jasy ahecha ipype nde rova	NOCHANGE
Kóva niko ñe’ẽpyahã ñe’ẽngatu rupive. ojapóva ñe’ẽsyry oñeha’ãne ikatuha peve omoinge hemiandu hapicha -ohendúva- apytu’ũme.	Kóva niko ñe’ẽpyahã ñe’ẽngatu rupive. ojapóva ñe’ẽsyry oñeha’ãne ikatuha peve omoinge hemiandu hapicha -ohendúva- apytu’ũme.	NOCHANGE
Ñembosaraipavẽ peteĩ ojejapókuri ñembyamérikape ha pindoráma retãme.	Ñembosaraipavẽ peteĩ ojejapókuri ñembyamérikape ha pindoráma retãme.	NOCHANGE
Pohã ñana paraguaýpe ojeporuvéva mba’e guarãpa iporã	Pohã ñana paraguaýpe ojeporuvéva mba’e guarãpa iporã	NOCHANGE
Ñambosako’i haguâ té, ndojeporu va’erâi araka’eve tembiporu iñerrúmbeva. upéichante avei ñambosako’ívo yva ha ka’avoguigua.	Ñambosako’i haguâ té, ndojeporu va’erâi araka’eve tembiporu iñerrúmbeva. upéichante avei ñambosako’ívo yva ha ka’avoguigua.	NOCHANGE
Ñanemba’éva.	Ñanemba’éva.	NOCHANGE
Hũva ha péicha avei pe paje hũ apohára ndaikatúi ojapo paje morotĩva. paje	Hũva ha péicha avei pe paje hũ apohára ndaikatúi ojapo paje morotĩva. paje	NOCHANGE
Ijepopete rupive. ko amandajépe oikékuri avei ñe’êpoty, purahéi ha jeroky	Ijepopete rupive. ko amandajépe oikékuri avei ñe’êpoty, purahéi ha jeroky	NOCHANGE
Porâ kuñanguérape, ohundi tymba chu’ikuéra.	Porâ kuñanguérape, ohundi tymba chu’ikuéra.	NOCHANGE
Ñande ru ha ñande sýpe	Ñande ru ha ñande sýpe	NOCHANGE
Mbo’ekuaahára pyahu	Mbo’ekuaahára pyahu	NOCHANGE
Jerovia ha’e upe tembiapo oñemomba’eguasuvéva. ha’ekuéra omomba’eguasu tupã	Jerovia ha’e upe tembiapo oñemomba’eguasuvéva. ha’ekuéra omomba’eguasu tupã	NOCHANGE
Jehekýi oiko ojepe’áramo ñe’ëpehẽtai, ñe’ẽriregua ha ñe’ẽjoajuha peteĩ ñe’ẽ ykéregui.	Jehekýi oiko ojepe’áramo ñe’ëpehẽtai, ñe’ẽriregua ha ñe’ẽjoajuha peteĩ ñe’ẽ ykéregui.	NOCHANGE
Oity chupe... oje’éva jepiko avei, ñuhã	Oity chupe... oje’éva jepiko avei, ñuhã	NOCHANGE
Ñembyaíro ta’ãnga’ita ñañongatunde vaerã ipyrenda. katuete ojepurune upei	Ñembyaíro ta’ãnga’ita ñañongatunde vaerã ipyrenda. katuete ojepurune upei	NOCHANGE
Ndoikuaái gueteri ha’ekuéra	Ndoikuaái gueteri ha’ekuéra	NOCHANGE
Ára pyahu togueru.	Ára pyahu togueru.	NOCHANGE
Osyry hesay hetã pepo guýpe... ha okái.	Osyry hesay hetã pepo guýpe... ha okái.	NOCHANGE
Tetã peteĩ reko amérikagua	Tetã peteĩ reko amérikagua	NOCHANGE
Ha upéicha rupi márõ ndokuerái ñane mba’asy.	Ha upéicha rupi márõ ndokuerái ñane mba’asy.	NOCHANGE
Itajeresoha yvyty ombojeréva, hyãsia retãme.	Itajeresoha yvyty ombojeréva, hyãsia retãme.	NOCHANGE
Tetãygua reko rehegua, mbaoeéichapa upéva ojoaju akarapuoeã	Tetãygua reko rehegua, mbaoeéichapa upéva ojoaju akarapuoeã	NOCHANGE
Py’amokõi rovake, ñañembopy’apeteĩ hekojojáva rehe	Py’amokõi rovake, ñañembopy’apeteĩ hekojojáva rehe	NOCHANGE
Omimbi nomimbipáiva kuarahy rata omo’ã,	Omimbi nomimbipáiva kuarahy rata omo’ã,	NOCHANGE
Javy’a ñane retãme	Javy’a ñane retãme	NOCHANGE
Jaroviágui umi ñande ypykue ñemomba’e outaha ñamoingove ha	Jaroviágui umi ñande ypykue ñemomba’e outaha ñamoingove ha	NOCHANGE
Ombojopyrúva. ouva’ekue oiko paraguaýpe, omoñe’ẽva	Ombojopyrúva. ouva’ekue oiko paraguaýpe, omoñe’ẽva	NOCHANGE
Ko ñe’ê omanóta, ipytu kangýma guarani ñe’ê.	Ko ñe’ê omanóta, ipytu kangýma guarani ñe’ê.	NOCHANGE
Umi ñemombe’u iñasãiva ñane retãpýre ha ñande rapicha omombe’úva imandu’akuévo	Umi ñemombe’u iñasãiva ñane retãpýre ha ñande rapicha omombe’úva imandu’akuévo	NOCHANGE
Ha che páype upéi ko’ýte rohechase	Ha che páype upéi ko’ýte rohechase	NOCHANGE
Ndajuhúi ko arapýpe.	Ndajuhúi ko arapýpe.	NOCHANGE
Nde mante va’erã jey oimehápe ku reike hypýva	Nde mante va’erã jey oimehápe ku reike hypýva	NOCHANGE
Jahayhúva ko tetã toguãhe chupe hi’ára	Jahayhúva ko tetã toguãhe chupe hi’ára	NOCHANGE
Ha ome’ẽva chéve ko py’aguapy.	Ha ome’ẽva chéve ko py’aguapy.	NOCHANGE
Ñe’ẽ teépe ha ojehekombo’e ichupekuéra	Ñe’ẽ teépe ha ojehekombo’e ichupekuéra	NOCHANGE
Mburuvichárõ umi ojeja’óva.	Mburuvichárõ umi ojeja’óva.	NOCHANGE
Hypy’ũva mbo’epy ãngapýre ohesapéva oñemohenda	Hypy’ũva mbo’epy ãngapýre ohesapéva oñemohenda	NOCHANGE
Che- mbyaju ko- t- a’arõ	Che- mbyaju ko- t- a’arõ	NOCHANGE
(ñomongeta porã omomba va’erã ñe’ẽmbyrã, ndaha’éi oñe’ẽva kuérape).	(ñomongeta porã omomba va’erã ñe’ẽmbyrã, ndaha’éi oñe’ẽva kuérape).	NOCHANGE
Mbyry’ái, ñembyahýiva	Mbyry’ái, ñembyahýiva	NOCHANGE
Kuña ha kuimba’éva	Kuña ha kuimba’éva	NOCHANGE
Pehendúke che ñe’ẽ	Pehendúke che ñe’ẽ	NOCHANGE
O yvára peteĩ gui,	O yvára peteĩ gui,	NOCHANGE
Ñemby - paraguay.com	Ñemby - paraguay.com	NOCHANGE
Ha apurahéita, vy’ape apurahéita	Ha apurahéita, vy’ape apurahéita	NOCHANGE
(upe oñapymiva’ekue chugui ijyga, y porãhápe jepe oryrýi).	(upe oñapymiva’ekue chugui ijyga, y porãhápe jepe oryrýi).	NOCHANGE
Péva ha’e ñe’ẽtéva, ha’égui pe ñe’ẽ tee térã katu ñe’ẽ oñemomba’eguasuvéva terone’ẽje’évape.	Péva ha’e ñe’ẽtéva, ha’égui pe ñe’ẽ tee térã katu ñe’ẽ oñemomba’eguasuvéva terone’ẽje’évape.	NOCHANGE
(oñembohapejeýva maya-kuéra)	(oñembohapejeýva maya-kuéra)	NOCHANGE
Topa tekotevẽ ko yvy ári.	Topa tekotevẽ ko yvy ári.	NOCHANGE
Ñane ñenguahy’i va’ekuéma,	Ñane ñenguahy’i va’ekuéma,	NOCHANGE
Ndajaipotái ni peteĩ okañy.	Ndajaipotái ni peteĩ okañy.	NOCHANGE
Iporãite chopĩ jeroky jahecháa’ekue kuehe.	Iporãite chopĩ jeroky jahecháa’ekue kuehe.	NOCHANGE
Ñanderesaraivóve ñandehegui, jajapo mba’ekuéra momba’eguasurã ha mandu’arãpy	Ñanderesaraivóve ñandehegui, jajapo mba’ekuéra momba’eguasurã ha mandu’arãpy	NOCHANGE
Nda’ipóri avaréicha ohayhúva yvypóra	Nda’ipóri avaréicha ohayhúva yvypóra	NOCHANGE
Joyke’y paraguái, iporãma,	Joyke’y paraguái, iporãma,	NOCHANGE
Nde réra oikóva ku eíra saitéicha che ahy’okuápe,	Nde réra oikóva ku eíra saitéicha che ahy’okuápe,	NOCHANGE
Ha rohavi’úva che ñe’ẽ yvotýpe ko’ẽju ryke	Ha rohavi’úva che ñe’ẽ yvotýpe ko’ẽju ryke	NOCHANGE
Péicha oturuñe’ẽ	Péicha oturuñe’ẽ	NOCHANGE
Ne ñe’ẽ ahendu rupi	Ne ñe’ẽ ahendu rupi	NOCHANGE
Porãitére. ha’ekuéra ojokakuaairu. hetaiterei oiko upérupi karia’y	Porãitére. ha’ekuéra ojokakuaairu. hetaiterei oiko upérupi karia’y	NOCHANGE
Mbyjajere ojeréva kuarahýre peteĩ arýpe, ñande rekoha. kuarahýgui mbohapyha imombyrýre.	Mbyjajere ojeréva kuarahýre peteĩ arýpe, ñande rekoha. kuarahýgui mbohapyha imombyrýre.	NOCHANGE
Ha upéicha ko che apyta.	Ha upéicha ko che apyta.	NOCHANGE
Ñemoñe’ë paha	Ñemoñe’ë paha	NOCHANGE
- nde reimo’ã reína reñemongetaha pa’i ndive.	- nde reimo’ã reína reñemongetaha pa’i ndive.	NOCHANGE
Pya’ekue eikotevẽva ñemigua eipotáva ndive opaite ne mba’e’okápe.	Pya’ekue eikotevẽva ñemigua eipotáva ndive opaite ne mba’e’okápe.	NOCHANGE
Ko tembiapo rehegua	Ko tembiapo rehegua	NOCHANGE
Upe riremínte oguahẽ tujami ra’ykuéra ha ohechakuaávo hikuái mávapa itúva jukahare, oñondivepa osẽ omuña ha ojuka hikuái chavukúpe.	Upe riremínte oguahẽ tujami ra’ykuéra ha ohechakuaávo hikuái mávapa itúva jukahare, oñondivepa osẽ omuña ha ojuka hikuái chavukúpe.	NOCHANGE
Ha umi guyra opurahéi	Ha umi guyra opurahéi	NOCHANGE
Ñande rapicha	Ñande rapicha	NOCHANGE
Kuéra, ha oñemoĩ ombohovái opa mburuvicha oñemomba’eharére.	Kuéra, ha oñemoĩ ombohovái opa mburuvicha oñemomba’eharére.	NOCHANGE
Ahendúva osyry mba’e porâita pa’ûme	Ahendúva osyry mba’e porâita pa’ûme	NOCHANGE
Ãngapyhy ome’ẽva kuatia ñe’ẽ tuja moñe’ẽ ha’e jeikuaa noikoteveĩha mbohovai	Ãngapyhy ome’ẽva kuatia ñe’ẽ tuja moñe’ẽ ha’e jeikuaa noikoteveĩha mbohovai	NOCHANGE
Ñambohape ñane ñe’ẽ jajokupyty porãve haguã ñane arandúpe	Ñambohape ñane ñe’ẽ jajokupyty porãve haguã ñane arandúpe	NOCHANGE
Iporã ñu guasu guataha renda.	Iporã ñu guasu guataha renda.	NOCHANGE
Ary umi ojehecharamovéva jehechaukarã atýpe.	Ary umi ojehecharamovéva jehechaukarã atýpe.	NOCHANGE
Ku he’ẽ mbochýva verso avañe’ẽ,	Ku he’ẽ mbochýva verso avañe’ẽ,	NOCHANGE
Nde rehe kuña	Nde rehe kuña	NOCHANGE
Che rapichakuéra oñembosako’íma	Che rapichakuéra oñembosako’íma	NOCHANGE
Rosa iporãva nde joguaha.	Rosa iporãva nde joguaha.	NOCHANGE
Ñane tĩko’õ oúvo yvytúre	Ñane tĩko’õ oúvo yvytúre	NOCHANGE
Tekotevẽ oñembo’e tekoha reheguáre opárupi ha opaichave.	Tekotevẽ oñembo’e tekoha reheguáre opárupi ha opaichave.	NOCHANGE
Peteĩ mba’e neporãva ojejapóva ha’e	Peteĩ mba’e neporãva ojejapóva ha’e	NOCHANGE
Ha jaikuaa’ýva jajeporeka, mba’égui piko ambue ikatúta ha ñande	Ha jaikuaa’ýva jajeporeka, mba’égui piko ambue ikatúta ha ñande	NOCHANGE
Oimeraẽva mba’e tetãmini terã tetãguasu reheguáre.	Oimeraẽva mba’e tetãmini terã tetãguasu reheguáre.	NOCHANGE
Táva guasu argentino hesâi.	Táva guasu argentino hesâi.	NOCHANGE
Ha upekuévo toñemomba’e che ângare	Ha upekuévo toñemomba’e che ângare	NOCHANGE
Ha’ekuéra ohesyva’erã omokãva’erã	Ha’ekuéra ohesyva’erã omokãva’erã	NOCHANGE
Táva aregua motenondehára, hembireko ha ambue mburuvichakuéra	Táva aregua motenondehára, hembireko ha ambue mburuvichakuéra	NOCHANGE
Ijapytepekuéra oĩva’erã opa region tetãmini yvypegua, oguerekóva umi táva representante, umi	Ijapytepekuéra oĩva’erã opa region tetãmini yvypegua, oguerekóva umi táva representante, umi	NOCHANGE
Kóvap ojuhu peve.	Kóvap ojuhu peve.	NOCHANGE
Vaipa. ha’e ramo ma avakue pavẽ	Vaipa. ha’e ramo ma avakue pavẽ	NOCHANGE
Oguereko añetete ojekuaha va’erã opárupi, umi omba’apo haguépe ha ombopyhau va’erã opa ary.	Oguereko añetete ojekuaha va’erã opárupi, umi omba’apo haguépe ha ombopyhau va’erã opa ary.	NOCHANGE
Tuichave tetãyguakuéra tetã rehe	Tuichave tetãyguakuéra tetã rehe	NOCHANGE
Jepiveguáicha oñongatu sapy’arei oujeýrõ omba’ejerure. py’ỹinte niko	Jepiveguáicha oñongatu sapy’arei oujeýrõ omba’ejerure. py’ỹinte niko	NOCHANGE
Jekupyty niko oĩ mitãmi ma’ẽ rorýpe,	Jekupyty niko oĩ mitãmi ma’ẽ rorýpe,	NOCHANGE
Tetã ñe’ẽngu oipotágui.	Tetã ñe’ẽngu oipotágui.	NOCHANGE
Amongarúta che rembireko ha che ra’ykuérape.	Amongarúta che rembireko ha che ra’ykuérape.	NOCHANGE
Ñe’ẽndýi teroja tero ñe’ẽtéva	Ñe’ẽndýi teroja tero ñe’ẽtéva	NOCHANGE
Tembiapokue tembikuaapavẽ rapykuere, ha ambueve.	Tembiapokue tembikuaapavẽ rapykuere, ha ambueve.	NOCHANGE
Upeicha oguahẽ mborayhu añetete	Upeicha oguahẽ mborayhu añetete	NOCHANGE
Ichupekuéra guarã.	Ichupekuéra guarã.	NOCHANGE
Mbo’eharakuéra hatãiterei ñe’ẽtekuaápe ha nombo’éi ñe’ẽ jeporu.	Mbo’eharakuéra hatãiterei ñe’ẽtekuaápe ha nombo’éi ñe’ẽ jeporu.	NOCHANGE
Tetãmini rehegua omba’apóva ta ha’e ha’éva rérape, mbyky terã ipukúrõ hembiapo, tojepaga terã	Tetãmini rehegua omba’apóva ta ha’e ha’éva rérape, mbyky terã ipukúrõ hembiapo, tojepaga terã	NOCHANGE
Chémane. ñe’ẽteja	Chémane. ñe’ẽteja	NOCHANGE
Oguahẽvo hógape otopa hembirekópe peteĩ ña’ẽ pyahu rehevéma.	Oguahẽvo hógape otopa hembirekópe peteĩ ña’ẽ pyahu rehevéma.	NOCHANGE
- ma’erãpiko rejupi upépe.	- ma’erãpiko rejupi upépe.	NOCHANGE
Mba’asy oñembyaíva, oúva	Mba’asy oñembyaíva, oúva	NOCHANGE
Mba’e ipyahúva	Mba’e ipyahúva	NOCHANGE
So’o kangue ñemombo jaguape ndaha’ei porayhu. porayhu ha’e nde so’o kangue mboja’o nde rymba jagua ndíve nde vare’a jave ha’éichaite	So’o kangue ñemombo jaguape ndaha’ei porayhu. porayhu ha’e nde so’o kangue mboja’o nde rymba jagua ndíve nde vare’a jave ha’éichaite	NOCHANGE
Peteĩ ka’avo hérava aromita	Peteĩ ka’avo hérava aromita	NOCHANGE
Ha’eha nde ára	Ha’eha nde ára	NOCHANGE
Gua’upore mba’e iporãvéva , heta mobe’uapy’ãkuérape, ha’e marandu he’íva mba’apojekuéra oñeimo’ãvanteha	Gua’upore mba’e iporãvéva , heta mobe’uapy’ãkuérape, ha’e marandu he’íva mba’apojekuéra oñeimo’ãvanteha	NOCHANGE
Ñësëhá rupi.	Ñësëhá rupi.	NOCHANGE
Ojekuaauka tetã pytaguáva rehe	Ojekuaauka tetã pytaguáva rehe	NOCHANGE
Ku tape puku porãite asy ipyahúva hína	Ku tape puku porãite asy ipyahúva hína	NOCHANGE
Ñande jajerokymo’ã ñamondoromo’ã	Ñande jajerokymo’ã ñamondoromo’ã	NOCHANGE
Mba’eve no seĩ chupe ojeharúma.	Mba’eve no seĩ chupe ojeharúma.	NOCHANGE
Peteĩ yvykua y ndive omãpe.	Peteĩ yvykua y ndive omãpe.	NOCHANGE
Unidas (unesco), oñemboguapyva’ekue	Unidas (unesco), oñemboguapyva’ekue	NOCHANGE
Anichéne itapykue, paraguáiva tembi’u.	Anichéne itapykue, paraguáiva tembi’u.	NOCHANGE
Mbyja kuéra ovaháich pyhare.	Mbyja kuéra ovaháich pyhare.	NOCHANGE
Mborayhu oĩ ndepype	Mborayhu oĩ ndepype	NOCHANGE
Mba’e rehe repuka	Mba’e rehe repuka	NOCHANGE
Ha upérõmi ñañandu hakuvy ñane ñe’ãme	Ha upérõmi ñañandu hakuvy ñane ñe’ãme	NOCHANGE
Ha omoĩ ñane ne’ã kuápe heñoi ha ipoty jera	Ha omoĩ ñane ne’ã kuápe heñoi ha ipoty jera	NOCHANGE
Ha’ekuéra omboja omomarandu	Ha’ekuéra omboja omomarandu	NOCHANGE
Ndaikatúi amongeta che ñe’ẽ ojepo’opa cheñe’ã ojereraha	Ndaikatúi amongeta che ñe’ẽ ojepo’opa cheñe’ã ojereraha	NOCHANGE
