Ma' tin wiéaj u aáawtaal tin kaajali'	Ma' ' matin wiéa wáajj u aáawtaal tin kaajali'i'	TYPE:NEG;SUBTYPE:INT
Ma' tin wilaj u sáas1tal tin kaajali'	Ma' ta wilaj u sáas1tal tin e'exkaajali'	PERSON:2_PL
Ka bin tu kaxtaj bin uu jun xóot' nook' bine'	Ka bin tu kaxtaj bin uu jun xóot' nook' bine'	NOCHANGE
Jach wáaj k'a'abéet ah bin sk'éiwikil koonol	Jach wáaj k'a'abéet ah bin s'a'abéet k'éiwikil koonol	ASPECT:OBL
Chen ba'ax túune' esteee koomo ke u cha'a'maj u tsoone' kex táan u ts'onik le ba'alo' ma'atáan esten  u kíimil bin	Chen ba'ax túune' esteee koomo ke u cha'a'maj u tsoone' kex táan u ts'onik le ba'alo' ma'atáan esten  u kíimil bin	NOCHANGE
Jach chen bin máak ku jaantik chen ba'ale  xiib bin ku jaantik u pool tun bin le máako'obo'bey bin chen bin leeti' ku jaantik	Jach chen bin máak ku jaantik chen ba'ale  xiib bin ku jaantik u pool tun bin le máako'obo'bey bin chen bin leeti' ku jaantik	NOCHANGE
Chen ba'axe' teen kin tukultik túun beyo' wa ya'ab máax ka u kan u meente'	Chen ba'axe' teen kin tukultik túun beyo' wa ya'ab máax ka u kan u meente'	NOCHANGE
Yaan wáaj in bin okoonol mirnkaatd	Yaan waj wááaj in bin okoonol mirnkaatd	SUBTYPE:INT
Le ken a wil wel táan u jóok'ol u yóome' ka tupik yaanal ts'o'ok u liistoal beyo'	Le ken a wil wel táan u jóok'ol u yóome' ka tupik yaanal ts'o'ok u liistoal beyo'	NOCHANGE
U obstaakulo' yaan beyo' wa ba'ax  ti' bey ma' in takiko'one' u tojol	U obstaakulo' yaan beyo' wa ba'ax  ti' bey ma' in takiko'one' u tojol	NOCHANGE
Relijioon katoolika ku ya'ala'alo' ichil túun	Relijioon katoolika ku ya'ala'alo' ichil túun	NOCHANGE
Tumeen ka'ach bino' jach	Tumeen ka'ach bino' jach	NOCHANGE
T1óñux kajaoobalen	Ts'o'ot 1óñux kajaoobalen	ASPECT:TER;TENSE:PAS_SIM
Kux wa  ka sa'atakech  máax kun kanáantiklech- ki bin ti'	Kux wa  ka sa'atakech  máax kun kanáantiklech- ki bin ti'	NOCHANGE
Ku ts'áako'ob u nib óolil le ku meyajko'ob kool  ku ts'áako'ob u níin óolil e uu síibil ti'al leti'o'ob u	Ku ts'áako'ob u nib óolil le ku meyajko'ob kool  ku ts'áako'ob u níin óolil e uu síibil ti'al leti'o'ob u	NOCHANGE
Le chan paalo' tumeen ku ya'ala'ale' yaan ku taas taasbil u meenta'alo'ob	Le chan paalo' tumeen ku ya'ala'ale' yaan ku taas taasbil u meenta'alo'ob	NOCHANGE
Maas úuchbe ti' teeche' yaan a	Maas úuchbe ti' teeche' yaan a	NOCHANGE
Ku ts'okol túune' je'ex in wa'alik techo' ku ts'áak jump'éel	Ku ts'okol túune' je'ex in wa'alik techo' ku ts'áak jump'éel	NOCHANGE
Tin míis8ik in najwl	Tin míis8ik in e'exnajwl	PERSON:2_PL
Su láaj meyajtiko'ob	Su láaj meyajtiko'ob	NOCHANGE
May kajakbalen tij wotochi'	May kajakbalsuue n tij wotochi'	SUBTYPE:DEC;ASPECT:CUS
Ma'alobtalo' ku jóok'sa'al	Ma'alobtalo' ku jóok'sa'al	NOCHANGE
Íene'ñáak'ab úin bin tu k'íiwikil koon l	Íe'exe'ñáak'ab úi'ex bin tu k'íiwikil koon l	PERSON:2_PL
Ku bino'ob le pixano'obo'	Ku bino'ob le pixano'obo'	NOCHANGE
Pues leeti'o'obe' láaili'  ku chíimpoltiko'obe' láaili' jeets'el tu tuukulo'obe'	Pues leeti'o'obe' láaili'  ku chíimpoltiko'obe' láaili' jeets'el tu tuukulo'obe'	NOCHANGE
Tu'ux kun ts'áabil u nu'ukulil	Tu'ux kun ts'áabil u nu'ukulil	NOCHANGE
Jach taaj leeti'o'obe' jach ku ts'áaik u yóol u t'ano'ob máak leeti'o'obe' chen u ya'alobtech	Jach taaj leeti'o'obe' jach ku ts'áaik u yóol u t'ano'ob máak leeti'o'obe' chen u ya'alobtech	NOCHANGE
Táan wáaj a bn koono mrkñ'no	Táan wáaj a bn koono wáaj mrkñ'no	SUBTYPE:INT
Saajak u	Saajak u	NOCHANGE
U maama bino' tu jóok'saj bin te'el chan kajtalil bin tu'ux yano'obo'	U maama bino' tu jóok'saj bin te'el chan kajtalil bin tu'ux yano'obo'	NOCHANGE
Uk'ul le waajo'ob ken u biso' u u loolilo'ob u kibilo'ob	Uk'ul le waajo'ob ken u biso' u u loolilo'ob u kibilo'ob	NOCHANGE
Kaajlo'ob tu'ux eee jach a'ik aja'an u tuukulo'obe' tumeen je'el bix ti'al klu'umil to'on kintaana roj	Kaajlo'ob tu'ux eee jach a'ik aja'an u tuukulo'obe' tumeen je'el bix ti'al klu'umil to'on kintaana roj	NOCHANGE
Táan u bin oool tu k'íiwikil koonol	Táan u bin ots'o'oo ol tu k'íiwikil koonol	ASPECT:TER;TENSE:PAS_SIM
Tene' yaan ten xook ti' spañol	To'one' yaan ten xook ti' spañonol	ASPECT:HAB;PERSON:1_PL
Le waajo'	Le waajo'	NOCHANGE
De óoxyáal	De óoxyáal	NOCHANGE
Yaan wíinike' ku kolaartik yaan wíinike' ku	Yaan wíinike' ku kolaartik yaan wíinike' ku	NOCHANGE
Jach k'a'abéet in jin tu k'íiwikil koonol	Jach  wáajk'a'abéet in jin tu k'íiwikil koonol	SUBTYPE:INT
Ku p'ayko'ob ti'al u ts'áao'ob k'áak' yéetel ja' ti'al u chakiko'ob	Ku p'ayko'ob ti'al u ts'áao'ob k'áak' yéetel ja' ti'al u chakiko'ob	NOCHANGE
Le ken sáasak beya' pues  le wíinko'ob eee	Le ken sáasak beya' pues  le wíinko'ob eee	NOCHANGE
Le je'elo' yaan yila' yéetel buka'aj	Le je'elo' yaan yila' yéetel buka'aj	NOCHANGE
Táan in suut koodnol merkadm'o	Táan in suu báaxale'ext koodnol merkadm'o	PERSON:2_PL
Táan in xok tu naaiil xook	Táan in xo'a'abéet k tu naaiil xook	ASPECT:OBL
Man t'anik mix máak yaan a tu'ubsik tak a na' yaan a tu'ubsik  tak tu'ux  tu'ux yaanlajech ka'achil	Man t'anik mix máak yaan a tu'ubsik tak a na' yaan a tu'ubsik  tak tu'ux  tu'ux yaanlajech ka'achil	NOCHANGE
Jaan ka tu biso'ob túun bin le chan paal ku ya'ako'obe' pues	Jaan ka tu biso'ob túun bin le chan paal ku ya'ako'obe' pues	NOCHANGE
U kano'ob wa  u ma' u p'atiko'ob	U kano'ob wa  u ma' u p'atiko'ob	NOCHANGE
Lela' bin u jelpesik ya'ab ba'ax ichil le miaatsilo' tumen pues	Lela' bin u jelpesik ya'ab ba'ax ichil le miaatsilo' tumen pues	NOCHANGE
Leeti' ken a ts'áaj ti' le taasa te'ej joolo'	Leeti' ken a ts'áaj ti' le taasa te'ej joolo'	NOCHANGE
Yaan je'ex le k'ajóolta'an tulum jump'éel kaaj tu líik'so'ob	Yaan je'ex le k'ajóolta'an tulum jump'éel kaaj tu líik'so'ob	NOCHANGE
Ma'ach u cha'abal u yookol  mix máak te'el chan najo'	Ma'ach u cha'abal u yookol  mix máak te'el chan najo'	NOCHANGE
K'aas u le' ja'aso' ka'ana'an xan a	K'aas u le' ja'aso' ka'ana'an xan a	NOCHANGE
Jun p'íit wa ya'ab le je'elo' yaan wíinike' ki' u yu'u'ubik jach máan túun	Jun p'íit wa ya'ab le je'elo' yaan wíinike' ki' u yu'u'ubik jach máan túun	NOCHANGE
Ken sáasak bey yaan a meentik le píiba' pues yaan a meentik a k'u'um	Ken sáasak bey yaan a meentik le píiba' pues yaan a meentik a k'u'um	NOCHANGE
Éaak in winikech te' tu kúuchil bdaxalo'	Éaak u wino'obikech te' tu kúuchil bdaxalo'	PERSON:3_PL
Tene' yaan ten u áanaltejil in xook matemáticas	Tene' yaan  báaxale'exten u áanaltejil in xook matemáticas	PERSON:2_PL
Ba'ax máaxti' ken a ts'a'e' wa ti' nukuch máako'obe' booxtak	Ba'ax máaxti' ken a ts'a'e' wa ti' nukuch máako'obe' booxtak	NOCHANGE
Chen ba'axe' bejla'ak túune' le ee	Chen ba'axe' bejla'ak túune' le ee	NOCHANGE
Bix u cha'anil u kaajlo'ob bey tsikbalo'ob ku meyajtiko'obo'  bix u kajlo'ob bix u kuxtalo'ob	Bix u cha'anil u kaajlo'ob bey tsikbalo'ob ku meyajtiko'obo'  bix u kajlo'ob bix u kuxtalo'ob	NOCHANGE
Ba'ale' wa ka bine' yaan a kaxta'al yéetel a waalo'ob yéetel a láak'tsilo'ob yaan u taasa'alo'ob ku ya'ala'al bin ti'	Ba'ale' wa ka bine' yaan a kaxta'al yéetel a waalo'ob yéetel a láak'tsilo'ob yaan u taasa'alo'ob ku ya'ala'al bin ti'	NOCHANGE
Le chan xnuuko' ku ya'alik túun bine' -chan  xi'ipa k'a'abéet a jach tukultik máakal bejil ken a cha'e' tumeen jump'éel le bejo'	Le chan xnuuko' ku ya'alik túun bine' -chan  xi'ipa k'a'abéet a jach tukultik máakal bejil ken a cha'e' tumeen jump'éel le bejo'	NOCHANGE
Ya'ab u k'áat óolal máak yóok'sal u k'áata'al eee santo ja'o'	Ya'ab u k'áat óolal máak yóok'sal u k'áata'al eee santo ja'o'	NOCHANGE
Kin ts'i mtu naajil xooí	Kin ts'i'a'abéet  mtu naajil xooí	ASPECT:OBL
Uu u chan bix u ya'ala'al le	Uu u chan bix u ya'ala'al le	NOCHANGE
Le úuchben ch'i'ibalo'obo'	Le úuchben ch'i'ibalo'obo'	NOCHANGE
Esten ti'al u beenta'al le jaanal pixan ku ya'ala'alo'	Esten ti'al u beenta'al le jaanal pixan ku ya'ala'alo'	NOCHANGE
Tu ts'ook le bejo'	Tu ts'ook le bejo'	NOCHANGE
Táan in ssmute ooonol merkaad	Táan u ssmuo'obte ooonol merkaad	PERSON:3_PL
Ch'ujuk waaj	Ch'ujuk waaj	NOCHANGE
U jo'sa'al k'ajóoltbil le ti'al le mix ba'alo' le seero ku ya'ala'alo'	U jo'sa'al k'ajóoltbil le ti'al le mix ba'alo' le seero ku ya'ala'alo'	NOCHANGE
Jaan ka tun bin	Jaan ka tun bin	NOCHANGE
Máan xan yaan maantekai' tumeen	Máan xan yaan maantekai' tumeen	NOCHANGE
Jbi'en áalkab te' taam prarkéeo'	Jbi' wáajen áalkab te' taam prarkéeo'	SUBTYPE:INT
Taak in wliskechn ne' tu kúuchil báaxalo'	Taak  wáajin wliskechn ne' tu kúuchil báaxalo'	SUBTYPE:INT
Mix teen ka8ákbalen ta wotoch	Mix teen ka8áke'ex xookbalen ta wotoch	PERSON:2_PL
Te'ej ba'al je'el jach	Te'ej ba'al je'el jach	NOCHANGE
K'iine' yaan ami' yaan k'iine' yaan ba'alo'obe' pues k'aa'an a tseliki'	K'iine' yaan ami' yaan k'iine' yaan ba'alo'obe' pues k'aa'an a tseliki'	NOCHANGE
To'on te'ej k'iinilo'oba' pues  le ilik xan túun meyajtik lak  knuuktakilo'on	To'on te'ej k'iinilo'oba' pues  le ilik xan túun meyajtik lak  knuuktakilo'on	NOCHANGE
Te' in taa 'tu paajjil kopomae'	Te' in taa 'tu paajjil k wáaj opomae'	SUBTYPE:INT
Baalo'ob beyo' ku makal	Baalo'ob beyo' ku makal	NOCHANGE
Kin wa'alik tene' kin wa'alik bey ti' in in  paalila'	Kin wa'alik tene' kin wa'alik bey ti' in in  paalila'	NOCHANGE
Leti' túun bine' bey jach ya'ab ba'al bin u yoojel bino'	Leti' túun bine' bey jach ya'ab ba'al bin u yoojel bino'	NOCHANGE
Le xa'ano' ti' kun k'axbil le mejen túut e mejen mejen waajo'obo' e e	Le xa'ano' ti' kun k'axbil le mejen túut e mejen mejen waajo'obo' e e	NOCHANGE
Ka bin esten tu t'aabaj tu t'abaj je'el bix yoojelil u ta'abal bin  chenba'ale' ka tu ta'abaj tu t'abaj	Ka bin esten tu t'aabaj tu t'abaj je'el bix yoojelil u ta'abal bin  chenba'ale' ka tu ta'abaj tu t'abaj	NOCHANGE
Ku ya'aliko'obe' - pues yaan kséegerkko'on yóok'sal k-iliko'on tu'ux bini'-  ku ya'aliko'ob bin ka jo'op' u bin u séegertiko'ob bin	Ku ya'aliko'obe' - pues yaan kséegerkko'on yóok'sal k-iliko'on tu'ux bini'-  ku ya'aliko'ob bin ka jo'op' u bin u séegertiko'ob bin	NOCHANGE
Yaan in suut wtu oaajil xéok	Yaan wáaj in suut wtu oaajil xéok	SUBTYPE:INT;PERSON:1_SI
Ka tu bisaj bin kajtal tu chan palaasio rey tumeen ts'áab tak u naay	Ka tu bisaj bin kajtal tu chan palaasio rey tumeen ts'áab tak u naay	NOCHANGE
Treese u yáalal le ka'ano' le sieteo' leeti' le yóok'ol kaabo' siete bin u yáalal le	Treese u yáalal le ka'ano' le sieteo' leeti' le yóok'ol kaabo' siete bin u yáalal le	NOCHANGE
Táan in suutk odkpoól merkaado	Táa wáajn in suutk odkpoól merkaado	SUBTYPE:INT
Bey túuno' ts'o'ok u chokotal bey le	Bey túuno' ts'o'ok u chokotal bey le	NOCHANGE
Kin jóok'ol wáaj koonol tu k'dlwikil koonol	Kin ' majóok'ol wáaj koonol tu k'dlwikil koonoli'	TYPE:NEG
E la' chen xmaayáaj chen beya' ka'ach úuche'  beyo'	E la' chen xmaayáaj chen beya' ka'ach úuche'  beyo'	NOCHANGE
Táan in boon tu naajmil xoo	Táan in boon tu naaj wáaj mil xoo	SUBTYPE:INT
Ee'exe' ma' joúuáe'exi'	Ee'exe' wáaj ma' joúuáe'exi'	SUBTYPE:INT
Este áanjeleso'ob ku yu'uba'al u t'aano'ob	Este áanjeleso'ob ku yu'uba'al u t'aano'ob	NOCHANGE
Kin wa'alo'one pues yan je'ex wa je'ex u ya'alik in áabueelao' in k'áate' in wáabilo'obe' u kano'ob le yóot'o'	Kin wa'alo'one pues yan je'ex wa je'ex u ya'alik in áabueelao' in k'áate' in wáabilo'obe' u kano'ob le yóot'o'	NOCHANGE
Ku ya'alike'	Ku ya'alike'	NOCHANGE
Yáan in bin koool tu k'íidikil koonol	Yáan in bin taak oool tu k'íidikil koonol	SUBTYPE:DEC;ASPECT:DES
Yaan wáaj in in kogaonog mrkaaamdo	Yaan wáaj u in o'obkogaonog mrkaaamdo	PERSON:3_PL
Ku ts'o'okol túune' ka tasláantik esten eu che'il	Ku ts'o'okol túune' ka tasláantik esten eu che'il	NOCHANGE
Uuu uu leti'o ka'achil le ka'achilo' ku beeta'al le p'úujo'	Uuu uu leti'o ka'achil le ka'achilo' ku beeta'al le p'úujo'	NOCHANGE
U yooko'ob  u ka'bo'ob bin beya' laaj chowakyat bin u yíich'ak	U yooko'ob  u ka'bo'ob bin beya' laaj chowakyat bin u yíich'ak	NOCHANGE
Ka'ana'an u taasik ya'abkach si' ku meentik le nuxi' jool te'ej yóok'ol	Ka'ana'an u taasik ya'abkach si' ku meentik le nuxi' jool te'ej yóok'ol	NOCHANGE
Ma' in wojely u ja'tbili'	Ma' in wojelwáaj y u ja'tbili'	SUBTYPE:INT
Yaan wáaj in bi kootnol tu k'íiwika8l kxool	Yaan in bi kootwáaj nol te'ex tuu k'íiwika8l kxool	PERSON:2_PL
U tuukul xan leeti'o'obe' je'el u bee u beeytal kp'áatlo'on kjéets'lo'on way tak lu'ume'	U tuukul xan leeti'o'obe' je'el u bee u beeytal kp'áatlo'on kjéets'lo'on way tak lu'ume'	NOCHANGE
Chúumukle u  waajil el píib ken a meento'	Chúumukle u  waajil el píib ken a meento'	NOCHANGE
Yaan in báaxal tu naajil báaxal	Yaan in báaxal tuwáaj  naajil báaxal	SUBTYPE:INT
Éek'joch'e'en bin mix ba'al chika'ani'	Éek'joch'e'en bin mix ba'al chika'ani'	NOCHANGE
Teche' ma' wáaj áak'ajc ka bin merkaaeoi'	Teche' ma' wáaj áak'ajc yaan a bin merkaaeoi'	ASPECT:COM
Chen tsikbalte ten le a woojel tu yóok'sal a ch'i'ibalo'obo'	Chen tsikbalte ten le a woojel tu yóok'sal a ch'i'ibalo'obo'	NOCHANGE
Ku ts'áabal túun sebooyai' ku ts'áabal aajoi'	Ku ts'áabal túun sebooyai' ku ts'áabal aajoi'	NOCHANGE
Esten yóok'sal ma' u lúubul lelu'um yóok'ol beyo'	Esten yóok'sal ma' u lúubul lelu'um yóok'ol beyo'	NOCHANGE
Chen de chan salam chen	Chen de chan salam chen	NOCHANGE
Yóok'sal u béeytal u bisiko'ob	Yóok'sal u béeytal u bisiko'ob	NOCHANGE
Máax yéetel ka bin koonol tu kúuchil báañal	Máax yéetel ka bin koonol t'a'abéet u kúuchil báañal	ASPECT:OBL
Ma'atáan u béeytal a beetik ti'o'ob beya' ma'atáan u béeytal a wa'alikti'o'ob beya'	Ma'atáan u béeytal a beetik ti'o'ob beya' ma'atáan u béeytal a wa'alikti'o'ob beya'	NOCHANGE
Ts'o'ok in in kboonol tu k'íiwikil koonol	Ts'o'ok in in'a'abéet  kboonol tu k'íiwikil koonol	SUBTYPE:DEC;ASPECT:OBL
Ku t'a'abal	Ku t'a'abal	NOCHANGE
Buka'ajil máak ku	Buka'ajil máak ku	NOCHANGE
Te' in tamal tñ kaalli kopom1e'	Te' in tamal tñ kaalli kopom1e'	PERSON:1_SI
Tumeen  píib le ba'ax ku k'u'ubulti'o'obo'	Tumeen  píib le ba'ax ku k'u'ubulti'o'obo'	NOCHANGE
Pues leeti'e'e yaan u béeytal u jaanal ma'alob	Pues leeti'e'e yaan u béeytal u jaanal ma'alob	NOCHANGE
En kaambio be'ele' ma' chen máanak le paalalo'obo' hasta ol u kojiko'ob le nukuch máako'ob chen máanako'ob tu tséelo'	En kaambio be'ele' ma' chen máanak le paalalo'obo' hasta ol u kojiko'ob le nukuch máako'ob chen máanako'ob tu tséelo'	NOCHANGE
Chen ba'axe' wa u ti'al le mejen paalalo'obo' pues láayli' ma' páap xan kun bentbile'	Chen ba'axe' wa u ti'al le mejen paalalo'obo' pues láayli' ma' páap xan kun bentbile'	NOCHANGE
Tene' kin báaxal éaarkée	Tene'' kin báaxal éaurkéeo'ob	PERSON:3_PL
Ma' táan in nin koonol merkaadoi'	Ma' táan a nin koe'exonol merkaadoi'	PERSON:2_PL
Je'el u béeytal bin u kíinsiko'ob bine'	Je'el u béeytal bin u kíinsiko'ob bine'	NOCHANGE
Ku ya'ala'alo'	Ku ya'ala'alo'	NOCHANGE
Ku ya'ala'a túun ti' le naj je'elo' áak'ab naj	Ku ya'ala'a túun ti' le naj je'elo' áak'ab naj	NOCHANGE
Ma' ya'ab ku beetiki' tumeen to'one' mas ki' k-u'uyik le	Ma' ya'ab ku beetiki' tumeen to'one' mas ki' k-u'uyik le	NOCHANGE
Ooa'in in bin merkaado	Ooa'ináaj  in bin merkaado	ASPECT:BEG;TENSE:PAS_SIM
Ts'o'okol túune'	Ts'o'okol túune'	NOCHANGE
7a' in wopel u ia'abili'	7a' in wopel 'a'abéet u ia'abili'	SUBTYPE:DEC;ASPECT:OBL
Tene' kin bin páew ich kool	Táaj ene' kin bin páew ich kool	ASPECT:BEG;TENSE:PAS_SIM
Ea' táan in bin m1an tu k'íowoák kooli'	Ea'  wáajtáan in bin m1an tu k'íowoák kooli'	SUBTYPE:INT
Ma' táan in bin maan tu k'í'iwiil koiotnli'	Ma' táan ek bin maan tu k'í'iwiil koiotnli'	PERSON:1_PL
Ka bin tu yilaj u tíip'il juntúul nuxi' ba'al bin	Ka bin tu yilaj u tíip'il juntúul nuxi' ba'al bin	NOCHANGE
Sáam u meente le píibo'	Sáam u meente le píibo'	NOCHANGE
Ka in papaj tsikbalmil in taata tsikbalmil ti' teen	Ka in papaj tsikbalmil in taata tsikbalmil ti' teen	NOCHANGE
Leeti' le ken in tsol xan ee	Leeti' le ken in tsol xan ee	NOCHANGE
Le ki'iwajo' ee	Le ki'iwajo' ee	NOCHANGE
Mau oin wucuyik dooxtli'	Mau oin wucusuuy ik dooxtli'	SUBTYPE:DEC;ASPECT:CUS
Le wóolistak yaane'e ee bey	Le wóolistak yaane'e ee bey	NOCHANGE
Láayli' xan	Láayli' xan	NOCHANGE
Yaan in boon tu nnajin xook	Yaan a boon tu nnae'exjin xook	PERSON:2_PL
Le wolis waajo'oo' le je'elo' k'as	Le wolis waajo'oo' le je'elo' k'as	NOCHANGE
Xaaw  wa ku ts'áak jump'éel xiik'  wa ku ts'áak jump'éel u bak'el tseeme'	Xaaw  wa ku ts'áak jump'éel xiik'  wa ku ts'áak jump'éel u bak'el tseeme'	NOCHANGE
Jach mix  ma' utsi'	Jach mix  ma' utsi'	NOCHANGE
Jun páak ken a manile' ts'o'okole' kux túun u piikil ku ya'ala'alo'	Jun páak ken a manile' ts'o'okole' kux túun u piikil ku ya'ala'alo'	NOCHANGE
Chen ba'axe' ma' yáax esten	Chen ba'axe' ma' yáax esten	NOCHANGE
Wa ten tin wa'alaj in ts'áaik juuch' wa teen tin wa'alaj in ts'áaik sikil wa bixe' yaan in ts'áaik	Wa ten tin wa'alaj in ts'áaik juuch' wa teen tin wa'alaj in ts'áaik sikil wa bixe' yaan in ts'áaik	NOCHANGE
Ma túun in woojel tu lákali' ba'ale' le kin wilik u meenta'alo' leeti' ken in wilik	Ma túun in woojel tu lákali' ba'ale' le kin wilik u meenta'alo' leeti' ken in wilik	NOCHANGE
Ti' leeti'o'obe' le taak'ino' le ooroso' ee jach nojbe'en ti' leeti'o'ob	Ti' leeti'o'obe' le taak'ino' le ooroso' ee jach nojbe'en ti' leeti'o'ob	NOCHANGE
Yaán in jokchik chak nal tin kool	Yaán in jokch'a'abéet ik chak nal tin kool	SUBTYPE:DEC;ASPECT:OBL
Ku ya'aliko'obe' pues ba'axk'in ochocieentos seisieentos	Ku ya'aliko'obe' pues ba'axk'in ochocieentos seisieentos	NOCHANGE
Yaan u yóol u tuukulilo'ob ti'al le ee	Yaan u yóol u tuukulilo'ob ti'al le ee	NOCHANGE
Le je'elo'	Le je'elo'	NOCHANGE
Jaanal pixan aaaj	Jaanal pixan aaaj	NOCHANGE
Ku jaantiko'ob le ba'alo'ob ku ts'áabal ichil kex chen jun chan xéet' k'úum	Ku jaantiko'ob le ba'alo'ob ku ts'áabal ichil kex chen jun chan xéet' k'úum	NOCHANGE
Muñax mtcs'woka'an in beeli'	Muñax mtcs'taaw oka'an in beeli'	ASPECT:DES
Ma' in wopel u ia'abili'	Suum a' in wopel u ia'abili'	ASPECT:CUS
Kin p'atik tech le  ayiik'alila' kanántej meyajtej ba'ale' to'one' saajko'on in ch'a'o'one' wa kin  meyajto'on wa	Kin p'atik tech le  ayiik'alila' kanántej meyajtej ba'ale' to'one' saajko'on in ch'a'o'one' wa kin  meyajto'on wa	NOCHANGE
Ka binij ka jo'op' u bin bin tu kuchaj u u chan nook ba'alo'ob beyo' jump'íit chan jaanal tu kaxtaj beyo'  tu kuchaj	Ka binij ka jo'op' u bin bin tu kuchaj u u chan nook ba'alo'ob beyo' jump'íit chan jaanal tu kaxtaj beyo'  tu kuchaj	NOCHANGE
Yaj uch a tséentik  ma bix a nojochkíinsik	Yaj uch a tséentik  ma bix a nojochkíinsik	NOCHANGE
Ku yilik bine' k'uch ti' jump'éel tu'ux bine'	Ku yilik bine' k'uch ti' jump'éel tu'ux bine'	NOCHANGE
Leetie'e' maas ya'abbin  taak'in bin síib ti' tumeen le rey bin p'áato'	Leetie'e' maas ya'abbin  taak'in bin síib ti' tumeen le rey bin p'áato'	NOCHANGE
Ku ts'áabal xan xchiináaj	Ku ts'áabal xan xchiináaj	NOCHANGE
U ti'al máako' bueeno a kimeo'ob n beyo'chen k'uchuko'obe' pues leeti'o'obe' táan u jaanalo'ob'ob bine' chen k'uchuko'obe'	U ti'al máako' bueeno a kimeo'ob n beyo'chen k'uchuko'obe' pues leeti'o'obe' táan u jaanalo'ob'ob bine' chen k'uchuko'obe'	NOCHANGE
Wa chak ken u meente' pues ku	Wa chak ken u meente' pues ku	NOCHANGE
K'aaynajen tu na1jil xook	K'aaynajen tsuuu  na1jil xook	SUBTYPE:DEC;ASPECT:CUS
Ti' kun beentbil túuni'	Ti' kun beentbil túuni'	NOCHANGE
Chokol beyo' k'abéet chokol bin u ts'áabal bin  te'ej meesao'	Chokol beyo' k'abéet chokol bin u ts'áabal bin  te'ej meesao'	NOCHANGE
U maasil túun bin le máako'obo' pues tu ganarto'ob u taak'in tumeen bey  tu yáanto'ob u	U maasil túun bin le máako'obo' pues tu ganarto'ob u taak'in tumeen bey  tu yáanto'ob u	NOCHANGE
Ts'o'ok in in kboonol tu k'íiwikil koonol	Ts'o'ok in in kboonol tu k'íiwikilwáaj  koonol	SUBTYPE:INT
Jejeláas u boonilo'ob	Jejeláas u boonilo'ob	NOCHANGE
Yaan a tasik u tuunichile'	Yaan a tasik u tuunichile'	NOCHANGE
Ti' ka pakto'ob wa ka kulakech a wil u jaanal	Ti' ka pakto'ob wa ka kulakech a wil u jaanal	NOCHANGE
Tu'ux k'íiwikil oou8nog ka jtok'ol koonol	Tu'ux wáaj k'íiwikil oou8nog ka jtok'ol koonol	SUBTYPE:INT
Táan in meyáj ich kooo	Táan in meyáje'ex ich kooo	PERSON:2_PL
Kaaldo wa esten kaax ku kíinsa'ale'	Kaaldo wa esten kaax ku kíinsa'ale'	NOCHANGE
Ka t'óot'ik te'ej bejo' leeti' ken a láaj t'o'ot' te'ej bej  tu'ux	Ka t'óot'ik te'ej bejo' leeti' ken a láaj t'o'ot' te'ej bej  tu'ux	NOCHANGE
Tumeen le je'elo' ku yaantal u muuchilo'ob ti'al u k'áatiko'ob le ja'o' leeti'o'ob ken u k'áato'ob le ja'o'	Tumeen le je'elo' ku yaantal u muuchilo'ob ti'al u k'áatiko'ob le ja'o' leeti'o'ob ken u k'áato'ob le ja'o'	NOCHANGE
Yaan in boon tu nnajin xook	Yaan' ma in boon wáaj tu nnajin xooki'	TYPE:NEG;SUBTYPE:INT
In natsil tene' ma' jach chen tu chan p'íis yóoks'al ki'ibok le juch'o' chen ba'al' ma' jach	In natsil tene' ma' jach chen tu chan p'íis yóoks'al ki'ibok le juch'o' chen ba'al' ma' jach	NOCHANGE
Xtok'tuunichi' yaan jump'éel tuuniche' xtok' tuunich  ya'ala'ale' le beyo'	Xtok'tuunichi' yaan jump'éel tuuniche' xtok' tuunich  ya'ala'ale' le beyo'	NOCHANGE
Ta'aytak in chukik u úa'abil	Ta'aytak in xooke'ex chukik u úa'abil	PERSON:2_PL
In wu'uymajo' leeti' le geerra de kaastas ku ya'ala'alo'	In wu'uymajo' leeti' le geerra de kaastas ku ya'ala'alo'	NOCHANGE
Ta'aétak u chukyiko'ob u a'abil	Ta'aétak u chuke'exyiko'ob u a'abil	PERSON:2_PL
Kuxtal maayae' tak bejla'ake' ku meyajchajal	Kuxtal maayae' tak bejla'ake' ku meyajchajal	NOCHANGE
U chuj u báao'ob bin	U chuj u báao'ob bin	NOCHANGE
Juntéenake' kij bey u tsikbalmaj ten in áabueelao' ku ya'ake' juntéenake' kij	Juntéenake' kij bey u tsikbalmaj ten in áabueelao' ku ya'ake' juntéenake' kij	NOCHANGE
Jbinen áalkwb te' taacm payykéeo'	Jbi wáajnen áalkwb te' taacm payykéeo'	SUBTYPE:INT
Chen ka tu yilo'ob bin u k'uchulo'ob ti' jump'éel áaktun tun beya' ku yikliko'ob jach beya'  ti' bin weekel u k'i'ik'el bin le	Chen ka tu yilo'ob bin u k'uchulo'ob ti' jump'éel áaktun tun beya' ku yikliko'ob jach beya'  ti' bin weekel u k'i'ik'el bin le	NOCHANGE
Tene' pjbúul-en	Tene' wáaj pjbúul-en	SUBTYPE:INT;ASPECT:HAB;PERSON:1_SI;VOICE:ACT;TRANSITIV:ITR
Ma' tin wu'yyik oáxoli'	Ma' tináaj  wu'yyik oáxoli'	ASPECT:BEG;TENSE:PAS_SIM
Ka bin tu beeto'ob bin u chan naayo'ob tu k'ab bin le che'o'	Ka bin tu beeto'ob bin u chan naayo'ob tu k'ab bin le che'o'	NOCHANGE
Le  ku ta'akal le	Le  ku ta'akal le	NOCHANGE
Pues le piimo' ee yaan u bisiko'ob bin yaan u bisiko'ob u jaanto'ob	Pues le piimo' ee yaan u bisiko'ob bin yaan u bisiko'ob u jaanto'ob	NOCHANGE
Nojoch bey bejla'ak yaan kin wilik	Nojoch bey bejla'ak yaan kin wilik	NOCHANGE
Le ba'ax ken u ya'alo'ob tech ken a beete' leeti' ken a beetej	Le ba'ax ken u ya'alo'ob tech ken a beete' leeti' ken a beetej	NOCHANGE
Jach wáaj k'a'aúéet a bin k'íiwiki'a kooenol	Jach' ma wáaj k' wáaja'aúéet a bin k'íiwiki'a kooenoli'	TYPE:NEG;SUBTYPE:INT
Taasbil u beeta'alo'ob ka béeychajak u jaanalo'ob	Taasbil u beeta'alo'ob ka béeychajak u jaanalo'ob	NOCHANGE
Ti'al le pixano'obo'	Ti'al le pixano'obo'	NOCHANGE
Eeej che'a' te'ej tu'ux yaan le najo' ki bin bey tun le áak'ab bino' ka bin na'ako'obi'	Eeej che'a' te'ej tu'ux yaan le najo' ki bin bey tun le áak'ab bino' ka bin na'ako'obi'	NOCHANGE
Je'el u béeytal u táakpajalo'ob ti'al  le este le  meet ki'il waajo' chen lejaajo' ku	Je'el u béeytal u táakpajalo'ob ti'al  le este le  meet ki'il waajo' chen lejaajo' ku	NOCHANGE
U jóok'sa'al túun le píibo' ts'o'ok u jóok'sa'al bey le píibo'	U jóok'sa'al túun le píibo' ts'o'ok u jóok'sa'al bey le píibo'	NOCHANGE
Jach u ya'abile' ooraj ooraj diies minuutos ee	Jach u ya'abile' ooraj ooraj diies minuutos ee	NOCHANGE
Baan wáaj a máaaal tuw naajim báaxal	Baan wáaj u máaao'obal tuw naajim báaxal	PERSON:3_PL
Jbinen áalkab te' taam ajrépeo'	Jbinech wáaj áalkab te' taam ajrépeo'	SUBTYPE:INT;PERSON:2_SI
Leti' túun le máako'ob le wiít'o'ob  yéetel le esten le e	Leti' túun le máako'ob le wiít'o'ob  yéetel le esten le e	NOCHANGE
Yóok'sal táan u báaxtik le baak le e	Yóok'sal táan u báaxtik le baak le e	NOCHANGE
Wa le máax meyajtiko'ob le ch'a'aj cháako'	Wa le máax meyajtiko'ob le ch'a'aj cháako'	NOCHANGE
Bueeno te'elo' ku ts'áabal xan le ch'ujuk waaj ku ma'analao' le pan ku ya'ala'alo' ku ts'áabal xan te'ej mejen paalalo'obo'	Bueeno te'elo' ku ts'áabal xan le ch'ujuk waaj ku ma'analao' le pan ku ya'ala'alo' ku ts'áabal xan te'ej mejen paalalo'obo'	NOCHANGE
Ááan in bin koool tu k'íidikil koonol	Ááan in ba kooe'exol tu k'íidikil koonol	PERSON:2_PL
Ts'o'ok túun u kíinsik'ob le  ba'alche'o'ob  beyo'	Ts'o'ok túun u kíinsik'ob le  ba'alche'o'ob  beyo'	NOCHANGE
Yaaá wáaj a xook tu naajil xoog	Yaaá wáaj a xotaao k tu naajil xoog	ASPECT:DES
Tumeen le ba'ax bin je'elo' tats' máan bin ku meeti u yóol le ts'oon ti' ma'atáan u kíinsa'al de por si leeti'e'e ma' ts'áab ti' kíinsbili'	Tumeen le ba'ax bin je'elo' tats' máan bin ku meeti u yóol le ts'oon ti' ma'atáan u kíinsa'al de por si leeti'e'e ma' ts'áab ti' kíinsbili'	NOCHANGE
Lee yuumtsilo'obo'  yaan ee ajyuumtsilo' bey u ya'ala'alti'o' wa le aj	Lee yuumtsilo'obo'  yaan ee ajyuumtsilo' bey u ya'ala'alti'o' wa le aj	NOCHANGE
Ya'ab wíinik tak le nukuch máako'ob bejala'k te'ej kjtalo' bey u beetiko'ob	Ya'ab wíinik tak le nukuch máako'ob bejala'k te'ej kjtalo' bey u beetiko'ob	NOCHANGE
Yook túun bin le ba'ax bin binik túun bin beya' aasta  tak bin u k'áab u chi'  láaj choojnaja'an táan bin u bin u	Yook túun bin le ba'ax bin binik túun bin beya' aasta  tak bin u k'áab u chi'  láaj choojnaja'an táan bin u bin u	NOCHANGE
Ku ya'ala'ale' mejen paalal tumeen leeti'o'obe'	Ku ya'ala'ale' mejen paalal tumeen leeti'o'obe'	NOCHANGE
Ka ts'áab u k'aaba' le kaajo' polinkin	Ka ts'áab u k'aaba' le kaajo' polinkin	NOCHANGE
A'abejo' y8aan in bin merkaado	A'abejo' y8aan in bin merkaado wáaj	SUBTYPE:INT
Tumeen u ti'al mejen paalal tumeen le box kibo'obo' maas jach u ti'al le nukuch máako'obo'	Tumeen u ti'al mejen paalal tumeen le box kibo'obo' maas jach u ti'al le nukuch máako'obo'	NOCHANGE
Ma'atáan u ye'eskubáao'ob wa ka xi'iken tin juunale' kin taasko'ob tu ka'atéene' tumeen yaan u taalo'ob tin paaach	Ma'atáan u ye'eskubáao'ob wa ka xi'iken tin juunale' kin taasko'ob tu ka'atéene' tumeen yaan u taalo'ob tin paaach	NOCHANGE
E maayas le úuchben maayaso'obo' le ma' senkech úuchbentako'obo' pues láaili' xan u tuukulo'obe' ma' kxu'ulsa'al	E maayas le úuchben maayaso'obo' le ma' senkech úuchbentako'obo' pues láaili' xan u tuukulo'obe' ma' kxu'ulsa'al	NOCHANGE
Óoxtúul wa kantúul mejen paalalo'ob	Óoxtúul wa kantúul mejen paalalo'ob	NOCHANGE
Táan in suutk odkoól mérkkaado	Táan in suutk 'a'abéet odkoól mérkkaado	ASPECT:OBL
Eee páak'áal wa le esten le	Eee páak'áal wa le esten le	NOCHANGE
Si le je'ela' in wa'ake' ma' chen k'aak'as ba'ali  ka bin ooko'ob bin  te'el ichilo'	Si le je'ela' in wa'ake' ma' chen k'aak'as ba'ali  ka bin ooko'ob bin  te'el ichilo'	NOCHANGE
Leti' bine' ma' tu cha'ao'ob u máan bin le meejilo'ob inal le nuxi' reey bino'  le nojoch reeyo'	Leti' bine' ma' tu cha'ao'ob u máan bin le meejilo'ob inal le nuxi' reey bino'  le nojoch reeyo'	NOCHANGE
Beya' ku láalik le k'óolo' ku ts'o'ole'  ku  ts'áak le bak'o'o ku ts'o'okol túune' ku	Beya' ku láalik le k'óolo' ku ts'o'ole'  ku  ts'áak le bak'o'o ku ts'o'okol túune' ku	NOCHANGE
Tu'ux k'íiwikil oou8cog ka btok'ol koinol	Tu'u' max k'íiwi wáajkil oou8cog ka btok'ol koinoli'	TYPE:NEG;SUBTYPE:INT
Ya'ab máax ku k'áat óolal	Ya'ab máax ku k'áat óolal	NOCHANGE
Ka bin estee	Ka bin estee	NOCHANGE
Ma' táan in pbi-n paln td k'ñíiwikibl koonoli'	Ma' táan in taap bi-n paln td k'ñíiwikibl koonoli'	SUBTYPE:DEC;ASPECT:DES
Le ka k'uch le éespañooleso'ob bino' ka  bin u je'elpajal ya'ab ba'ax ichil le kuxtal máasewáalo'	Le ka k'uch le éespañooleso'ob bino' ka  bin u je'elpajal ya'ab ba'ax ichil le kuxtal máasewáalo'	NOCHANGE
Táamal nojoch tu'ux kun ts'áabil baako'ob tu áakal le kun ts'áabil te'ej muerte te'ej joolo'	Táamal nojoch tu'ux kun ts'áabil baako'ob tu áakal le kun ts'áabil te'ej muerte te'ej joolo'	NOCHANGE
Ti' bin jump'éel sajkabe' ti kajlaj tun bin le chan nuuk bino'	Ti' bin jump'éel sajkabe' ti kajlaj tun bin le chan nuuk bino'	NOCHANGE
Ka tu kíinso'ob bin tu tóokajo'ob bin	Ka tu kíinso'ob bin tu tóokajo'ob bin	NOCHANGE
Ba'atelnajen e' tu kúuchil biaxalx'	Ba'atelnma' ajen e wáaj' tu kúuchil biaxalx'i'	TYPE:NEG;SUBTYPE:INT;PERSON:2_SI
Ku p'a'atal chen le ja'o' je'elo' chen le ja'o' je'elo' ken yáat le je'elo' teche' ts'o'ok a suut yéetel	Ku p'a'atal chen le ja'o' je'elo' chen le ja'o' je'elo' ken yáat le je'elo' teche' ts'o'ok a suut yéetel	NOCHANGE
Yéetel esten	Yéetel esten	NOCHANGE
Jach wáaj k'a'abéit a bin k'íiwikil koonol	Jach wáaj k'ts'o'oa 'abéit a bin k'íiwikil koonol	ASPECT:TER;TENSE:PAS_SIM
U láak' jump'éel le bejo'  wa ka k'uchukech te'ej	U láak' jump'éel le bejo'  wa ka k'uchukech te'ej	NOCHANGE
Pues bey túuno' ti'al u jaanto'ob bin tu bejilo'ob  bin le esten le	Pues bey túuno' ti'al u jaanto'ob bin tu bejilo'ob  bin le esten le	NOCHANGE
Tak ti'al u jóok'sa'al le	Tak ti'al u jóok'sa'al le	NOCHANGE
Jaan chen ba'al bine' ka'a bin káaj u k'aj óolta'al le jboob ku ya'ala'alo'	Jaan chen ba'al bine' ka'a bin káaj u k'aj óolta'al le jboob ku ya'ala'alo'	NOCHANGE
Táan xan u t'a'abal le k'áak'o'	Táan xan u t'a'abal le k'áak'o'	NOCHANGE
Táan k hxookb tu naajiu xtok	Táan k hxookb tu naajiu xtok	PERSON:1_SI
Leeti' túun bine' ku ya'alike' - yaan in bin in wil ba'ax le yaan te'el chan najo'	Leeti' túun bine' ku ya'alike' - yaan in bin in wil ba'ax le yaan te'el chan najo'	NOCHANGE
Ma' in kaxtej u bix ken in tsolilej	Ma' in kaxtej u bix ken in tsolilej	NOCHANGE
Tene' ti' in taali'	Tesuun e' ti' in taali'	ASPECT:CUS
Bueenoleti'o'obe' ku tukultiko'obe' yaan ki'ichkelem yuum leeti'o'obe' jach tu jets'aj u tuukulo'ob  ti'al  le lelo'	Bueenoleti'o'obe' ku tukultiko'obe' yaan ki'ichkelem yuum leeti'o'obe' jach tu jets'aj u tuukulo'ob  ti'al  le lelo'	NOCHANGE
U yo'och k'oja'an  ma'atáan a ts'aaik u xa'ak' jach ya'ab	U yo'och k'oja'an  ma'atáan a ts'aaik u xa'ak' jach ya'ab	NOCHANGE
Ya'ab máako'ob utstak u nook'o'ob bin yani' táan u yilik yaan taak'ini'	Ya'ab máako'ob utstak u nook'o'ob bin yani' táan u yilik yaan taak'ini'	NOCHANGE
Ku yiko'ob túune' ti' bin pekekbal le chan xnuk tun  bin beya' chilikbal bin	Ku yiko'ob túune' ti' bin pekekbal le chan xnuk tun  bin beya' chilikbal bin	NOCHANGE
Ch'ujuk je'ex u ch'ujukil le iis	Ch'ujuk je'ex u ch'ujukil le iis	NOCHANGE
Báalamo'ob wa ma' e' u apeyiidos  úuchben apeyiidos úuchben apeyiidos kanul	Báalamo'ob wa ma' e' u apeyiidos  úuchben apeyiidos úuchben apeyiidos kanul	NOCHANGE
Je'elo'  ka bino'ob tun bin jump'éel k'iin beyo' ka tu jóok'so'ob bin  le reeyo' bey ya'abo'obo'	Je'elo'  ka bino'ob tun bin jump'éel k'iin beyo' ka tu jóok'so'ob bin  le reeyo' bey ya'abo'obo'	NOCHANGE
Ba'ax túun ken u beeto'obe' le binka'aj túun tasbil le waajo'	Ba'ax túun ken u beeto'obe' le binka'aj túun tasbil le waajo'	NOCHANGE
Táan in suutk odkpoól merkaado	Táan in suutk 'a'abéet odkpoól merkaado	ASPECT:OBL
Pero yóok'sal u pool le máako'ob sen jaanta'ab beyo'	Pero yóok'sal u pool le máako'ob sen jaanta'ab beyo'	NOCHANGE
Táanil ma' jach lúubsa'ab u yóolo'ob	Táanil ma' jach lúubsa'ab u yóolo'ob	NOCHANGE
Nin xeen7yk janal ich rkés7oa7	Te'exe' nin xeen7ye'exk janal ich rkés7oa7	PERSON:2_PL
Chen ba'axe' le je'ela' le ti' le mejen paalalo' yaan a jóok'sik apartée	Chen ba'axe' le je'ela' le ti' le mejen paalalo' yaan a jóok'sik apartée	NOCHANGE
Beey ts'okole' nojoch u ts'a'ay	Beey ts'okole' nojoch u ts'a'ay	NOCHANGE
Bey u jets'ik'ob u kúuchilil tu láakal ba'al beyo'	Bey u jets'ik'ob u kúuchilil tu láakal ba'al beyo'	NOCHANGE
Bey a wóol ku t'aan bin te'el mas taamil bino'	Bey a wóol ku t'aan bin te'el mas taamil bino'	NOCHANGE
Le beetike' ku ya'alale' ku beeta'al bey de  esten de táamali'lo' wa to'obil waaj	Le beetike' ku ya'alale' ku beeta'al bey de  esten de táamali'lo' wa to'obil waaj	NOCHANGE
Ka suunaj bin ka'atéen tu chan kajtalile'	Ka suunaj bin ka'atéen tu chan kajtalile'	NOCHANGE
Tene' kin bin xciíbal a eotocx	Taat ene' kin'o bin xciíbal a eotocx	ASPECT:DES
Kux túun u nook'il ken a tak'ilo'	Kux túun u nook'il ken a tak'ilo'	NOCHANGE
Táan in bin k1oopoí tu j'íiwikil koonol	Ts'o'ok in bin k1oopoí tu j'íiwikil koonol	ASPECT:TER;TENSE:PAS_SIM
Ba'ale' bejla'ake' le p'úujo' ol ol ma'ach u meenta'al	Ba'ale' bejla'ake' le p'úujo' ol ol ma'ach u meenta'al	NOCHANGE
Ya'abkach múulo'b tu líik'sláanto'ob leeti'o'obe' tu'ux tu p'ato'ob to'one' leeti' le  ba'axo'ob ayik'alkúuntik leti' leee	Ya'abkach múulo'b tu líik'sláanto'ob leeti'o'obe' tu'ux tu p'ato'ob to'one' leeti' le  ba'axo'ob ayik'alkúuntik leti' leee	NOCHANGE
Yaan in manik ch'ujuko'ob tu d'íiwikil koenol	Ma' yaan in manik ch'ujuko'ob tu d'íiwikil koenoli'	TYPE:NEG
Le ba'ax ku ya'alik ti' le chan nuuko' leetie'e' ka tu kaxtaj bin le e	Le ba'ax ku ya'alik ti' le chan nuuko' leetie'e' ka tu kaxtaj bin le e	NOCHANGE
Tin ueenti- 8anal a7ch k'ol	Tin ueenti- 8aninl a7ch k'ol	PERSON:1_SI
Tak u aja le biix ku ya'ala'alo'	Tak u aja le biix ku ya'ala'alo'	NOCHANGE
Bey uuuu k'a'k'atts'áabil ken a ts'aaj beya'	Bey uuuu k'a'k'atts'áabil ken a ts'aaj beya'	NOCHANGE
Bejla'ake' u beeta'ale' jach máan ko'oj u beeta'al	Bejla'ake' u beeta'ale' jach máan ko'oj u beeta'al	NOCHANGE
A'ot ts'oka'an in beeli'	A'o wáajt ts'oka'an in beeli'	SUBTYPE:INT
Este le chan láak'tsilo'ob bin je'el bino' tu biso'ob juntúul chan paal	Este le chan láak'tsilo'ob bin je'el bino' tu biso'ob juntúul chan paal	NOCHANGE
Táan wáaj aboon tu naa il xook	Táan wáaj aboon wáaj tu naa il xook	SUBTYPE:INT
Leeti' bine' ma' tu meentaj kueenta te'el tu'ux ku	Leeti' bine' ma' tu meentaj kueenta te'el tu'ux ku	NOCHANGE
A níib óoltik  a chíimpooltik le nukuch máako'ob wa maas úuchbentak ti' teecho'	A níib óoltik  a chíimpooltik le nukuch máako'ob wa maas úuchbentak ti' teecho'	NOCHANGE
Le chen in woojel	Le chen in woojel	NOCHANGE
To'obil waaj ku beeta'ali' yáax chen de	To'obil waaj ku beeta'ali' yáax chen de	NOCHANGE
Kíim le k'aak'as ba'al yaan te'ela' ku ya'ako'ob bin	Kíim le k'aak'as ba'al yaan te'ela' ku ya'ako'ob bin	NOCHANGE
Eee meen juntúul nojoch máak ba'ale'	Eee meen juntúul nojoch máak ba'ale'	NOCHANGE
Jbch b'a'abéee in jin tu k'íiwikil koonol	Jbch b'a'abéee a jine'ex koonol	PERSON:2_PL
Mix ba'al yaan in jaanto'on tene' taak in kaxtin jump'éel tuúx	Mix ba'al yaan in jaanto'on tene' taak in kaxtin jump'éel tuúx	NOCHANGE
Te'ej yáax taaxo' ti' ken a ts'áaj le jump'íit le esten le   ki'iwaj de kaaldo'	Te'ej yáax taaxo' ti' ken a ts'áaj le jump'íit le esten le   ki'iwaj de kaaldo'	NOCHANGE
Le ba'aba'al ku ya'ala'ale'	Le ba'aba'al ku ya'ala'ale'	NOCHANGE
Táan wáaj a bj kon7l tu k'uíéolkil oouol	Táan wáaj k bj kon7l tu k'uíéolkil oouol	PERSON:1_PL
Te'el tu'ux ts'o'on le xch'uupo' mina'an bini' sáam bin xi'ik	Te'el tu'ux ts'o'on le xch'uupo' mina'an bini' sáam bin xi'ik	NOCHANGE
Táan in suut oonol merkaado	T'a'abéet áan in suut oonol merkaado	ASPECT:OBL
Ma' táan in bin maan tu k'í'iwiil kootnoli'	Ma' táan in bin maan tu k'í'iwiil kootnoli'	PERSON:1_SI
Yéetel le	Yéetel le	NOCHANGE
Es ke leeti'ee' tu kanaj u jaante máak tu sutaj u báaj de beyilo'	Es ke leeti'ee' tu kanaj u jaante máak tu sutaj u báaj de beyilo'	NOCHANGE
Ba'ale' ichil túun le je'ela' ku jach ku yaakuntiko'ob le jajal yuumo'obo' laaten túune' ku ya'ala'ale' táaj yan u muuk'o'ob	Ba'ale' ichil túun le je'ela' ku jach ku yaakuntiko'ob le jajal yuumo'obo' laaten túune' ku ya'ala'ale' táaj yan u muuk'o'ob	NOCHANGE
T1átux k-ahkbalen	T1átux k-ahkba wáajlen	SUBTYPE:INT
Ka bin bini'	Ka bin bini'	NOCHANGE
Tak ti' u kúchul u láak' le	Tak ti' u kúchul u láak' le	NOCHANGE
Ee esten ku bin u béeytal bin u jaantiko'ob te'ej bej bin táan u bino'obo'	Ee esten ku bin u béeytal bin u jaantiko'ob te'ej bej bin táan u bino'obo'	NOCHANGE
-ba'an túun ken in meentej bix ken in meentil ka in wil máax le yaan te'elo' máax le yan te'elo'	-ba'an túun ken in meentej bix ken in meentil ka in wil máax le yaan te'elo' máax le yan te'elo'	NOCHANGE
-pero bix kech bin -  ku ya'alik bin ti'	-pero bix kech bin -  ku ya'alik bin ti'	NOCHANGE
P'elik  láaj u mejen le' ken a jóok's beyo'	P'elik  láaj u mejen le' ken a jóok's beyo'	NOCHANGE
Nin xeen7ik janal ich rkés7oal	Nin ' maxeen7ik  wáajjanal ich rkés7oali'	TYPE:NEG;SUBTYPE:INT
Ee kajtalilo'	Ee kajtalilo'	NOCHANGE
Je'elo' bey ti'ano'ob  yáanal túun le  ee	Je'elo' bey ti'ano'ob  yáanal túun le  ee	NOCHANGE
Da' táan in bin konol tu k'íiikil kooonol	Leti'e' da' táan u bin konol tu k'íiikil kooonol	PERSON:3_SI
Uk'ulo' ku beetiko'ob le nukuch túuto'	Uk'ulo' ku beetiko'ob le nukuch túuto'	NOCHANGE
Ba'atelnajen te' tu kúuchág báaxalo'	Ba'atelnajen te' tu ke'ex xookúuchág báaxalo'	PERSON:2_PL
Bejla'ake' maas leeti' ktakiko'on	Bejla'ake' maas leeti' ktakiko'on	NOCHANGE
Ku báajal u meyajto'ob túun ichil u meyajtiko'obo'	Ku báajal u meyajto'ob túun ichil u meyajtiko'obo'	NOCHANGE
Ma' táan in bin koonpl tu k'íiwikil koonol	Suum a' táan in bin koonpl tu k'íiwikil koonol	ASPECT:CUS
Je'elo' ti' leeti'o'ob túune' leete'ej te'ej ee nukuch túuto'ob ku beetiko'ob beyo'	Je'elo' ti' leeti'o'ob túune' leete'ej te'ej ee nukuch túuto'ob ku beetiko'ob beyo'	NOCHANGE
Je'el u béeytal u ts'áabal xa'an wa je'el u béeytal u ts'áabal u le' ja'as yóok'ol bey	Je'el u béeytal u ts'áabal xa'an wa je'el u béeytal u ts'áabal u le' ja'as yóok'ol bey	NOCHANGE
Te'ej meesao' wa te'ej kúuchil tu'ux ken a	Te'ej meesao' wa te'ej kúuchil tu'ux ken a	NOCHANGE
Ku tukulta'ale' yaan u bis'aal tumeen le nukuch máako'obo' wa tumeen le kimeno'obo'	Ku tukulta'ale' yaan u bis'aal tumeen le nukuch máako'obo' wa tumeen le kimeno'obo'	NOCHANGE
Yaan in boon tu naajil xook	Yaan in boon tu nawáaj ajil xook	SUBTYPE:INT;ASPECT:HAB;PERSON:1_SI;VOICE:ACT;TRANSITIV:ITR
Tene' kin bááaxal tu naajil xook	Tene' kima' n bááa wáajxal tu naajil xooki'	TYPE:NEG;SUBTYPE:INT
Ku k'as ku táakpajalo'obo' tumeen ti'al u meenta'al le payalchi'o' mu'un béeytal u táakpajal ko'oleli'	Ku k'as ku táakpajalo'obo' tumeen ti'al u meenta'al le payalchi'o' mu'un béeytal u táakpajal ko'oleli'	NOCHANGE
Tumeen tene' ma' uts in wiliki'	Tumeen tene' ma' uts in wiliki'	NOCHANGE
Ku ts'o'okol túune' ken ya'at le beyo' pues ku k'axik yóok'sal ma' u	Ku ts'o'okol túune' ken ya'at le beyo' pues ku k'axik yóok'sal ma' u	NOCHANGE
Letl'e' áak'ab ku bin tu k'íiwikil koonol	Ma' letl'e' áak'ab ku bin tu k'íiwikil koonoli'	TYPE:NEG
Mejen paalalo'obe' táan u	Mejen paalalo'obe' táan u	NOCHANGE
Tene' kin bin xíimbal ta wotoc	Tene' kin bin xíimbalwáaj  ta wotoc	SUBTYPE:INT;ASPECT:HAB;PERSON:1_SI;VOICE:ACT;TRANSITIV:ITR
Le xa'ano' ku t'a'abal túun	Le xa'ano' ku t'a'abal túun	NOCHANGE
Tene' bejla'ake' kin wilike' jach mina'an mix yéetel le kpaalalo'on	Tene' bejla'ake' kin wilike' jach mina'an mix yéetel le kpaalalo'on	NOCHANGE
Tene' kin báaxal tu naajil xook	Táaj ene' kin báaxal tu naajil xook	ASPECT:BEG;TENSE:PAS_SIM
Juuch' ka'ana'an ti'al a tatkúunsikle eee u ja'il le kaax bey ts'o'ok a	Juuch' ka'ana'an ti'al a tatkúunsikle eee u ja'il le kaax bey ts'o'ok a	NOCHANGE
Ts'o'okol túune yáax ba'ax ku meentik in natsile' leeti'e' ku téetik le  jach	Ts'o'okol túune yáax ba'ax ku meentik in natsile' leeti'e' ku téetik le  jach	NOCHANGE
Kpues ku ts'áabal bin le lelo' yóok'sal bine' leeti'o'ob táan u jaantiko'ob le je'elo'	Kpues ku ts'áabal bin le lelo' yóok'sal bine' leeti'o'ob táan u jaantiko'ob le je'elo'	NOCHANGE
Yaan wáaj a báaxal tdu naahil báaxal	Te'exe' yaan wáaj e'exa báaxal tdu naahil báaxal	PERSON:2_PL
Bejla'ak tun tu k'inile' u k'áat máake' ka ta'aka'ak le nook'o'obo'	Bejla'ak tun tu k'inile' u k'áat máake' ka ta'aka'ak le nook'o'obo'	NOCHANGE
Máax séktel ka mbkin koono tu koúuchil báaxal	Máax' séktel ka mbkin koone'exo tu koúuchil báaxal	PERSON:2_PL
Ta wiiaj waaj u sáastagñ a kaajal	Ta wiiaj wáaj waaj u sáastagñ a kaajal	SUBTYPE:INT
Yaan wáaj in 'gbiu oono me7rk'ado	Yaan wáaj  wáajin 'gbiu oono me7rk'ado	SUBTYPE:INT
E mayak che'o' te'ej yáanal le mayak che'o' ti' yan túun le óoxtul mejen muucho'obo'	E mayak che'o' te'ej yáanal le mayak che'o' ti' yan túun le óoxtul mejen muucho'obo'	NOCHANGE
Le jaanal pixan ka beetik bey ti' leeti'o'obo'	Le jaanal pixan ka beetik bey ti' leeti'o'obo'	NOCHANGE
Tene' pjbúul-en	Tewáaj ne' pjbúul-en	SUBTYPE:INT
Ki'imak in wóol in b n ichláooi	Ki'imak in wóo wáajl in b n ichláooi	SUBTYPE:INT
Leti'e' múul kajakbal tek éeúel	Te'exe' leti'e' múe'exul kajakbal tek éeúel	PERSON:2_PL
Hasta bey u láaj tu'up u p'áatal bey chen chen chúuke'	Hasta bey u láaj tu'up u p'áatal bey chen chen chúuke'	NOCHANGE
Jeee esten le boob túuno'  leeti' pues k'aas bin leeti'e'  jun	Jeee esten le boob túuno'  leeti' pues k'aas bin leeti'e'  jun	NOCHANGE
Tak e le paaxo' yaan p'áatal tak te'ej k'iinilo'ob ichilo'ona' je'el le maaya páaxo'	Tak e le paaxo' yaan p'áatal tak te'ej k'iinilo'ob ichilo'ona' je'el le maaya páaxo'	NOCHANGE
U k'iinil le jaanal pixano' u ja'abl	U k'iinil le jaanal pixano' u ja'abl	NOCHANGE
Ba'ale' yaan k'iine' kin wa'ako'one pues	Ba'ale' yaan k'iine' kin wa'ako'one pues	NOCHANGE
Ku yilik bine' yaan jump'éel chan naj bin te'ej te'ej ichil le  solaar bey tu'ux ku meyajo'	Ku yilik bine' yaan jump'éel chan naj bin te'ej te'ej ichil le  solaar bey tu'ux ku meyajo'	NOCHANGE
U jaajile' ma' jump'éelilo'on je'el bix  way maayaso'on kintaana roo maayas yúukataan mayas	U jaajile' ma' jump'éelilo'on je'el bix  way maayaso'on kintaana roo maayas yúukataan mayas	NOCHANGE
Ti' u beetiko'ob le kruuso'	Ti' u beetiko'ob le kruuso'	NOCHANGE
Ka t'aan kex wa ma' k'a'abéet u p'áatal u yu'ubo'	Ka t'aan kex wa ma' k'a'abéet u p'áatal u yu'ubo'	NOCHANGE
Yaán in jokchiw chajk nkal tin kool	Yaán iaj wán jokchiw chajk nkal tin kool	SUBTYPE:INT
Tene' ati' ka7takbalen bu yo'oóhe'	Tene' ati' ka7te'exakbalen bu yo'oóhe'	PERSON:2_PL
Tumeen ma' chen waaji'	Tumeen ma' chen waaji'	NOCHANGE
Tu taaso'ob ba'alo'ob  xan túumben ba'alo'ob	Tu taaso'ob ba'alo'ob  xan túumben ba'alo'ob	NOCHANGE
Úuchik  ku u u u t'i'itkubáaj máak esteen beyo' pues tak e le le ba'alo'ob taasa'ab tumeen le e ee e	Úuchik  ku u u u t'i'itkubáaj máak esteen beyo' pues tak e le le ba'alo'ob taasa'ab tumeen le e ee e	NOCHANGE
U cha'am'ob bin che' u ch'amo'ob máaskab tu láakal u ch'a'amo'obleeti'o'obe' taak u	U cha'am'ob bin che' u ch'amo'ob máaskab tu láakal u ch'a'amo'obleeti'o'obe' taak u	NOCHANGE
Puro láaj wa ka wile'  láaj u yich éespañooleso'ob yaan ti'	Puro láaj wa ka wile'  láaj u yich éespañooleso'ob yaan ti'	NOCHANGE
Soldaadoso'  bin beyo' cha' in jan bini' ki bin	Soldaadoso'  bin beyo' cha' in jan bini' ki bin	NOCHANGE
Jayp'éel kruus ken u ts'áai' treese u p'éelal mejen jool ken u beento'o'ob	Jayp'éel kruus ken u ts'áai' treese u p'éelal mejen jool ken u beento'o'ob	NOCHANGE
Pool wíinikil tun bin jach u k'aaba' le kaajo'	Pool wíinikil tun bin jach u k'aaba' le kaajo'	NOCHANGE
Ku meetik jump'éel chan waaje' ku	Ku meetik jump'éel chan waaje' ku	NOCHANGE
Yaana kaxtik puro máak yaan u k'uchul tu'ux yaan máako'ob puuro káaltal wíiniko'ob	Yaana kaxtik puro máak yaan u k'uchul tu'ux yaan máako'ob puuro káaltal wíiniko'ob	NOCHANGE
Yaan wáaj in bin kóono tu k'íiwlkil koonol	Yaan wáaj ek bin kóono tu k'íiwlkil koonol	PERSON:1_PL
Te'ej jool túuno' yaan a jóok'sik túunxan jump'éel taasa le ki'iwaj  ta beetaj de k'aabo'	Te'ej jool túuno' yaan a jóok'sik túunxan jump'éel taasa le ki'iwaj  ta beetaj de k'aabo'	NOCHANGE
U saantos e  españooleso'obo'   e yaan tu seentro séeremoniaale chan kaj	U saantos e  españooleso'obo'   e yaan tu seentro séeremoniaale chan kaj	NOCHANGE
Kaasi bey je'ex u ya'ala'al	Kaasi bey je'ex u ya'ala'al	NOCHANGE
Kin hanik yaxabach ba7'alob tu b'íiwikie koonol	Kin hanik y báaxale'exaxabach ba7'alob tu b'íiwikie koonol	PERSON:2_PL
Ku ku bey ts'o'ok u chokotal le tuunicho'ob túuno'	Ku ku bey ts'o'ok u chokotal le tuunicho'ob túuno'	NOCHANGE
Táan in mekaj ich nool	Táan ich mekaj ich nool	PERSON:2_SI
Ts'o'a'an wáaj in beel	Ts'o wáaj'a'an wáaj in beel	SUBTYPE:INT;PERSON:1_SI
Yaan tj' teen 18 ja'abo'ob	Ma' yinan tj' teen 18 jin'abo'obi'	TYPE:NEG;PERSON:1_SI
Tumeen bejla'ake' ku ya'alale' ma' es ke le paalalo'obo' yaan tojbe'enil ti' leeti'o'ob	Tumeen bejla'ake' ku ya'alale' ma' es ke le paalalo'obo' yaan tojbe'enil ti' leeti'o'ob	NOCHANGE
Ka tu yilaj bin bey ts'o'ok u chu'uul bin bey le máako' lúub u ts'oon túun  bin le máako' le x	Ka tu yilaj bin bey ts'o'ok u chu'uul bin bey le máako' lúub u ts'oon túun  bin le máako' le x	NOCHANGE
Bejla'ake' táan u tsikbal a maam'aa táan u tsikbal a taata yéetel wa máaxe'	Bejla'ake' táan u tsikbal a maam'aa táan u tsikbal a taata yéetel wa máaxe'	NOCHANGE
P'a'atal mix jun xéet' che' wa táan u buuts'ilaankili' tumeen je'el u	P'a'atal mix jun xéet' che' wa táan u buuts'ilaankili' tumeen je'el u	NOCHANGE
Jbi'en áalkab te' taam prarkéeo'	Jbi'en áalkats'o'ob  te' taam prarkéeo'	ASPECT:TER;TENSE:PAS_SIM
Esten lelele k'áat chi' ti'al u yúuchul le	Esten lelele k'áat chi' ti'al u yúuchul le	NOCHANGE
Uu uu yáalal le ka le kaab	Uu uu yáalal le ka le kaab	NOCHANGE
Bey tuno' jach bey tak bejla'ak tune' le k'iin bejla'ake' le masewáalo'ona' pues ti'an weye' kuxa'ano'on	Bey tuno' jach bey tak bejla'ak tune' le k'iin bejla'ake' le masewáalo'ona' pues ti'an weye' kuxa'ano'on	NOCHANGE
U áabuelos in bauela je'elo' ka bino'obe' ti' láaj ti'ano'ob túune'  ti' p'áat inalo'obe' ma' tu ka e'esaj u báaj bin ti' le eee	U áabuelos in bauela je'elo' ka bino'obe' ti' láaj ti'ano'ob túune'  ti' p'áat inalo'obe' ma' tu ka e'esaj u báaj bin ti' le eee	NOCHANGE
Xa'ak'pesk'aja'an  in miaatsilo'on	Xa'ak'pesk'aja'an  in miaatsilo'on	NOCHANGE
Yaan wáaj in bin koool merkaado	Yaan wáaj ie'exn bin koool merkaado	PERSON:2_PL
Le beetik túun tene' tin wilik beyo' le beetik ma' jach ya'ab máax takiki'	Le beetik túun tene' tin wilik beyo' le beetik ma' jach ya'ab máax takiki'	NOCHANGE
Ku beeta'al ti'al u k'a'ajsa'al le le	Ku beeta'al ti'al u k'a'ajsa'al le le	NOCHANGE
Je'elo' ku ts'áabal túun ku laj	Je'elo' ku ts'áabal túun ku laj	NOCHANGE
Tene' ti' kajakbalen tu otñchne'	Te'exe' ti' kajakbale'ex tu otñchne'	PERSON:2_PL
Payalchi'o' mu'un béeytal	Payalchi'o' mu'un béeytal	NOCHANGE
Tr'aytak in pchukik u ja'abil	Tr'aytak  wáajin pchukik u ja'abil	SUBTYPE:INT
Taal bin u chu'ukul tun bin le máako'	Taal bin u chu'ukul tun bin le máako'	NOCHANGE
Táan in wilike' ya'ab le ya'ab le tsikbal tuuso'ob ku meenta'al bey tu yóok'sal le e'boobo'	Táan in wilike' ya'ab le ya'ab le tsikbal tuuso'ob ku meenta'al bey tu yóok'sal le e'boobo'	NOCHANGE
Úuchben maayaso'ob te'ej maayaso'ob je'ex le yaan te'ej k'iinilo'oba'	Úuchben maayaso'ob te'ej maayaso'ob je'ex le yaan te'ej k'iinilo'oba'	NOCHANGE
Ku ya'alik bine'	Ku ya'alik bine'	NOCHANGE
Eee wolis túuno' leeti'e'e ba'ax ku beetik xane' pues ku meetik  jump'éel chan	Eee wolis túuno' leeti'e'e ba'ax ku beetik xane' pues ku meetik  jump'éel chan	NOCHANGE
Despuees ti' ku páatali' tu juunal kun bin u sa'atla'ajal	Despuees ti' ku páatali' tu juunal kun bin u sa'atla'ajal	NOCHANGE
Le ma'aj ko'ojtako' leeti' chen je'ex le ktakiko'ob  de boono'ob  de chen jump'éel	Le ma'aj ko'ojtako' leeti' chen je'ex le ktakiko'ob  de boono'ob  de chen jump'éel	NOCHANGE
Ba'ale' ichil  láaili' xane' le úuchben máako'obo' láaj yaan bin u	Ba'ale' ichil  láaili' xane' le úuchben máako'obo' láaj yaan bin u	NOCHANGE
Táan in suut tu naajiil aoo	Táan u suuo'obt tu naajiil aoo	PERSON:3_PL
Ki'imak a wóol a bin jtu k'íiwikil koonol	Ki'imak a wóol a bin jtusuu  k'íiwikil koonol	ASPECT:CUS
Tens' áak'ab kin bcn merkaado	Tens' áak'a báaxale'exb kin bcn merkaado	PERSON:2_PL
Ka bin bini ka ook te'el naj bino'	Ka bin bini ka ook te'el naj bino'	NOCHANGE
U píibil le jaanal pixano'	U píibil le jaanal pixano'	NOCHANGE
Jbinen yéetel in éetailo'b tu kííiwikil íoonol	Leti'e' ma' jbinen yéetel in éetailo'b tu kííiwikil íoonoli'	TYPE:NEG
Ch'a' jump'éel responsabilidad u kanáant le ba'ax ku ye'esa'al ti' tumeen u noolo'	Ch'a' jump'éel responsabilidad u kanáant le ba'ax ku ye'esa'al ti' tumeen u noolo'	NOCHANGE
Tin ueentik janal ich k'ol	Ma' wáaj tin ueentik janal ich k'oli'	TYPE:NEG;SUBTYPE:INT
Le píibo' ts'okol u pu'ulul le píibo' pues	Le píibo' ts'okol u pu'ulul le píibo' pues	NOCHANGE
Tin konaj u k'naxi in kojl	Tin konaj u k'naxi wáaj in kojl	SUBTYPE:INT
Uts tin wich tumeen ku ts'áaik u páajtalil	Uts tin wich tumeen ku ts'áaik u páajtalil	NOCHANGE
De k'aab le ki'iwaj ku beenta'ala'	De k'aab le ki'iwaj ku beenta'ala'	NOCHANGE
Te che' bino'	Te che' bino'	NOCHANGE
U che'eile' yaan u bin ch'akbil	U che'eile' yaan u bin ch'akbil	NOCHANGE
Tene' kin bin paak'áail ich kool	Táaj ene' kin bin paak'áail ich kool	ASPECT:BEG;TENSE:PAS_SIM
Táan in boon tu naajil xooh	Táan iaj wán boon tu naajil xooh	SUBTYPE:INT
'í' jach k'a'aáéet in bin tu k'íiwikil koonoli'	'í' jach k'a'aáéet in bin tu k'íiwikil koonol wáaj	SUBTYPE:INT
Ta'aytak in chuki ñ ja'atib	Ta'aytak u chuki o'obñ ja'atib	PERSON:3_PL
Mr' jach 'añ'abéet in bin tu k'íiwñkil koonoli'	Mr' jach 'añ'a wáajbéet in bin tu k'íiwñkil koonoli'	SUBTYPE:INT
A ki'iki' t'antik	A ki'iki' t'antik	NOCHANGE
U áabuelóo u tatarabuelo beyo' ba'ale' u áabueloobe'  tsikbalte ti' leetio'ob	U áabuelóo u tatarabuelo beyo' ba'ale' u áabueloobe'  tsikbalte ti' leetio'ob	NOCHANGE
Máax yéetel ka rin koonol t7 kúuchil báaxal	Máax yéetel suuk a rin koonol t7 kúuchil báaxal	SUBTYPE:DEC;ASPECT:CUS
Ts'okole' ku pixik yéetel u le' ja'aso' bey u beetik leeti'o'	Ts'okole' ku pixik yéetel u le' ja'aso' bey u beetik leeti'o'	NOCHANGE
E ayiik'alil ku p'áatik to'on kch'i'ibalo'ob	E ayiik'alil ku p'áatik to'on kch'i'ibalo'ob	NOCHANGE
Jump'éel diia antese' ku bin ch'akbil	Jump'éel diia antese' ku bin ch'akbil	NOCHANGE
Ma' táan in bin koonol merkaanoi'	Ma' táan in bin suuk oonol merkaanoi'	ASPECT:CUS
Te'ej k'iino'ob bejla'aka' jach tu láakal ts'o'ok u láaj jelpajal	Te'ej k'iino'ob bejla'aka' jach tu láakal ts'o'ok u láaj jelpajal	NOCHANGE
Yaán in jokchik chak nal tin kool	Yaán in jokchik chak nal ta koole'ex	PERSON:3_PL
Bey u ya'alik ten jump'éel k'iin bine' le xi'ipalo' ku ya'alik bin ti' u mama bine'  tu na' bine'	Bey u ya'alik ten jump'éel k'iin bine' le xi'ipalo' ku ya'alik bin ti' u mama bine'  tu na' bine'	NOCHANGE
Ts'o'ok túun u meyajtiko'ob bey  u k'óolil  yéetel u káaxil tu láakal le je'elo' uu uu preparaartiko'ob beyo'	Ts'o'ok túun u meyajtiko'ob bey  u k'óolil  yéetel u káaxil tu láakal le je'elo' uu uu preparaartiko'ob beyo'	NOCHANGE
Tsikbalte ti' teen bix kuxlik ka'ach e úuchben maayao'obo'	Tsikbalte ti' teen bix kuxlik ka'ach e úuchben maayao'obo'	NOCHANGE
Españoles wa le káastelaan máako'obo'	Españoles wa le káastelaan máako'obo'	NOCHANGE
Le ken ila'ak wel ts'o'ok u tajal le jkaakxo'	Le ken ila'ak wel ts'o'ok u tajal le jkaakxo'	NOCHANGE
Jump'éel waaj nojoch	Jump'éel waaj nojoch	NOCHANGE
Tu k'iinil bey ta'aytak u koolo'obo'  leeti'o'obe' ku k'áatiko'ob ti' le	Tu k'iinil bey ta'aytak u koolo'obo'  leeti'o'obe' ku k'áatiko'ob ti' le	NOCHANGE
Tu'ux kajúkbalen	Ma' tu'ux kajúkbaleni'	TYPE:NEG
Ku júupulo'ob u ts'i'kte le bak'o'	Ku júupulo'ob u ts'i'kte le bak'o'	NOCHANGE
Kex tumeen tu jaajil ya'ab máak kíimi ya'ab máak sa'at u kuxtale	Kex tumeen tu jaajil ya'ab máak kíimi ya'ab máak sa'at u kuxtale	NOCHANGE
Tak túun tu láak' kíin túune' ku yiliko'ob wa k'áax ja' wa ma' k'áax ja' tia'l u yaantal le nalo'	Tak túun tu láak' kíin túune' ku yiliko'ob wa k'áax ja' wa ma' k'áax ja' tia'l u yaantal le nalo'	NOCHANGE
Ma' táan in bin maapn tw k'íiwskil koonobli'	Ma' káaj in bin maapn tw k'íiwskil koonobli'	ASPECT:BEG;TENSE:PAS_SIM
Ka tu sutaj túun de chiichi'il le jach u yuumil túun le palaasio ka tu k'a'alal tun bin te'el najo'	Ka tu sutaj túun de chiichi'il le jach u yuumil túun le palaasio ka tu k'a'alal tun bin te'el najo'	NOCHANGE
Kex bin brujoe' pero leeti'o'obe' mas ya'abo'ob bin	Kex bin brujoe' pero leeti'o'obe' mas ya'abo'ob bin	NOCHANGE
Yaan in xook tu naajil cook	Yaan a xooe'exk tu naajil cook	PERSON:2_PL
Nukuch waajo'ob xaan u tajalo' chúumuk ku ts'áabal	Nukuch waajo'ob xaan u tajalo' chúumuk ku ts'áabal	NOCHANGE
Cha'aik ya'abkach loolo'ob lool	Cha'aik ya'abkach loolo'ob lool	NOCHANGE
Le k-oojlo'on tu yo'lal le xch'i'ibalo'ob úuchben uchik u chu'unul le kya'ak lu'uma'	Le k-oojlo'on tu yo'lal le xch'i'ibalo'ob úuchben uchik u chu'unul le kya'ak lu'uma'	NOCHANGE
Táan u ya'akko'ob klo klo klo klo ki	Táan u ya'akko'ob klo klo klo klo ki	NOCHANGE
Tukulto'ob táan u bino'ob ti' jump'éel	Tukulto'ob táan u bino'ob ti' jump'éel	NOCHANGE
De k'aak'as ba'alil túun	De k'aak'as ba'alil túun	NOCHANGE
Yaana k'as chan chinik a pool ti'	Yaana k'as chan chinik a pool ti'	NOCHANGE
Ba'ale' le túuchicho' yaane' ti' ku bisik yóok'oli' yaane' yaane' ku ts'áabko'ob yáanal	Ba'ale' le túuchicho' yaane' ti' ku bisik yóok'oli' yaane' yaane' ku ts'áabko'ob yáanal	NOCHANGE
Ken ts'o'okok beyo' bey ma' síisako' yaan wíinike' kin wilik	Ken ts'o'okok beyo' bey ma' síisako' yaan wíinike' kin wilik	NOCHANGE
Ts'o'ok u náakal in wóol óotsilo'on mix ba'al yaan in kjaanto'on	Ts'o'ok u náakal in wóol óotsilo'on mix ba'al yaan in kjaanto'on	NOCHANGE
K'a'al in áabueelae' ka jo'op' u ya'alik tun bin ti' le le le máako'ob bin  este le le	K'a'al in áabueelae' ka jo'op' u ya'alik tun bin ti' le le le máako'ob bin  este le le	NOCHANGE
Le táasche'o'ob beeta'abo'	Le táasche'o'ob beeta'abo'	NOCHANGE
Ts'oka'an wáaj in 'eel	Ts'oka'an w xooke'exáaj in 'eel	PERSON:2_PL
Ook8in in bin ich cool	Ook8in in bu icho'ob cool	PERSON:3_PL
Leeti' ku ts'áabali' je'el puut	Leeti' ku ts'áabali' je'el puut	NOCHANGE
Le je'ela' u chan	Le je'ela' u chan	NOCHANGE
E máako'ob xan be'elake' pues táan in wiko'on bik le	E máako'ob xan be'elake' pues táan in wiko'on bik le	NOCHANGE
Puro k'e'eyn wolistak beya'	Puro k'e'eyn wolistak beya'	NOCHANGE
Ma'  k'abéet u láaj jáabal le kib yóok'ol le tuunich tu'ux ta t'abo'	Ma'  k'abéet u láaj jáabal le kib yóok'ol le tuunich tu'ux ta t'abo'	NOCHANGE
Ken ts'o'okok túun bey u siistal le k'óolo' ba'ax ku beetik tuune' ku ki'	Ken ts'o'okok túun bey u siistal le k'óolo' ba'ax ku beetik tuune' ku ki'	NOCHANGE
M' ts'oka'an in beeli'	M' ts'oka'an ine'ex beeli'	PERSON:2_PL
Jaan ku ya'alik bine' pajteni' le ba'alo'  pajteni' le ba'alo' ki bin ju	Jaan ku ya'alik bine' pajteni' le ba'alo'  pajteni' le ba'alo' ki bin ju	NOCHANGE
Ka u yil ma' u	Ka u yil ma' u	NOCHANGE
-chan xnuuko' ku ya'alik bin ti' leeti'e'  -pero chan winik  le tu'ux ka bino' táan a túun a wilik óoxp'éel bej yani'- ki bin	-chan xnuuko' ku ya'alik bin ti' leeti'e'  -pero chan winik  le tu'ux ka bino' táan a túun a wilik óoxp'éel bej yani'- ki bin	NOCHANGE
Suuk u beeta'ale'	Suuk u beeta'ale'	NOCHANGE
Jela'an eee wolistak túuno' ku bin u ts'áako'ob u kruusil u kruusil tu chúumuk	Jela'an eee wolistak túuno' ku bin u ts'áako'ob u kruusil u kruusil tu chúumuk	NOCHANGE
Le je'ela' k'as talam u tsoololil bey u tsikbalil	Le je'ela' k'as talam u tsoololil bey u tsikbalil	NOCHANGE
Tene' kin bin páak ich éool	Tene' kin bu páao'obk ich éool	PERSON:3_PL
Bey túun ts'o'ok u jóok'sa'al le waajo' ku	Bey túun ts'o'ok u jóok'sa'al le waajo' ku	NOCHANGE
Ma'k  ichil bin bey u ya'alik bin bey te'ej máako'obo' ka bin cha'ab u bin ka a'ala'ab bin ti'e' - yaan in yaan in wiko'on tu'ux ka bin- ki bin	Ma'k  ichil bin bey u ya'alik bin bey te'ej máako'obo' ka bin cha'ab u bin ka a'ala'ab bin ti'e' - yaan in yaan in wiko'on tu'ux ka bin- ki bin	NOCHANGE
Le esten le nukuch túuto' ku  meyajta'al yéetel juuch'	Le esten le nukuch túuto' ku  meyajta'al yéetel juuch'	NOCHANGE
Te'ej áak'abilo' le beetik ku ts'áabal le kibobo'obo'	Te'ej áak'abilo' le beetik ku ts'áabal le kibobo'obo'	NOCHANGE
Chen bin u bin u máan le k'iino'ob bino' táanu  bin u máan máan u bin u máan táan bin u  máan jach jaaj ku ganatik taak'in	Chen bin u bin u máan le k'iino'ob bino' táanu  bin u máan máan u bin u máan táan bin u  máan jach jaaj ku ganatik taak'in	NOCHANGE
Le e' boob wa ka jóok'oko' pues seguuro yaan u jaanta'alo'ob wa kaabal wa yóok'ol  bej yano'ob jaa	Le e' boob wa ka jóok'oko' pues seguuro yaan u jaanta'alo'ob wa kaabal wa yóok'ol  bej yano'ob jaa	NOCHANGE
Ya'ab ba'ax yaanto'on ich maaya  yaanto'on xan ich káastelaan in in	Ya'ab ba'ax yaanto'on ich maaya  yaanto'on xan ich káastelaan in in	NOCHANGE
Le bix u meeta'ale' ee	Le bix u meeta'ale' ee	NOCHANGE
Láayli'  xan beyo' yaan u meenta'al jump'éel nuxi'	Láayli'  xan beyo' yaan u meenta'al jump'éel nuxi'	NOCHANGE
U u yuumtsilo'ob xane'	U u yuumtsilo'ob xane'	NOCHANGE
Máax ba'axe' ku yáax cho'ik te'ej juuch'	Máax ba'axe' ku yáax cho'ik te'ej juuch'	NOCHANGE
Tene' áak'ab kin bib rnkiaado	Tene' áak'ab ka bibe'ex koonol rnkiaado	PERSON:2_PL
Sáansamal kin bin koonol mdaado	Sáansam wáajal kin bin koonol mdaado	SUBTYPE:INT
Tene' ti' kajabalen tu yot-che'	Tene' ti' kajab'a'abéet alen tu yot-che'	ASPECT:OBL
Táan in ioon tu knaajil xok	Taat áan i'on ioon tu knaajil xok	ASPECT:DES
A pantaloono'o ken bey ti' leeti'a' paktej ken ti'	A pantaloono'o ken bey ti' leeti'a' paktej ken ti'	NOCHANGE
Maanal k'aasil bix ken takil ba'al bey a wóol ti' chojokbal a ta' tu paach a	Maanal k'aasil bix ken takil ba'al bey a wóol ti' chojokbal a ta' tu paach a	NOCHANGE
Táan wáaj a bin oonol mrkaado	Ma' táanwáaj a bin oonol mrkaadoi'	TYPE:NEG;VOICE:ACT;TRANSITIV:ITR
Leeti' le úuchben máako'ob pues le bin	Leeti' le úuchben máako'ob pues le bin	NOCHANGE
Ooa'in in bin merkaado	Ooa'in in bin'a'abéet  merkaado	SUBTYPE:DEC;ASPECT:OBL
Ustako'obo' ti'al u ts'áaj te'ej yóok'ol le meesao' ti'al xan u payalchi'ita'al	Ustako'obo' ti'al u ts'áaj te'ej yóok'ol le meesao' ti'al xan u payalchi'ita'al	NOCHANGE
Ka bin u yilo'ob bin ba'ax ts'o'ok u kaxtik leeti'	Ka bin u yilo'ob bin ba'ax ts'o'ok u kaxtik leeti'	NOCHANGE
Tene' yabn ten me7aj úblo-ga	Tene wáaj' yabn ten me7aj úblo-ga	SUBTYPE:INT;PERSON:1_SI
Ba'ale' in	Ba'ale' in	NOCHANGE
Jach wáaj 'a'iabéet aa ab7n meraaho	Jach wáaj 'a'iabéesuut  aa ab7n meraaho	ASPECT:CUS
Waye' leti' ku paa'xal tak ti' le k'iinilo'oba'  ti' le  ee kaajo'ob pues táakpaja'ano'ob te'el ichil seentros séeremoniaaleso' ku	Waye' leti' ku paa'xal tak ti' le k'iinilo'oba'  ti' le  ee kaajo'ob pues táakpaja'ano'ob te'el ichil seentros séeremoniaaleso' ku	NOCHANGE
Tene' ts'o'an wáaj in beel	Tene' ma' tene' ts'o'an in beeli'	TYPE:NEG;SUBTYPE:DEC
Bey jach jaaj le xi'ipal bin u kaxtej  u t'aak'ine' tu ganarta túun bey leeti' ook te'el naj tu yilaj máax le ts'ajaan te'el najo'	Bey jach jaaj le xi'ipal bin u kaxtej  u t'aak'ine' tu ganarta túun bey leeti' ook te'el naj tu yilaj máax le ts'ajaan te'el najo'	NOCHANGE
Ku cha'abal jump'éel súutukil jump'éel ooraj	Ku cha'abal jump'éel súutukil jump'éel ooraj	NOCHANGE
Juntúul xi'ipal le reeyo'  ka tu suto'ob beyo'	Juntúul xi'ipal le reeyo'  ka tu suto'ob beyo'	NOCHANGE
Muñax ts'oka'an in beeli'	Muñax ts'ok báaxale'exa'an in beeli'	PERSON:2_PL
Le ken súutuk de k'aak'asba'alil beya'	Le ken súutuk de k'aak'asba'alil beya'	NOCHANGE
Ts'áako'ob u tuupo'o ba'ax túun jach bejla'ak ma' in	Ts'áako'ob u tuupo'o ba'ax túun jach bejla'ak ma' in	NOCHANGE
Yaao wáaj in bin koonol tu k'íiwikil koonol	Yaao wáaj ek bin koonol tu k'íiwikil koonol	PERSON:1_PL
Yaan a k'uchul ti' jump'éel tu'ux yaan a súutul	Yaan a k'uchul ti' jump'éel tu'ux yaan a súutul	NOCHANGE
Tene' tun bejla'aj túune' pues	Tene' tun bejla'aj túune' pues	NOCHANGE
Wa jump'éelili' ken a meente le waaj beyo'	Wa jump'éelili' ken a meente le waaj beyo'	NOCHANGE
Lúul kajakbal t1gu yéñn-el	Te'exe' lúul kajake'exbal t1gu yéñn-el	PERSON:2_PL
A'ot ts'oka'an in beeli'	A'ott ts'oka'an in beeli'e'	ASPECT:IMM;TENSE:PAS_SIM
Ichil le ichil le ch'a'aj cháako'  tak tin kaajale' ku beeta'al le cha'aj cháako' esteen	Ichil le ichil le ch'a'aj cháako'  tak tin kaajale' ku beeta'al le cha'aj cháako' esteen	NOCHANGE
Je'ex le je'elo' jump'éel ba'aj jach	Je'ex le je'elo' jump'éel ba'aj jach	NOCHANGE
Máako'ob jach ka'anachaj u tuukulo'ob	Máako'ob jach ka'anachaj u tuukulo'ob	NOCHANGE
Ch'up wey ko'on weenele'ki bin  pues ko'ox na'akal tu k'ab le	Ch'up wey ko'on weenele'ki bin  pues ko'ox na'akal tu k'ab le	NOCHANGE
Ma'atáan u na'atik ba'ax a k'áat a wa'al ti' chen a koje	Ma'atáan u na'atik ba'ax a k'áat a wa'al ti' chen a koje	NOCHANGE
Yaanlaj bin juntúul chan nojoch máak bine' bueeno juntúul chan nojoch ko'olej bin beyo'	Yaanlaj bin juntúul chan nojoch máak bine' bueeno juntúul chan nojoch ko'olej bin beyo'	NOCHANGE
U wolik u báai' ka'na'an a júuytik  a júuytik a júuytik	U wolik u báai' ka'na'an a júuytik  a júuytik a júuytik	NOCHANGE
U sáastale' teche' ts'o'ok a juch'ik a	U sáastale' teche' ts'o'ok a juch'ik a	NOCHANGE
Yaan le kya'ala kojunlich yaan le kya'ala'al esten	Yaan le kya'ala kojunlich yaan le kya'ala'al esten	NOCHANGE
Le píibil waajo' ti'al u beeta'ale'	Le píibil waajo' ti'al u beeta'ale'	NOCHANGE
Íene'ñáak'ab úin bin tu k'íiwikil koon l	Íene'ñáak'ub úin bin tu k'íiwikil koon l	PERSON:2_PL
Ma' utsi ts'o'olej tak u jo'olo'ob bejla'ake' láak wa'alakbal ku láak wa'akúunsiko'ob	Ma' utsi ts'o'olej tak u jo'olo'ob bejla'ake' láak wa'alakbal ku láak wa'akúunsiko'ob	NOCHANGE
Bey túuno' ti' bin ka'ach ku yaantal  u gobernantesilo'ob te'elo'	Bey túuno' ti' bin ka'ach ku yaantal  u gobernantesilo'ob te'elo'	NOCHANGE
Ki'iboktako'obo' ya'abe' ka láaj	Ki'iboktako'obo' ya'abe' ka láaj	NOCHANGE
Ku jóok's'aal le che'o'ob ku buuts'ilaankilo' ku p'a'atal  le jach	Ku jóok's'aal le che'o'ob ku buuts'ilaankilo' ku p'a'atal  le jach	NOCHANGE
Mix ba'al yaan in mina'an knook'o'on	Mix ba'al yaan in mina'an knook'o'on	NOCHANGE
Ti'al le ku ya'ala'al esten le muerteo' wa le máax bey u yet taal le	Ti'al le ku ya'ala'al esten le muerteo' wa le máax bey u yet taal le	NOCHANGE
Ba'ax u láak' xane' pues lete'ej xan le ee	Ba'ax u láak' xane' pues lete'ej xan le ee	NOCHANGE
Te'elba'ate'el táambal úucho' pues ya'abkach kaajo'ob xan p'áat láayli' yaan te'ej k'iio'oba' je'ex le xjo' tsuuk je'el bix sakalaaka je'el bix	Te'elba'ate'el táambal úucho' pues ya'abkach kaajo'ob xan p'áat láayli' yaan te'ej k'iio'oba' je'ex le xjo' tsuuk je'el bix sakalaaka je'el bix	NOCHANGE
Táan in bin koonol tu k'íiwikil k'onol	Táan in bin koonol tu k'íwáaj iwikil k'onol	SUBTYPE:INT
K'ajynajen tu naajil xook	K'ajyna wáajjen tu naajil xook	SUBTYPE:INT
Ku xa'ak'ta'al le juuch' yéetel le siklo'	Ku xa'ak'ta'al le juuch' yéetel le siklo'	NOCHANGE
Ma' wáaj jacú k'k'abéet in biw merkaaéoi'	Ma' wáaj jacú k'k'abéet suui n biw merkaaéoi'	ASPECT:CUS
Ba'ax túun bine' tu cha'o'ob tun bin u yáaka'btal bin ti'o'ob beyo'	Ba'ax túun bine' tu cha'o'ob tun bin u yáaka'btal bin ti'o'ob beyo'	NOCHANGE
Chen jump'éel táan piik le jach kóochtako'	Chen jump'éel táan piik le jach kóochtako'	NOCHANGE
Je'el bix le ba'ate'el táambal úuch	Je'el bix le ba'ate'el táambal úuch	NOCHANGE
Eee k'iinil ken u beeto'obo' leeti' túu le chen u láaj much'o'ob le ba'axo'ob ken u meyajto'obo' ichil le je'elo'	Eee k'iinil ken u beeto'obo' leeti' túu le chen u láaj much'o'ob le ba'axo'ob ken u meyajto'obo' ichil le je'elo'	NOCHANGE
Yaan in boon tu naajil x1ok	Yaan in bo wáajon tu naajil x1ok	SUBTYPE:INT
Y le mejen xkoots'ob waajo'obo' tu báak'lik	Y le mejen xkoots'ob waajo'obo' tu báak'lik	NOCHANGE
Te'ej mejen paalalo' pues láayi' xan te'ej ichilo'	Te'ej mejen paalalo' pues láayi' xan te'ej ichilo'	NOCHANGE
Santa muerte ale'  mina'an le	Santa muerte ale'  mina'an le	NOCHANGE
Ku ts'áabal túun xan le ki'ibo'obo'	Ku ts'áabal túun xan le ki'ibo'obo'	NOCHANGE
Nukuch waaj ku beeta'al túutil waaj ma' túutil waaji' le  nukuch waaj ku beeta'al yéetel le	Nukuch waaj ku beeta'al túutil waaj ma' túutil waaji' le  nukuch waaj ku beeta'al yéetel le	NOCHANGE
Ma' k'a'abéet wáaj in bin tu k'íiwikil koúnoli'	Ma' k'a'abéet wáaj in bin tu k'íiwikil koúnol wáaj	SUBTYPE:INT
Yóok'sal mix jump'íit u k'ebanil yaan	Yóok'sal mix jump'íit u k'ebanil yaan	NOCHANGE
Jach sk''abéeg a bin mdrkaaeo	Te'exe' jach sk''ae'exbéeg a bin mdrkaaeo	PERSON:2_PL
Áabastesimieento u ya'aliko'ob bin beyo'-	Áabastesimieento u ya'aliko'ob bin beyo'-	NOCHANGE
Tenó' áak'au kin bin merkamdo	Tenó'' áake'ex'au kin bin merkamdo	PERSON:2_PL
Yéetel tu láakal le ba'alo'ob bey ts'áaba'  de ke le paalo' yaan	Yéetel tu láakal le ba'alo'ob bey ts'áaba'  de ke le paalo' yaan	NOCHANGE
Bey túuno' ee tak ka úuch túun le geerra de kaastaso' ku ya'alik in noole' ku ya'alik in in áabueelae'	Bey túuno' ee tak ka úuch túun le geerra de kaastaso' ku ya'alik in noole' ku ya'alik in in áabueelae'	NOCHANGE
Yaan u ba'alil u ni'o'ob ki ten	Yaan u ba'alil u ni'o'ob ki ten	NOCHANGE
Yóok'sal ma' xan uk'ul xani' pues	Yóok'sal ma' xan uk'ul xani' pues	NOCHANGE
Ti'al u bin le pixano'obo'	Ti'al u bin le pixano'obo'	NOCHANGE
Yóoks'al ma' u téek eelel ma' sakantal	Yóoks'al ma' u téek eelel ma' sakantal	NOCHANGE
Chen ba'ale je'ex u kreero'ob leeti'o'ob je'ex u chíimpoolalo'obo' bey xan le to'ona' yaan wa ba'axo'ob  ku k'éexel ti'al leti' chen ba'axe' pues	Chen ba'ale je'ex u kreero'ob leeti'o'ob je'ex u chíimpoolalo'obo' bey xan le to'ona' yaan wa ba'axo'ob  ku k'éexel ti'al leti' chen ba'axe' pues	NOCHANGE
Táan in suut koonoyl merkaado	Táan in suutsuu  koonoyl merkaado	ASPECT:CUS
Je'el u béeytal in wiko'one' jach jaaj  je'ex u kaxta'al xan le taak'ino'ob ti' le muka'ano'obo'	Je'el u béeytal in wiko'one' jach jaaj  je'ex u kaxta'al xan le taak'ino'ob ti' le muka'ano'obo'	NOCHANGE
Yaan in boon tu nnajin xook	Yaan u boono'ob tu nnajin xook	PERSON:3_PL
Táan u bin obol tu k'íiwikil koonol	Táan u bin obo wáajl tu k'íiwikil koonol	SUBTYPE:INT
Tene' yaín ten u áanalte'il in xoñk matemáticas	Tene' yaín ten u áanalte'il intaa  xoñk matemáticas	ASPECT:DES
Jach sk''abéeg a bin mdrkaaeo	Jach sk''abéeg wáaj a bin mdrkaaeo	SUBTYPE:INT
Ma' ta w-'uyik ohúaxoli'	Suum a' ta w-'uyik ohúaxoli'	ASPECT:CUS
Ka'anal k'a'abéet u na'aksik ma'atáan u béeytal u na'akalo'	Ka'anal k'a'abéet u na'aksik ma'atáan u béeytal u na'akalo'	NOCHANGE
Ya'abkach meyajo'obi' la'aj meentik je'el u páajtala a meentik séeba'ane'	Ya'abkach meyajo'obi' la'aj meentik je'el u páajtala a meentik séeba'ane'	NOCHANGE
Eee nojoch ba'al yanik xan ti' le kaan xan ichilo'obo' le báalamo'obo'	Eee nojoch ba'al yanik xan ti' le kaan xan ichilo'obo' le báalamo'obo'	NOCHANGE
Je'el u páajtal a ts'áak u láak' u juuch'e' yóoksal u tatal ma'alo'ob ti'al a ts'áaj te'ej	Je'el u páajtal a ts'áak u láak' u juuch'e' yóoksal u tatal ma'alo'ob ti'al a ts'áaj te'ej	NOCHANGE
Yaan in manik ch7'ujuko'ob tu d'íiwikil koenol	Te'exe' yaan a mane'exik ch7'ujuko'ob tu d'íiwikil koenol	PERSON:2_PL
Yaan wáaj in bin koonol tu k'íiwlkil koonol	Yaan wáaj in wáaj bin koonol tu k'íiwlkil koonol	SUBTYPE:INT
Tumeen a woojel le píibo' yaan a meentik	Tumeen a woojel le píibo' yaan a meentik	NOCHANGE
Le bix u t'a'abal le píibo' ku	Le bix u t'a'abal le píibo' ku	NOCHANGE
Le buka'aj k'a'abéet wa nojoch wa chichan	Le buka'aj k'a'abéet wa nojoch wa chichan	NOCHANGE
Ma' u sa'atalo'ob le ba'ax tu p'atajto'on  knoolo'ono'	Ma' u sa'atalo'ob le ba'ax tu p'atajto'on  knoolo'ono'	NOCHANGE
Yáanal le mayak che' tu'ux ts'o'ok u láaj ta'asal bey ba'ax ku bisik yóok'ol le	Yáanal le mayak che' tu'ux ts'o'ok u láaj ta'asal bey ba'ax ku bisik yóok'ol le	NOCHANGE
Yaan wáaj in bin kóouno tu k'íiwlkil koonol	Yaan wáaj wáaj in bin kóouno tu k'íiwlkil koonol	SUBTYPE:INT;PERSON:1_SI
Táan wáaj a bjn koon7l tu k'uíiwikil oonol	Táan wáaj wáaj a bjn koon7l tu k'uíiwikil oonol	SUBTYPE:INT
Kib de koloores ti' le mejen paalalo'obo' ti' le nukuch máako'obo' box kib	Kib de koloores ti' le mejen paalalo'obo' ti' le nukuch máako'obo' box kib	NOCHANGE
Nukuch kúuchililo'ob le seentros séeremoniaales ku ya'ala'alo'	Nukuch kúuchililo'ob le seentros séeremoniaales ku ya'ala'alo'	NOCHANGE
Le ku meyajtik le ko'olelo'obo' eee ku meyajtik le máako'obo' ma' tu cha'o'ob in máani'	Le ku meyajtik le ko'olelo'obo' eee ku meyajtik le máako'obo' ma' tu cha'o'ob in máani'	NOCHANGE
Le ba'al tun je'ela' tu'ux taali' tumeen úuch ka'ache' le nukuch le maayao'obo' wa le nukuch maako'obo'	Le ba'al tun je'ela' tu'ux taali' tumeen úuch ka'ache' le nukuch le maayao'obo' wa le nukuch maako'obo'	NOCHANGE
Joypéel k'1ino'ob ka bhkn tu k'íiwikil koonol	Joypéel k'1 báaxale'exino'ob ka bhkn tu k'íiwikil koonol	PERSON:2_PL
Ts'áako'ob lu'umi' yóok'sal ma' u jook'ol	Ts'áako'ob lu'umi' yóok'sal ma' u jook'ol	NOCHANGE
Mejentak ma nuuktak u beenta'ali'	Mejentak ma nuuktak u beenta'ali'	NOCHANGE
Le ch'a'aj cháako' ku beeta'al beya'	Le ch'a'aj cháako' ku beeta'al beya'	NOCHANGE
Le ch le kibo' pues yaan a cha'a'ik u láaj ja'abali' ma'atáan xan a bin a tupej ka láaj	Le ch le kibo' pues yaan a cha'a'ik u láaj ja'abali' ma'atáan xan a bin a tupej ka láaj	NOCHANGE
Mañ tan in k'íilkabi'	Mañ tan in k'íilkabi' wáaj	SUBTYPE:INT
Pues leeti' ku taal u cha'a'o'ob bin	Pues leeti' ku taal u cha'a'o'ob bin	NOCHANGE
Taak in wilikech tet tu kúuchie bá1waloh	Taak' ma in wili wáajkech tet tu kúuchie bá1walohi'	TYPE:NEG;SUBTYPE:INT
Pues chen bin u xusbiko'ob bin le tuunich  bino' leeti'o'ob bine' ku  beetiko'ob bin le ku na'aksiko'ob bin lenukuch tuuncho'ob bin beyo'	Pues chen bin u xusbiko'ob bin le tuunich  bino' leeti'o'ob bine' ku  beetiko'ob bin le ku na'aksiko'ob bin lenukuch tuuncho'ob bin beyo'	NOCHANGE
Le guaardia túun bino' ka  tu ya'alaje' ma' bin u u	Le guaardia túun bino' ka  tu ya'alaje' ma' bin u u	NOCHANGE
Ol ichka'ap'eelchaja'an beyo' yaan e tuukul kastelaano' yaan u tuukulil maayai'	Ol ichka'ap'eelchaja'an beyo' yaan e tuukul kastelaano' yaan u tuukulil maayai'	NOCHANGE
Te'ej je'el túuna' ti' túun kun beetbil le waajo'ob de to'obilo'	Te'ej je'el túuna' ti' túun kun beetbil le waajo'ob de to'obilo'	NOCHANGE
Jaan ka jo'op' u ya'ako'ob bine' pues ba'an tun le ba'axa' kio'ob bin si le je'ela' este	Jaan ka jo'op' u ya'ako'ob bine' pues ba'an tun le ba'axa' kio'ob bin si le je'ela' este	NOCHANGE
Eesexe' ma' joúuáe'exi'	Eesexe'áaj  ma' joúuáe'exi'	ASPECT:BEG;TENSE:PAS_SIM
U béeytal u takik tak u chi' ka	U béeytal u takik tak u chi' ka	NOCHANGE
Ku p'e'esko'ob le ba'alche'o'obo' ku esten uu uu esten uuu	Ku p'e'esko'ob le ba'alche'o'obo' ku esten uu uu esten uuu	NOCHANGE
Pues ba'ax utsil yaan ti' ken ti'	Pues ba'ax utsil yaan ti' ken ti'	NOCHANGE
Ka tu ya'alo'ob le guaardiao' ka tu ya'alaj bin ti' le máako'obo'	Ka tu ya'alo'ob le guaardiao' ka tu ya'alaj bin ti' le máako'obo'	NOCHANGE
Ooa'in in bin merkaado	Ooa' wáajin in bin merkaado	SUBTYPE:INT
Tens' áak'ab kin bcn merkaado	Ma' tens' áak'ab kin bcn merkaadoi'	TYPE:NEG
Tenh' ajkoonolen hid -merkaao	Tenh' ajkoonolen hid -merkaao wáaj	SUBTYPE:INT
Wáan in bin koool tu k'íiwikil koonol	Wáan in bi wáajn koool tu k'íiwikil koonol	SUBTYPE:INT
Máax yietel jo'op' a bil 7koono tu kúuchil báaxal	Máax yietel jo'op' a bil 7kooe'exno tu kúuchil báaxal	PERSON:2_PL
Tene' yaan ten txooo t' esspalñ	Tene'' yaan e'exten txooo t' esspalñ	PERSON:2_PL
Ken k'uchuk le nukuch máako'ob  jach a ti'ilo' bino' le yuum a ti'ile'exo'	Ken k'uchuk le nukuch máako'ob  jach a ti'ilo' bino' le yuum a ti'ile'exo'	NOCHANGE
Uuuu che káajak u payalchi'o'ob túun bey le nukuch máako'obo'	Uuuu che káajak u payalchi'o'ob túun bey le nukuch máako'obo'	NOCHANGE
Tu ts'ok óoxp'éel túun le bejo'	Tu ts'ok óoxp'éel túun le bejo'	NOCHANGE
Yuum k'ujo'ob ku ch'íilpoolta'al deesde úuchej tak te'el k'iinilo'oba' k-ike' beyo' tu'uxak kajalkajile'	Yuum k'ujo'ob ku ch'íilpoolta'al deesde úuchej tak te'el k'iinilo'oba' k-ike' beyo' tu'uxak kajalkajile'	NOCHANGE
Ku ya'alik bin le chan xnuuk ti' le xi'ipalo'-tu'ux ka bin winik - ki bin	Ku ya'alik bin le chan xnuuk ti' le xi'ipalo'-tu'ux ka bin winik - ki bin	NOCHANGE
Yaan in boon tu naajil x1ok	Yaan in boo'ex tu naajil x1ok	PERSON:2_PL
Techea a k'aaba'e'	Techewáaj a a k'aaba'e'	SUBTYPE:INT
Tu'ñux kaja8balen	Tu'ñux ke'exaja8balen	PERSON:2_PL
Ich maayao'one' yáax ku yúuchul siibale' ku ts'o'okole' ku jaanta'al le ku p'áatalo' ma'ach u	Ich maayao'one' yáax ku yúuchul siibale' ku ts'o'okole' ku jaanta'al le ku p'áatalo' ma'ach u	NOCHANGE
Taak in wilikech te' tu kúuchil báaxalo'	Taak in wilitáan ech te' tu kúuchil báaxalo'	SUBTYPE:DEC;ASPECT:PRG
Tumeen beyo' táan a sáasilkúunsik bin u beel le pixano'	Tumeen beyo' táan a sáasilkúunsik bin u beel le pixano'	NOCHANGE
Ku taal máako'ob xak'a'altik u ju'unil	Ku taal máako'ob xak'a'altik u ju'unil	NOCHANGE
Máax kun náats'al bin te'el naj tbino' de kiinsbil u meentik tumeen leetie'  ma' u k'áat ka ojéelta'ak  tun bin	Máax kun náats'al bin te'el naj tbino' de kiinsbil u meentik tumeen leetie'  ma' u k'áat ka ojéelta'ak  tun bin	NOCHANGE
E je'elo' ka bin u k'éexel tumeen leeti'o'obe' tu taaso'ob u láak' tuukul ichil le máasewáal	E je'elo' ka bin u k'éexel tumeen leeti'o'obe' tu taaso'ob u láak' tuukul ichil le máasewáal	NOCHANGE
Pues ku k'u'unul ti' esten le ko'olebil maariao'	Pues ku k'u'unul ti' esten le ko'olebil maariao'	NOCHANGE
Ku ya'ala'alo'	Ku ya'ala'alo'	NOCHANGE
Le in wu'uymaj u tsikbalta'al  tumeen in noolo'ob tumeen le máako'ob  u u k'ajóolmo'ob jun p'íit yóok'sal le	Le in wu'uymaj u tsikbalta'al  tumeen in noolo'ob tumeen le máako'ob  u u k'ajóolmo'ob jun p'íit yóok'sal le	NOCHANGE
Táan a níistik a1 wotoch	Ts'o'ot áan a níistik a1 wotoch	ASPECT:TER;TENSE:PAS_SIM
Ka bin jo'op' u tsikbaltiko'ob ti' le ba'ax ts'o'ok u yojéeltiko'ob ba'an  ts'o'ok u yiliko'ob	Ka bin jo'op' u tsikbaltiko'ob ti' le ba'ax ts'o'ok u yojéeltiko'ob ba'an  ts'o'ok u yiliko'ob	NOCHANGE
Pero u na' bino' ku ya'alik ti' leeti'e'	Pero u na' bino' ku ya'alik ti' leeti'e'	NOCHANGE
Ku ts'o'okol túune' ku	Ku ts'o'okol túune' ku	NOCHANGE
Te' int bal tu kaajil kopoma8e'	Te' int bal tu kaajil kopoma8e' wáaj	SUBTYPE:INT
Je'elo' ka k'uch tun  esten ti' jump'éel bej beya' ka tu satubáae' te'ej máako'ob bino' sataj u báae' ka bin u yáalkab bin	Je'elo' ka k'uch tun  esten ti' jump'éel bej beya' ka tu satubáae' te'ej máako'ob bino' sataj u báae' ka bin u yáalkab bin	NOCHANGE
Pues yéetel tu kanáantubáao'ob yéetel tuu jóok'o'ob xan	Pues yéetel tu kanáantubáao'ob yéetel tuu jóok'o'ob xan	NOCHANGE
Pero jach bin tu puksi'ik'al bin xan ts'aa'y u yóol le ts'oono'	Pero jach bin tu puksi'ik'al bin xan ts'aa'y u yóol le ts'oono'	NOCHANGE
Jsa'atech te' parkoéeo'	Jsa wáaj'atech te' parkoéeo'	SUBTYPE:INT
Yaan wáaj a báaual tu naajil báaxal	Yaan wáaj a báaual tu naajilwáaj  báaxal	SUBTYPE:INT
U bisa'al tumeen le iik'o' ti' ku p'áatali' ma'atáan a molik xan	U bisa'al tumeen le iik'o' ti' ku p'áatali' ma'atáan a molik xan	NOCHANGE
Yóok'sal túun u cha'abal u jaanale' yaan a ts'áaik te'ej joolo'	Yóok'sal túun u cha'abal u jaanale' yaan a ts'áaik te'ej joolo'	NOCHANGE
Ichil túun le lela' ka tu taaso'ob le	Ichil túun le lela' ka tu taaso'ob le	NOCHANGE
Le chen ts'o'kok túun u beeta'al le bey yáax	Le chen ts'o'kok túun u beeta'al le bey yáax	NOCHANGE
Jobon hasta chojokbal ti'	Jobon hasta chojokbal ti'	NOCHANGE
Ee ba'axo'ob máax kun ts'áaik	Ee ba'axo'ob máax kun ts'áaik	NOCHANGE
Ka'abeje' yaan in bin tu k'íiwikil koonol	Káaj a'abeje' yaan in bin tu k'íiwikil koonol	ASPECT:BEG;TENSE:PAS_SIM
Ja'as k'úum	Ja'as k'úum	NOCHANGE
Te'el miil óochocieentos kuareenta y sieete ka ba'ate'eltalnaj le	Te'el miil óochocieentos kuareenta y sieete ka ba'ate'eltalnaj le	NOCHANGE
Ku esten u tu'upul	Ku esten u tu'upul	NOCHANGE
Le ka ojéelya'an túun bey uchik u yaantal le jboob ku ya'ala'alo'	Le ka ojéelya'an túun bey uchik u yaantal le jboob ku ya'ala'alo'	NOCHANGE
Le cha'aj cháako' ts'o'okol tun bey  esten uu	Le cha'aj cháako' ts'o'okol tun bey  esten uu	NOCHANGE
Tu lákaal ts'áab ti' jach jaaj ayik'alchaj bin tak leeti'	Tu lákaal ts'áab ti' jach jaaj ayik'alchaj bin tak leeti'	NOCHANGE
Bey ya'abo'on' yaane'  táan u jáajan ja'atale' táan u cho'ik u táan yóok'sal  ma' xan	Bey ya'abo'on' yaane'  táan u jáajan ja'atale' táan u cho'ik u táan yóok'sal  ma' xan	NOCHANGE
Leeti'e'e ma'ach u meentik mejen waajo'ob nukuch waaj	Leeti'e'e ma'ach u meentik mejen waajo'ob nukuch waaj	NOCHANGE
Ts'o'okole' pues tumeen úuch ka'ache' le chen ila'ak a takmaj a iipile'	Ts'o'okole' pues tumeen úuch ka'ache' le chen ila'ak a takmaj a iipile'	NOCHANGE
Tene ti' tku7jakbjalcen hu yotoche'	Ma' wáaj tene ti' tku7jakbjalcen hu yotoche'i'	TYPE:NEG;SUBTYPE:INT
Jach ma'ach u buuts'ilaankilo' k'ana'an u kanáanta'ale' ma' u	Jach ma'ach u buuts'ilaankilo' k'ana'an u kanáanta'ale' ma' u	NOCHANGE
Le píibo' ts'o'ok xan u jáabal u che'ile'	Le píibo' ts'o'ok xan u jáabal u che'ile'	NOCHANGE
P-jaanen merkaawao	P-jaawáaj nen merkaawao	SUBTYPE:INT
Tumeen yaan k'iine' ma' in ti'alo'oni wa ma'e' yaan a  a bixij	Tumeen yaan k'iine' ma' in ti'alo'oni wa ma'e' yaan a  a bixij	NOCHANGE
Ka esten ka ts'áabal túun le waaj beyo' pues	Ka esten ka ts'áabal túun le waaj beyo' pues	NOCHANGE
Táan in bin kokonol tu k'íiwikil koonol	Táan in bin kokonol tu k'íiwikwáaj il koonol	SUBTYPE:INT;ASPECT:HAB;PERSON:1_SI;VOICE:ACT;TRANSITIV:ITR
Táan in xook tu níñjil xook	Táan in xooktaa  tu níñjil xook	SUBTYPE:DEC;ASPECT:DES
Ba'atelnajen te' tu kúuchál báaxalo'	Ba'atelnajen te'e'ex tu kúuchál báaxalo'	PERSON:2_PL
Tréesieentos kuatrosieentos jump'éel	Tréesieentos kuatrosieentos jump'éel	NOCHANGE
U esten u  ch'uyubil tumeen tak le ch'uyubo'  le lelo' ti'	U esten u  ch'uyubil tumeen tak le ch'uyubo'  le lelo' ti'	NOCHANGE
U muuk'il ichil le kuxtal úuchben máasewáalo'obo'	U muuk'il ichil le kuxtal úuchben máasewáalo'obo'	NOCHANGE
Ma' tin wilaj u aáawtaal tin kaajali'	Ma' tin wilats'o'oj  u aáawtaal tin kaajali'	ASPECT:TER;TENSE:PAS_SIM
Ts'o'ok a juch'ik  a k'u'um ts'o'ok a p'o'ok a k'u'um ts'o'ok a juch'ik a k'u'uk	Ts'o'ok a juch'ik  a k'u'um ts'o'ok a p'o'ok a k'u'um ts'o'ok a juch'ik a k'u'uk	NOCHANGE
Tene' ajkoonoxen ichiw mherwekaado	Tene' wáaj ajkoonoxen ichiw mherwekaado	SUBTYPE:INT
Ku láaj ts'i'iktik le bak'o' chen ba'ale' téen in na'e'	Ku láaj ts'i'iktik le bak'o' chen ba'ale' téen in na'e'	NOCHANGE
Teche' yaan tech wáaj meyaj ti' biología	Teche' yaan tech wáaj meyaj ti' bwáaj iología	SUBTYPE:INT
Táan b bin tu koox	Táan b bie'exn tu koox	PERSON:2_PL
Pues ma' ya'abi' chen ba'ale' wa ti'al u	Pues ma' ya'abi' chen ba'ale' wa ti'al u	NOCHANGE
E xbáalamo'ob láaj u áapeyiidos	E xbáalamo'ob láaj u áapeyiidos	NOCHANGE
Púustik láakal ba'ax k'aas yani' yaan	Púustik láakal ba'ax k'aas yani' yaan	NOCHANGE
Tene' yaan ten meaj b7iñocrgía	Tene' yaan te'a'abéet n meaj b7iñocrgía	SUBTYPE:DEC;ASPECT:OBL
Yéetel jump'íit k'uxub	Yéetel jump'íit k'uxub	NOCHANGE
Ta'aytak u -cuhukikb'ob um ja'ab8il	Ta'aytakma'  u -cu wáajhukikb'ob um ja'ab8ili'	TYPE:NEG;SUBTYPE:INT
Le p'uuj túuno' ti'al u yaantal u bak'el	Le p'uuj túuno' ti'al u yaantal u bak'el	NOCHANGE
Ku ts'aabal xa'an yóok'ole' ku ts'o'okole' ku mu'ukul	Ku ts'aabal xa'an yóok'ole' ku ts'o'okole' ku mu'ukul	NOCHANGE
Ts'o'okol túun u t'a'abala beyo' ku cha'abal u láaj t'a'abal le che'o'obo'	Ts'o'okol túun u t'a'abala beyo' ku cha'abal u láaj t'a'abal le che'o'obo'	NOCHANGE
Tso'okol túune' ku jo'ol u pak'achtik yat xan le je'elo' leeti'e'	Tso'okol túune' ku jo'ol u pak'achtik yat xan le je'elo' leeti'e'	NOCHANGE
Tu yaak'abile' le kibo'ob láaj	Tu yaak'abile' le kibo'ob láaj	NOCHANGE
Yaan a ts'áaik sujuy nook' saki'	Yaan a ts'áaik sujuy nook' saki'	NOCHANGE
Ááan in bin koonol tu k'íidikil koonol	Ááan' ma in bin koonol tu k'íidikil koonoli'	TYPE:NEG
Yaan túun xan a	Yaan túun xan a	NOCHANGE
Yaan wáaj in jóok'ol konocx tu k'íiwikil koonol	Yaan wáaj a jóok'ol konocx tu k'íiwikil koonol	PERSON:2_SI
Ma' oin wucuyik ooxtli'	Taam a'o' oin wucuyik ooxtli'	ASPECT:DES
Je'elo' pues tak bejla'ake' ma'atáan in na'atik túun bixij bix je'el in in	Je'elo' pues tak bejla'ake' ma'atáan in na'atik túun bixij bix je'el in in	NOCHANGE
Yaax wáaj in bin koonol merkaad	Ma' yaaxwáaj in bin koonol merkaadi'	TYPE:NEG;VOICE:ACT;TRANSITIV:ITR
U este u píibil le waajo'	U este u píibil le waajo'	NOCHANGE
U xóoxot'al el kaaxo' bey u ts'áak tumeen u yoojel máax ki' u yu'ubik	U xóoxot'al el kaaxo' bey u ts'áak tumeen u yoojel máax ki' u yu'ubik	NOCHANGE
Yéetel le u chokwa'ilo' le chocolaate'	Yéetel le u chokwa'ilo' le chocolaate'	NOCHANGE
Le ba'al ts'o'ok u yiliko'obo' leeti'o'ob bin u yuumil ka'ach le palaasio	Le ba'al ts'o'ok u yiliko'obo' leeti'o'ob bin u yuumil ka'ach le palaasio	NOCHANGE
U k'ajóota'al yéetel u	U k'ajóota'al yéetel u	NOCHANGE
Je'elo' ts'o'ok túune' ku múuch'ul le máako'ob ti' jump'éel kúuchil bey wa te'ej esten le kúuchil ku yúuchulo'	Je'elo' ts'o'ok túune' ku múuch'ul le máako'ob ti' jump'éel kúuchil bey wa te'ej esten le kúuchil ku yúuchulo'	NOCHANGE
Tumeen bey bino' ma'atáan bin u wekiko'ob bin wa de kaaldo bine' ma'atáan bin u wekiko'ob bin le	Tumeen bey bino' ma'atáan bin u wekiko'ob bin wa de kaaldo bine' ma'atáan bin u wekiko'ob bin le	NOCHANGE
Tak'ik yóok'ol bey u chan maake'	Tak'ik yóok'ol bey u chan maake'	NOCHANGE
Bejla'ake' eeebeyo' pues	Bejla'ake' eeebeyo' pues	NOCHANGE
Caín wáaj in xin ich ko8l	Caín  wáajwáaj in xin ich ko8l	SUBTYPE:INT
Yaan wáaj in biin koinol tu k'íiwikil koonol	Yaan wáaj in bie'exin koinol tu k'íiwikil koonol	PERSON:2_PL
Je'elo' le nook' túuno' je'ex to'on bejla'aka'	Je'elo' le nook' túuno' je'ex to'on bejla'aka'	NOCHANGE
Pixano'obo' ti'al bin u biso'ob pues	Pixano'obo' ti'al bin u biso'ob pues	NOCHANGE
Tene' kaíakralen weye'	Tene' kaíak báaxale'exralen weye'	PERSON:2_PL
Le chen áak'ablajak bey chen jo'op' u taal u chíinil k'iin bin beya' leeti' kenjo'op' u taal u súutul de	Le chen áak'ablajak bey chen jo'op' u taal u chíinil k'iin bin beya' leeti' kenjo'op' u taal u súutul de	NOCHANGE
Ka tu yilaj bin juntúul chan xnuuk	Ka tu yilaj bin juntúul chan xnuuk	NOCHANGE
A yáax beente le ets'kúunsajo'	A yáax beente le ets'kúunsajo'	NOCHANGE
