Ti'al in bin tak	Ti'al in bin tak	NOCHANGE
Le de k'aab le ki'iwajo' ma', ma' páap u beenta'ali'.	Le de k'aab le ki'iwajo' ma', ma' páap u beenta'ali'.	NOCHANGE
Le beetike' ku ya'alale' ku beeta'al bey de  esten... de táamali'lo' wa to'obil waaj	Le beetike' ku ya'alale' ku beeta'al bey de  esten... de táamali'lo' wa to'obil waaj	NOCHANGE
Chan xnuuk túun bino' tu yilo'ob bin	Chan xnuuk túun bino' tu yilo'ob bin	NOCHANGE
Ka bin bini'.	Ka bin bini'.	NOCHANGE
Le chan xnuuko' ku ya'alik túun bine' -chan  xi'ipa k'a'abéet a jach tukultik máakal bejil ken a cha'e', tumeen jump'éel le bejo'	Le chan xnuuko' ku ya'alik túun bine' -chan  xi'ipa k'a'abéet a jach tukultik máakal bejil ken a cha'e', tumeen jump'éel le bejo'	NOCHANGE
Bey túuno' ku ki' ta'asali' le ee... e.e..	Bey túuno' ku ki' ta'asali' le ee... e.e..	NOCHANGE
Ku máan túun esten	Ku máan túun esten	NOCHANGE
Le je'elo' yaan yila' yéetel buka'aj	Le je'elo' yaan yila' yéetel buka'aj	NOCHANGE
Waaj,	Waaj,	NOCHANGE
Pues ma' ya'abi', chen ba'ale' wa ti'al u	Pues ma' ya'abi', chen ba'ale' wa ti'al u	NOCHANGE
Ka yanak u ja'ilxan u k'oolil  le jaaxo'	Ka yanak u ja'ilxan u k'oolil  le jaaxo'	NOCHANGE
Ti' ka pakto'ob wa ka kulakech a wil u jaanal,	Ti' ka pakto'ob wa ka kulakech a wil u jaanal,	NOCHANGE
Chen leti'.	Chen leti'.	NOCHANGE
Ya'abkach meyajo'obi' la'aj meentik je'el u páajtala a meentik séeba'ane'	Ya'abkach meyajo'obi' la'aj meentik je'el u páajtala a meentik séeba'ane'	NOCHANGE
U bisa'alo'ob tak ju may, ts'o'okle' ku k'uchlo'ob tak xja'asil	U bisa'alo'ob tak ju may, ts'o'okle' ku k'uchlo'ob tak xja'asil	NOCHANGE
Ku ya'alike'	Ku ya'alike'	NOCHANGE
Tu k'iinil bey ta'aytak u koolo'obo',  leeti'o'obe' ku k'áatiko'ob ti' le	Tu k'iinil bey ta'aytak u koolo'obo',  leeti'o'obe' ku k'áatiko'ob ti' le	NOCHANGE
U láak' jump'éel le bejo' , wa ka k'uchukech te'ej...	U láak' jump'éel le bejo' , wa ka k'uchukech te'ej...	NOCHANGE
Pues leeti' ku taal u cha'a'o'ob bin.	Pues leeti' ku taal u cha'a'o'ob bin.	NOCHANGE
Jump'éel de , de chan xa'an yéetel puuro che'il u paach	Jump'éel de , de chan xa'an yéetel puuro che'il u paach	NOCHANGE
De k'as áak'ab	De k'as áak'ab	NOCHANGE
E je'elo' ka bin u k'éexel, tumeen leeti'o'obe' tu taaso'ob u láak' tuukul ichil le máasewáal	E je'elo' ka bin u k'éexel, tumeen leeti'o'obe' tu taaso'ob u láak' tuukul ichil le máasewáal	NOCHANGE
Le píibil waajo' ti'al u beeta'ale'	Le píibil waajo' ti'al u beeta'ale'	NOCHANGE
Ts'o'okol túun beyo' ku ch'a'ake' ka pak'achtik le waaj yóok'ol le...	Ts'o'okol túun beyo' ku ch'a'ake' ka pak'achtik le waaj yóok'ol le...	NOCHANGE
In natsil tene' ma', jach chen tu chan p'íis, yóoks'al ki'ibok le juch'o' chen ba'al' ma' jach	In natsil tene' ma', jach chen tu chan p'íis, yóoks'al ki'ibok le juch'o' chen ba'al' ma' jach	NOCHANGE
Eee... tu'ux kun meyajtbil	Eee... tu'ux kun meyajtbil	NOCHANGE
Te'ej k'iin je'elo' láayli' xan  je'el u béeytal u ya'ala'al wa yaan u láak' u láak'o'ob , wa yaan máax bey u láak'kimeno'	Te'ej k'iin je'elo' láayli' xan  je'el u béeytal u ya'ala'al wa yaan u láak' u láak'o'ob , wa yaan máax bey u láak'kimeno'	NOCHANGE
Ichil le tuukulo' ku ya'ala'ale'  táan u	Ichil le tuukulo' ku ya'ala'ale'  táan u	NOCHANGE
Le je'elo' ma' ka'na'an u kaxta'al le sajkab tuunicho mi bix u ya'ala'alti'e'.eso	Le je'elo' ma' ka'na'an u kaxta'al le sajkab tuunicho mi bix u ya'ala'alti'e'.eso	NOCHANGE
Wa tumeen esten mix kanan u beeta'ali'	Wa tumeen esten mix kanan u beeta'ali'	NOCHANGE
Ka tu yilaj bin juntúul chan xnuuk	Ka tu yilaj bin juntúul chan xnuuk	NOCHANGE
E kuxa'anilo'on, yaniko'on, tumeen to'on jela'anktuukul	E kuxa'anilo'on, yaniko'on, tumeen to'on jela'anktuukul	NOCHANGE
Ma'atáan ktakik k iipilo'on,	Ma'atáan ktakik k iipilo'on,	NOCHANGE
U kis buuts'il u bin máake' , yaan jump'éel te'ej k'íiwiko'	U kis buuts'il u bin máake' , yaan jump'éel te'ej k'íiwiko'	NOCHANGE
Wa chen sak kib je'el u béeytal xan a ts'áaike'.	Wa chen sak kib je'el u béeytal xan a ts'áaike'.	NOCHANGE
Leeti' le ba'al ba'alo', wa leeti' le ba'al ba'alo', in woojel.	Leeti' le ba'al ba'alo', wa leeti' le ba'al ba'alo', in woojel.	NOCHANGE
U cha'am'ob bin che', u ch'amo'ob máaskab, tu láakal u ch'a'amo'ob,leeti'o'obe' taak u...	U cha'am'ob bin che', u ch'amo'ob máaskab, tu láakal u ch'a'amo'ob,leeti'o'obe' taak u...	NOCHANGE
Chen ba'ax túune' esteee... koomo ke u cha'a'maj u tsoone' kex táan u ts'onik le ba'alo' ma'atáan esten  u kíimil bin	Chen ba'ax túune' esteee... koomo ke u cha'a'maj u tsoone' kex táan u ts'onik le ba'alo' ma'atáan esten  u kíimil bin	NOCHANGE
U láak' kaajo'ob, bix, kóosumeel, san jervaasio, kankuun,	U láak' kaajo'ob, bix, kóosumeel, san jervaasio, kankuun,	NOCHANGE
Ya'abkach múulo'b tu líik'sláanto'ob leeti'o'obe' tu'ux tu p'ato'ob to'one' leeti' le  ba'axo'ob ayik'alkúuntik, leti' leee...	Ya'abkach múulo'b tu líik'sláanto'ob leeti'o'obe' tu'ux tu p'ato'ob to'one' leeti' le  ba'axo'ob ayik'alkúuntik, leti' leee...	NOCHANGE
Ya'ab máax ku k'áat óolal	Ya'ab máax ku k'áat óolal	NOCHANGE
Eee... nojoch ba'al yanik xan ti' le kaan xan ichilo'obo', le báalamo'obo'	Eee... nojoch ba'al yanik xan ti' le kaan xan ichilo'obo', le báalamo'obo'	NOCHANGE
Mix ba'al yaan in... mina'an knook'o'on,	Mix ba'al yaan in... mina'an knook'o'on,	NOCHANGE
In kaajal bix u beeta'alo'	In kaajal bix u beeta'alo'	NOCHANGE
Tu lákaal ts'áab ti', jach jaaj ayik'alchaj bin tak leeti'.	Tu lákaal ts'áab ti', jach jaaj ayik'alchaj bin tak leeti'.	NOCHANGE
Juntúul paale' jach k'a'abéet u chíimpooltik	Juntúul paale' jach k'a'abéet u chíimpooltik	NOCHANGE
Chika'an tak u bel u yiito'ob beya' ti' yaan u	Chika'an tak u bel u yiito'ob beya' ti' yaan u	NOCHANGE
Tu'ux kun ts'áabil, u nu'ukulil,	Tu'ux kun ts'áabil, u nu'ukulil,	NOCHANGE
Ba'ax k'iin u meyajta'al	Ba'ax k'iin u meyajta'al	NOCHANGE
Yaan jump'éel tieendaj ta xno'oj, tieendasan jose', ts'o'okole' ku laanchajal a bin a bin tu ka'atéen	Yaan jump'éel tieendaj ta xno'oj, tieendasan jose', ts'o'okole' ku laanchajal a bin a bin tu ka'atéen	NOCHANGE
Je'elo' ka túun tu ya'alo'ob ti' beyo' ka tu k'axo'obe' ka tu... ka tu  tsáajo'ob bin beya'	Je'elo' ka túun tu ya'alo'ob ti' beyo' ka tu k'axo'obe' ka tu... ka tu  tsáajo'ob bin beya'	NOCHANGE
Te'ej k'iin je'elo'ob ts'o'ok u páajtal in k'ajóoltik ya'abkach	Te'ej k'iin je'elo'ob ts'o'ok u páajtal in k'ajóoltik ya'abkach	NOCHANGE
Ma'atáan ktakiko'on u piikilo',	Ma'atáan ktakiko'on u piikilo',	NOCHANGE
Tak ti'al u jóok'sa'al le...	Tak ti'al u jóok'sa'al le...	NOCHANGE
Ku ya'ik tun bin in áabueelae' -ma'	Ku ya'ik tun bin in áabueelae' -ma'	NOCHANGE
Ba'ale' ichil le... esten le  je'ela' k'a'abéet in	Ba'ale' ichil le... esten le  je'ela' k'a'abéet in	NOCHANGE
Yóok'sal bin ma' u jaantiko'ob bin le ti' bin le	Yóok'sal bin ma' u jaantiko'ob bin le ti' bin le	NOCHANGE
De k'aak'as ba'alil túun.	De k'aak'as ba'alil túun.	NOCHANGE
Pero... u na' bino' ku ya'alik ti' leeti'e'	Pero... u na' bino' ku ya'alik ti' leeti'e'	NOCHANGE
Bey túun ts'o'ok u jóok'sa'al le waajo' ku	Bey túun ts'o'ok u jóok'sa'al le waajo' ku	NOCHANGE
Jump'éelili' u boonil,  de...	Jump'éelili' u boonil,  de...	NOCHANGE
Táanil, ma' jach lúubsa'ab u yóolo'ob	Táanil, ma' jach lúubsa'ab u yóolo'ob	NOCHANGE
Yóoks'al ma' u téek eelel. ma' sakantal	Yóoks'al ma' u téek eelel. ma' sakantal	NOCHANGE
Tumeen beyo' táan a sáasilkúunsik bin u beel le pixano'.	Tumeen beyo' táan a sáasilkúunsik bin u beel le pixano'.	NOCHANGE
Le píibil waajo' je'ex suuk u meentik in na'tsil yéetel in yuumtsile'  jump'éel	Le píibil waajo' je'ex suuk u meentik in na'tsil yéetel in yuumtsile'  jump'éel	NOCHANGE
Leeti'e le tuup ku ts'áaik le xi'ipalaalo'obo'.	Leeti'e le tuup ku ts'áaik le xi'ipalaalo'obo'.	NOCHANGE
U jaajile' ma' jump'éelilo'on je'el bix  way maayaso'on kintaana roo, maayas yúukataan, mayas	U jaajile' ma' jump'éelilo'on je'el bix  way maayaso'on kintaana roo, maayas yúukataan, mayas	NOCHANGE
Leti' bine' ma' tu cha'ao'ob u máan bin le meejilo'ob inal le nuxi' reey bino',  le nojoch reeyo',	Leti' bine' ma' tu cha'ao'ob u máan bin le meejilo'ob inal le nuxi' reey bino',  le nojoch reeyo',	NOCHANGE
Le tuunicho',	Le tuunicho',	NOCHANGE
Ichil le... ichil le ch'a'aj cháako',  tak tin kaajale' ku beeta'al le cha'aj cháako' esteen	Ichil le... ichil le ch'a'aj cháako',  tak tin kaajale' ku beeta'al le cha'aj cháako' esteen	NOCHANGE
Máako'ob jach ka'anachaj u tuukulo'ob	Máako'ob jach ka'anachaj u tuukulo'ob	NOCHANGE
Ka puk'ike' ka láaliki'	Ka puk'ike' ka láaliki'	NOCHANGE
Ma' in kaxtej u bix ken in tsolilej ,	Ma' in kaxtej u bix ken in tsolilej ,	NOCHANGE
Jejeláas u boonilo'ob.	Jejeláas u boonilo'ob.	NOCHANGE
U bisa'al tumeen le iik'o', ti' ku p'áatali', ma'atáan a molik xan,	U bisa'al tumeen le iik'o', ti' ku p'áatali', ma'atáan a molik xan,	NOCHANGE
Tumeen leeti'o'ob bine', je'ex  le kaano', le kukulkaan ku ya'ala'alo'	Tumeen leeti'o'ob bine', je'ex  le kaano', le kukulkaan ku ya'ala'alo'	NOCHANGE
Leti' túun bine' bey jach ya'ab ba'al bin u yoojel bino'	Leti' túun bine' bey jach ya'ab ba'al bin u yoojel bino'	NOCHANGE
Jaan ka jo'op' u tsikbalta'al tun bin beyo' ka bin tu ya'alo'ob bin le máako'ob  beyo' wa ka wile'exe' kíin juntúul	Jaan ka jo'op' u tsikbalta'al tun bin beyo' ka bin tu ya'alo'ob bin le máako'ob  beyo' wa ka wile'exe' kíin juntúul	NOCHANGE
Yaan u yila'al u kúuchilil	Yaan u yila'al u kúuchilil	NOCHANGE
Leti' túun le máako'ob, le wiít'o'ob,  yéetel le esten le... e	Leti' túun le máako'ob, le wiít'o'ob,  yéetel le esten le... e	NOCHANGE
Ku yilik bine' k'uch ti' jump'éel tu'ux bine'	Ku yilik bine' k'uch ti' jump'éel tu'ux bine'	NOCHANGE
Ts'o'ok a tak'akúunsika'	Ts'o'ok a tak'akúunsika'	NOCHANGE
Ba'ale' in	Ba'ale' in	NOCHANGE
Je'elo' ka k'uch tun  esten, ti' jump'éel bej beya' ka tu satubáae' te'ej máako'ob bino', sataj u báae' ka bin u yáalkab bin	Je'elo' ka k'uch tun  esten, ti' jump'éel bej beya' ka tu satubáae' te'ej máako'ob bino', sataj u báae' ka bin u yáalkab bin	NOCHANGE
Ts'o'okol túune' ka bin	Ts'o'okol túune' ka bin	NOCHANGE
Ku ya'ala'al to'on máako'ob jach yaan u na'ato'ob	Ku ya'ala'al to'on máako'ob jach yaan u na'ato'ob	NOCHANGE
Ts'okol túune' le je'elo' ku síik,	Ts'okol túune' le je'elo' ku síik,	NOCHANGE
U maama bino' tu jóok'saj bin te'el chan kajtalil bin tu'ux yano'obo'	U maama bino' tu jóok'saj bin te'el chan kajtalil bin tu'ux yano'obo'	NOCHANGE
Ken ts'o'okok beyo' bey ma' síisako' yaan wíinike' kin wilik	Ken ts'o'okok beyo' bey ma' síisako' yaan wíinike' kin wilik	NOCHANGE
Ku ya'ako'obe' -pero máaxi'-  ki'o'ob bin - aan, juntúul chan xnuuk	Ku ya'ako'obe' -pero máaxi'-  ki'o'ob bin - aan, juntúul chan xnuuk	NOCHANGE
Te'el tu'ux ts'o'on le xch'uupo', mina'an bini', sáam bin xi'ik.	Te'el tu'ux ts'o'on le xch'uupo', mina'an bini', sáam bin xi'ik.	NOCHANGE
Yaana k'as chan chinik a pool ti',	Yaana k'as chan chinik a pool ti',	NOCHANGE
Ken ts'o'okok u tajal le k'ool bey túun ts'o'ok u tupik yáanala'	Ken ts'o'okok u tajal le k'ool bey túun ts'o'ok u tupik yáanala'	NOCHANGE
De k'aab le ki'iwaj ku beenta'ala',	De k'aab le ki'iwaj ku beenta'ala',	NOCHANGE
Ku máan u ta'ak u báao'ob ich k'áax, yóok'sal ma' u kíins'aal in esten in... in... áabueelo beyo' kij	Ku máan u ta'ak u báao'ob ich k'áax, yóok'sal ma' u kíins'aal in esten in... in... áabueelo beyo' kij	NOCHANGE
Wa jump'éelili' ken a meente le waaj beyo',	Wa jump'éelili' ken a meente le waaj beyo',	NOCHANGE
U wináalil novieembre ku ya'ala'alo',	U wináalil novieembre ku ya'ala'alo',	NOCHANGE
Wojéeltik tu'ux je'el u béeytal,  tu'ux, ka'ap'éel tu'ux je'el u béeytaal u cha'a'abla	Wojéeltik tu'ux je'el u béeytal,  tu'ux, ka'ap'éel tu'ux je'el u béeytaal u cha'a'abla	NOCHANGE
U bin bin t'ambil le reeyo', leeti'e'e je'el u béeytal u ya'alikti'o'obe' ba'ax le tu yilo'obo'.	U bin bin t'ambil le reeyo', leeti'e'e je'el u béeytal u ya'alikti'o'obe' ba'ax le tu yilo'obo'.	NOCHANGE
In kaxtik u beelil	In kaxtik u beelil	NOCHANGE
Ka máansik le toopeo' ka bin, ku lanchajal a bin a  wilik najo'o túun	Ka máansik le toopeo' ka bin, ku lanchajal a bin a  wilik najo'o túun	NOCHANGE
Ba'ale', koomo pues bey ts'o'ok u yáak'abtal beyo',   ts'o'ok u bin le k'iin beyo',	Ba'ale', koomo pues bey ts'o'ok u yáak'abtal beyo',   ts'o'ok u bin le k'iin beyo',	NOCHANGE
Ts'o'okole' yaan a bin, yaan a máasik le óospitaal	Ts'o'okole' yaan a bin, yaan a máasik le óospitaal	NOCHANGE
Tsajik le k'uxub iyéetel  le máanteko' antes u láalik ichil le juuch'o'.	Tsajik le k'uxub iyéetel  le máanteko' antes u láalik ichil le juuch'o'.	NOCHANGE
Jejeláas le saantos kya'alalo' ku ch'iimpoolta'al, je'ex te'ej úuchilo'	Jejeláas le saantos kya'alalo' ku ch'iimpoolta'al, je'ex te'ej úuchilo'	NOCHANGE
Chen bin u bin u máan le k'iino'ob bino', táanu  bin u máan, máan u bin u máan, táan bin u  máan, jach jaaj ku ganatik taak'in	Chen bin u bin u máan le k'iino'ob bino', táanu  bin u máan, máan u bin u máan, táan bin u  máan, jach jaaj ku ganatik taak'in	NOCHANGE
Wa ba'axo'ob ku meyaj.. u nu'ukulilo'ob	Wa ba'axo'ob ku meyaj.. u nu'ukulilo'ob	NOCHANGE
Tumeen le je'ela' pues yan ma' chen de kaaldoi',	Tumeen le je'ela' pues yan ma' chen de kaaldoi',	NOCHANGE
Kin wa'alik tene' kin wa'alik bey ti' in, in  paalila'	Kin wa'alik tene' kin wa'alik bey ti' in, in  paalila'	NOCHANGE
Ka t'óot'ik te'ej bejo', leeti' ken a láaj t'o'ot' te'ej bej  tu'ux	Ka t'óot'ik te'ej bejo', leeti' ken a láaj t'o'ot' te'ej bej  tu'ux	NOCHANGE
Le chan paalo' tumeen ku ya'ala'ale' yaan ku taas... taasbil u meenta'alo'ob	Le chan paalo' tumeen ku ya'ala'ale' yaan ku taas... taasbil u meenta'alo'ob	NOCHANGE
Ka tu kíinso'ob bin, tu tóokajo'ob bin.	Ka tu kíinso'ob bin, tu tóokajo'ob bin.	NOCHANGE
Treinta y uno yéetel diia primero.	Treinta y uno yéetel diia primero.	NOCHANGE
Pixano'obo', ti'al bin u biso'ob pues...	Pixano'obo', ti'al bin u biso'ob pues...	NOCHANGE
U k'iinil le jaanal pixano', u ja'abl,	U k'iinil le jaanal pixano', u ja'abl,	NOCHANGE
Yaan a k'uchul ti' jump'éel tu'ux yaan a súutul	Yaan a k'uchul ti' jump'éel tu'ux yaan a súutul	NOCHANGE
Ya'ab u k'áat óolal máak yóok'sal u k'áata'al eee... santo ja'o'	Ya'ab u k'áat óolal máak yóok'sal u k'áata'al eee... santo ja'o'	NOCHANGE
Tréesieentos, kuatrosieentos jump'éel.	Tréesieentos, kuatrosieentos jump'éel.	NOCHANGE
Ba'ax esten... ba'ax u meentmaj leeti'i'	Ba'ax esten... ba'ax u meentmaj leeti'i'	NOCHANGE
Ba'ale' ti'al túun le je'ela' ku beeta'al jejeláas jaanalo'ob, tu ts'ook k'iine',	Ba'ale' ti'al túun le je'ela' ku beeta'al jejeláas jaanalo'ob, tu ts'ook k'iine',	NOCHANGE
Kuxtalilo', wa miaatsililo'	Kuxtalilo', wa miaatsililo'	NOCHANGE
Yóok'sal bin túun t'anik'ob bin le ja'o', le nukuch máako'obo' táan u t'aniko'ob xan, ichil le je'el túuno' pues	Yóok'sal bin túun t'anik'ob bin le ja'o', le nukuch máako'obo' táan u t'aniko'ob xan, ichil le je'el túuno' pues	NOCHANGE
Ku bino'ob le pixano'obo',	Ku bino'ob le pixano'obo',	NOCHANGE
Ka bin tu beeto'ob bin u chan naayo'ob tu k'ab bin le che'o'	Ka bin tu beeto'ob bin u chan naayo'ob tu k'ab bin le che'o'	NOCHANGE
Uts tin wich le meyaj je'ex le kin máak'anatik te'ej	Uts tin wich le meyaj je'ex le kin máak'anatik te'ej	NOCHANGE
Le chen... la'a beetik tun bin beyo' le maayaso'ob úuchil ken...	Le chen... la'a beetik tun bin beyo' le maayaso'ob úuchil ken...	NOCHANGE
Je'elo' ma'atáan in laxtik bix ken in wa'alil ti', tin kaxtak je'el bixake', -ma'atáan in ts'áaik ti' teech taak'in, ma'atáan in beetik beya'...	Je'elo' ma'atáan in laxtik bix ken in wa'alil ti', tin kaxtak je'el bixake', -ma'atáan in ts'áaik ti' teech taak'in, ma'atáan in beetik beya'...	NOCHANGE
U k'ajóota'al yéetel u...	U k'ajóota'al yéetel u...	NOCHANGE
Bey u ya'ala'alo', mu'un béeytal u táakpajal ko'oleli', tumeen yaan u yiik'al le... le	Bey u ya'ala'alo', mu'un béeytal u táakpajal ko'oleli', tumeen yaan u yiik'al le... le	NOCHANGE
Ba'alo'ob kin kanko'on,tumeen  ba'alob kin kanko'ob , ba'ale' yaane' ma' in t'anej... ma' in tu'ubso'on in t'aano'oni', ma' in tu'ubso'on kmiaatsilo'oni', ya'ab ba'ax	Ba'alo'ob kin kanko'on,tumeen  ba'alob kin kanko'ob , ba'ale' yaane' ma' in t'anej... ma' in tu'ubso'on in t'aano'oni', ma' in tu'ubso'on kmiaatsilo'oni', ya'ab ba'ax	NOCHANGE
E xbáalamo'ob, láaj u áapeyiidos	E xbáalamo'ob, láaj u áapeyiidos	NOCHANGE
Jun páak ken a manile', ts'o'okole' kux túun u piikil ku ya'ala'alo'	Jun páak ken a manile', ts'o'okole' kux túun u piikil ku ya'ala'alo'	NOCHANGE
De xa'an, ts'o'okol le yáax naj ken a wilo', ts'o'okole' yaan jump'éel réestoraani', ts'o'okole' ka wilik jump'éel toopée	De xa'an, ts'o'okol le yáax naj ken a wilo', ts'o'okole' yaan jump'éel réestoraani', ts'o'okole' ka wilik jump'éel toopée	NOCHANGE
Tumeen wa ma'atáan a ts'áaike' leeti'e'e yaan u to'okol u yo'och tumeen le máax taas beyo'	Tumeen wa ma'atáan a ts'áaike' leeti'e'e yaan u to'okol u yo'och tumeen le máax taas beyo'	NOCHANGE
Ma' je'ex ka'ach úucho', chen máanakech , tu'uxak bejil ka máanakech ken a wil juntúul nojoch máake'	Ma' je'ex ka'ach úucho', chen máanakech , tu'uxak bejil ka máanakech ken a wil juntúul nojoch máake'	NOCHANGE
Le éespiritualidaad maaya ku ya'ala'alo', tumeen leeti'o'ob bine' ku ya'ala'ale' uch u meentiko'ob le nukuch múulo'obo'	Le éespiritualidaad maaya ku ya'ala'alo', tumeen leeti'o'ob bine' ku ya'ala'ale' uch u meentiko'ob le nukuch múulo'obo'	NOCHANGE
Kaabalo'	Kaabalo'	NOCHANGE
Yóok'ol kaab, le  nueeveo' leeti' le... esten e...	Yóok'ol kaab, le  nueeveo' leeti' le... esten e...	NOCHANGE
Yook túun bin le ba'ax bin binik túun bin beya' aasta  tak bin u k'áab u chi'  láaj choojnaja'an táan bin u bin u	Yook túun bin le ba'ax bin binik túun bin beya' aasta  tak bin u k'áab u chi'  láaj choojnaja'an táan bin u bin u	NOCHANGE
A ki'iki' t'antik.	A ki'iki' t'antik.	NOCHANGE
Kuuch, ts'o'okol u chúukbesik u kuuche' ku bin túun	Kuuch, ts'o'okol u chúukbesik u kuuche' ku bin túun	NOCHANGE
Le chen k'uchuk u meesil,	Le chen k'uchuk u meesil,	NOCHANGE
Ts'o'ok túun u kíinsik'ob le  ba'alche'o'ob  beyo'	Ts'o'ok túun u kíinsik'ob le  ba'alche'o'ob  beyo'	NOCHANGE
Je'elo' ts'o'ok túune' ku múuch'ul le máako'ob ti' jump'éel kúuchil bey, wa te'ej esten le kúuchil ku yúuchulo'	Je'elo' ts'o'ok túune' ku múuch'ul le máako'ob ti' jump'éel kúuchil bey, wa te'ej esten le kúuchil ku yúuchulo'	NOCHANGE
Pues ku ya'alik le máako'ob tuun bino' , aaaj!!  je'ela' si le je'ela' chen juntúul chan xnuuk baka'an ku ya'aliko'ob bin	Pues ku ya'alik le máako'ob tuun bino' , aaaj!!  je'ela' si le je'ela' chen juntúul chan xnuuk baka'an ku ya'aliko'ob bin	NOCHANGE
Bey túuno' yaan a tsolik, tu láakal tak u flooresil, tak u esten u...	Bey túuno' yaan a tsolik, tu láakal tak u flooresil, tak u esten u...	NOCHANGE
Paalech ma'atáan a bin te'ela' ma'atáan a bin,	Paalech ma'atáan a bin te'ela' ma'atáan a bin,	NOCHANGE
Ju maye' yaan u tu... jo'okaajilo' yaan jump'éel chan naji'	Ju maye' yaan u tu... jo'okaajilo' yaan jump'éel chan naji'	NOCHANGE
Ka ti' tun ku kaajal a wilik jump'éel chan naj ti' jump'éel xa'an beya'	Ka ti' tun ku kaajal a wilik jump'éel chan naj ti' jump'éel xa'an beya'	NOCHANGE
Tumeen ku ya'alik ten in paalile', pero ba'axten, ilawile ma le maayaso'obo'	Tumeen ku ya'alik ten in paalile', pero ba'axten, ilawile ma le maayaso'obo'	NOCHANGE
Ka suunaj bin ka'atéen tu chan kajtalile'	Ka suunaj bin ka'atéen tu chan kajtalile'	NOCHANGE
Chen ba'ale' k'a'ana'an xan a wilike' wa	Chen ba'ale' k'a'ana'an xan a wilike' wa	NOCHANGE
Ku báajal u meyajto'ob túun, ichil u meyajtiko'obo'	Ku báajal u meyajto'ob túun, ichil u meyajtiko'obo'	NOCHANGE
U cha' u báao'	U cha' u báao'	NOCHANGE
De óox yáal ken a beetil, tumeen yaan u ts'ook bey le e...	De óox yáal ken a beetil, tumeen yaan u ts'ook bey le e...	NOCHANGE
Ku ya'ala'ale' mejen paalal tumeen leeti'o'obe'	Ku ya'ala'ale' mejen paalal tumeen leeti'o'obe'	NOCHANGE
Ts'o'okol túune' ka bin, ka máansik le kuurvaj tu'ux yaan le laguunao', ka máansik tun le bej je'elo'	Ts'o'okol túune' ka bin, ka máansik le kuurvaj tu'ux yaan le laguunao', ka máansik tun le bej je'elo'	NOCHANGE
Tu ts'ok óoxp'éel túun le bejo'	Tu ts'ok óoxp'éel túun le bejo'	NOCHANGE
Chen ba'axe' le te'ej biixo' ku meeta'al túun esten... te'ek táasche'o'	Chen ba'axe' le te'ej biixo' ku meeta'al túun esten... te'ek táasche'o'	NOCHANGE
U áabuelos in bauela, je'elo' ka bino'obe' ti' láaj ti'ano'ob túune'  ti' p'áat inalo'obe', ma' tu ka e'esaj u báaj bin ti' le eee...	U áabuelos in bauela, je'elo' ka bino'obe' ti' láaj ti'ano'ob túune'  ti' p'áat inalo'obe', ma' tu ka e'esaj u báaj bin ti' le eee...	NOCHANGE
Mina'an ti' taak'in, ka jo'op' u bin, ka jo'op' u bin.	Mina'an ti' taak'in, ka jo'op' u bin, ka jo'op' u bin.	NOCHANGE
Ti'al u beetik u muuchilo'ob	Ti'al u beetik u muuchilo'ob	NOCHANGE
Yaan a ts'áaik esten chocolaatée,	Yaan a ts'áaik esten chocolaatée,	NOCHANGE
Máan xan yaan maantekai' tumeen	Máan xan yaan maantekai' tumeen	NOCHANGE
Ma' u wol... ma' uwolik u báaj le juuch'o' yóok'sal ma' u yaantal u xiixel tumeen le k'óolo' k'a'ana'an jach ma'alob	Ma' u wol... ma' uwolik u báaj le juuch'o' yóok'sal ma' u yaantal u xiixel tumeen le k'óolo' k'a'ana'an jach ma'alob	NOCHANGE
Pero yóok'sal u pool le máako'ob sen jaanta'ab beyo'	Pero yóok'sal u pool le máako'ob sen jaanta'ab beyo'	NOCHANGE
Láaili' p'aatatak le ba'ax tu meyajto'ob  te'el k'iinilo'oba', yaan xan te'el  tuu...	Láaili' p'aatatak le ba'ax tu meyajto'ob  te'el k'iinilo'oba', yaan xan te'el  tuu...	NOCHANGE
Ts'o'okole' pues tumeen úuch ka'ache' le chen ila'ak a takmaj a iipile'	Ts'o'okole' pues tumeen úuch ka'ache' le chen ila'ak a takmaj a iipile'	NOCHANGE
Ku meetik jump'éel chan waaje' ku	Ku meetik jump'éel chan waaje' ku	NOCHANGE
Ken k'uchuk le nukuch máako'ob  jach a ti'ilo' bino', le yuum a ti'ile'exo'	Ken k'uchuk le nukuch máako'ob  jach a ti'ilo' bino', le yuum a ti'ile'exo'	NOCHANGE
U obstaakulo' yaan beyo', wa ba'ax  ti' bey ma' in takiko'one', u tojol.	U obstaakulo' yaan beyo', wa ba'ax  ti' bey ma' in takiko'one', u tojol.	NOCHANGE
Le e' boob wa ka jóok'oko' pues seguuro yaan u jaanta'alo'ob wa kaabal wa yóok'ol  bej yano'ob jaa...	Le e' boob wa ka jóok'oko' pues seguuro yaan u jaanta'alo'ob wa kaabal wa yóok'ol  bej yano'ob jaa...	NOCHANGE
Tu tukulto'ob xan uu...	Tu tukulto'ob xan uu...	NOCHANGE
Le tu láakal le taak'ino',	Le tu láakal le taak'ino',	NOCHANGE
Eeej... , tak túun  a k'uchul tu kaajil ju may	Eeej... , tak túun  a k'uchul tu kaajil ju may	NOCHANGE
K'a'al in áabueelae' ka jo'op' u ya'alik tun bin ti' le... le... le máako'ob bin  este le... le	K'a'al in áabueelae' ka jo'op' u ya'alik tun bin ti' le... le... le máako'ob bin  este le... le	NOCHANGE
Xla' xa'an,	Xla' xa'an,	NOCHANGE
Ku cha'abal u tajal le jkaax yéetel le xa'ak' je'elo'	Ku cha'abal u tajal le jkaax yéetel le xa'ak' je'elo'	NOCHANGE
Tumeen a woojel le píibo' yaan a meentik	Tumeen a woojel le píibo' yaan a meentik	NOCHANGE
Le ko'olelo'obo' je'el u béeytal u meyajtiko'ob ee... eee. chen wa ba'axo'ob je'ex	Le ko'olelo'obo' je'el u béeytal u meyajtiko'ob ee... eee. chen wa ba'axo'ob je'ex	NOCHANGE
Ka bin esten tu t'aabaj, tu t'abaj je'el bix yoojelil u ta'abal bin  chenba'ale' ka tu ta'abaj, tu t'abaj.	Ka bin esten tu t'aabaj, tu t'abaj je'el bix yoojelil u ta'abal bin  chenba'ale' ka tu ta'abaj, tu t'abaj.	NOCHANGE
Xi'ipal bino' ku ya'alik, ku sutik u báaj bine' ku yilik  bine'  -jach jaaj  ki bin ma' in wil ka'achili' . ki bin.	Xi'ipal bino' ku ya'alik, ku sutik u báaj bine' ku yilik  bine'  -jach jaaj  ki bin ma' in wil ka'achili' . ki bin.	NOCHANGE
Kux wa  ka sa'atakech , máax kun kanáantiklech?- ki bin ti'.	Kux wa  ka sa'atakech , máax kun kanáantiklech?- ki bin ti'.	NOCHANGE
Su láaj meyajtiko'ob	Su láaj meyajtiko'ob	NOCHANGE
Le bix u meeta'ale' ee...	Le bix u meeta'ale' ee...	NOCHANGE
U che'eile' yaan u bin ch'akbil	U che'eile' yaan u bin ch'akbil	NOCHANGE
Ken ts'o'okok túun bey u siistal le k'óolo', ba'ax ku beetik tuune' ku ki'	Ken ts'o'okok túun bey u siistal le k'óolo', ba'ax ku beetik tuune' ku ki'	NOCHANGE
Jach taaj leeti'o'obe' jach ku ts'áaik u yóol u t'ano'ob máak, leeti'o'obe' chen u ya'alobtech	Jach taaj leeti'o'obe' jach ku ts'áaik u yóol u t'ano'ob máak, leeti'o'obe' chen u ya'alobtech	NOCHANGE
Che ts'o'okok túun le bey uu...	Che ts'o'okok túun le bey uu...	NOCHANGE
A yáax beente le ets'kúunsajo',	A yáax beente le ets'kúunsajo',	NOCHANGE
Mejen suaavetak ken a ts'áao', yóok'sal u béeytal u jaantik	Mejen suaavetak ken a ts'áao', yóok'sal u béeytal u jaantik	NOCHANGE
Yaan a wa'alik ti' ma'alob k'iin taat,	Yaan a wa'alik ti' ma'alob k'iin taat,	NOCHANGE
U yooko'ob , u ka'bo'ob bin beya' laaj chowakyat bin u yíich'ak	U yooko'ob , u ka'bo'ob bin beya' laaj chowakyat bin u yíich'ak	NOCHANGE
Le beetik túun tene' tin wilik beyo' le beetik ma' jach ya'ab máax takiki'	Le beetik túun tene' tin wilik beyo' le beetik ma' jach ya'ab máax takiki'	NOCHANGE
Ee.. ku jóok'sa'al u yóom le u k'i'ik'el le jkaax bey ku jóok'ol ken looknaka'	Ee.. ku jóok'sa'al u yóom le u k'i'ik'el le jkaax bey ku jóok'ol ken looknaka'	NOCHANGE
Hasta bey u láaj tu'up... u p'áatal bey chen, chen chúuke'	Hasta bey u láaj tu'up... u p'áatal bey chen, chen chúuke'	NOCHANGE
Jela'an u kuxtal kex ti' jump'éelili' kaaj yan	Jela'an u kuxtal kex ti' jump'éelili' kaaj yan	NOCHANGE
Máako'ob maas úuchbentako'ob ti' to'on	Máako'ob maas úuchbentako'ob ti' to'on	NOCHANGE
Tumeen bey bino' ma'atáan bin u wekiko'ob bin, wa de kaaldo bine' ma'atáan bin u wekiko'ob bin le	Tumeen bey bino' ma'atáan bin u wekiko'ob bin, wa de kaaldo bine' ma'atáan bin u wekiko'ob bin le	NOCHANGE
Jenk'a'ajal tumeen nojoch ts'o'okole' wóolis.	Jenk'a'ajal tumeen nojoch ts'o'okole' wóolis.	NOCHANGE
Le biixa' ku beeta'al tumeen ku ya'ala'ale' esten	Le biixa' ku beeta'al tumeen ku ya'ala'ale' esten	NOCHANGE
Ka bin láaj juntarnajo'obe' ka bin tu ya'alo'obe' yaan u jóok'siko'ob bin le reeyo'	Ka bin láaj juntarnajo'obe' ka bin tu ya'alo'obe' yaan u jóok'siko'ob bin le reeyo'	NOCHANGE
Eeej... ku tsikbalta'ale' eeej... ku tskbalta'al beyo' es queee...	Eeej... ku tsikbalta'ale' eeej... ku tskbalta'al beyo' es queee...	NOCHANGE
U ts'íibo'ob tu p'ato'ob leeti'o'ob	U ts'íibo'ob tu p'ato'ob leeti'o'ob	NOCHANGE
Je'elo' bey ti'ano'ob  yáanal túun le  ee...	Je'elo' bey ti'ano'ob  yáanal túun le  ee...	NOCHANGE
Tumeen yaan k'iine'  tun ya'ala'alto'ne'	Tumeen yaan k'iine'  tun ya'ala'alto'ne'	NOCHANGE
Ka esten ka ts'áabal túun le waaj beyo' pues...	Ka esten ka ts'áabal túun le waaj beyo' pues...	NOCHANGE
Tu tséelo'ob, ta xno'oj yéetel ta xts'íie' láaj yaan naj	Tu tséelo'ob, ta xno'oj yéetel ta xts'íie' láaj yaan naj	NOCHANGE
Jku ya'alik, ku kano'ob le páarteriia ku ya'ala'alo' wa le ilaj paalo'	Jku ya'alik, ku kano'ob le páarteriia ku ya'ala'alo' wa le ilaj paalo'	NOCHANGE
Le jaanlil kool,	Le jaanlil kool,	NOCHANGE
Pero yaan bin juntúul máak bine', le kanáantik le reeyo',  le guaardiao',	Pero yaan bin juntúul máak bine', le kanáantik le reeyo',  le guaardiao',	NOCHANGE
Máax... ba'axe' ku yáax cho'ik te'ej juuch'	Máax... ba'axe' ku yáax cho'ik te'ej juuch'	NOCHANGE
Te'ej k'iino'ob bejla'aka' jach tu láakal ts'o'ok u láaj jelpajal	Te'ej k'iino'ob bejla'aka' jach tu láakal ts'o'ok u láaj jelpajal	NOCHANGE
Yíibil u... uuu... máantekail	Yíibil u... uuu... máantekail	NOCHANGE
Laak'o'ob , wa ma' yo'lal le meyaj je'ela',  in wa'ake' ma'atáan in k'ajóoltik tu láakal le mejen kaajo'obo', ma'at'áan in k'ajóoltik xan bix u sukbe'enilo'ob	Laak'o'ob , wa ma' yo'lal le meyaj je'ela',  in wa'ake' ma'atáan in k'ajóoltik tu láakal le mejen kaajo'obo', ma'at'áan in k'ajóoltik xan bix u sukbe'enilo'ob	NOCHANGE
Ka... máasewáale' ka jo'op' u bin u... u chan bin u...	Ka... máasewáale' ka jo'op' u bin u... u chan bin u...	NOCHANGE
Ma' utsi ts'o'olej tak u jo'olo'ob bejla'ake' láak wa'alakbal, ku láak wa'akúunsiko'ob	Ma' utsi ts'o'olej tak u jo'olo'ob bejla'ake' láak wa'alakbal, ku láak wa'akúunsiko'ob	NOCHANGE
Xtok'tuunichi', yaan jump'éel tuuniche' xtok' tuunich  ya'ala'ale', le beyo'	Xtok'tuunichi', yaan jump'éel tuuniche' xtok' tuunich  ya'ala'ale', le beyo'	NOCHANGE
Ts'oon	Ts'oon	NOCHANGE
Ya'ab wíinik tak le nukuch máako'ob bejala'k te'ej kjtalo' bey u beetiko'ob.	Ya'ab wíinik tak le nukuch máako'ob bejala'k te'ej kjtalo' bey u beetiko'ob.	NOCHANGE
Jump'éel dia, jump'éel k'iin beyo'	Jump'éel dia, jump'éel k'iin beyo'	NOCHANGE
-ba'an túun ken in meentej, bix ken in meentil ka in wil máax le yaan te'elo', máax le yan te'elo'	-ba'an túun ken in meentej, bix ken in meentil ka in wil máax le yaan te'elo', máax le yan te'elo'	NOCHANGE
Bejla'ake' u beeta'ale' jach máan ko'oj u beeta'al	Bejla'ake' u beeta'ale' jach máan ko'oj u beeta'al	NOCHANGE
Le waajo'.	Le waajo'.	NOCHANGE
Ku jóok'ol túun bin u páajtej bin máak te'ej yo' bejo'ob tun bin beyo', tumeen	Ku jóok'ol túun bin u páajtej bin máak te'ej yo' bejo'ob tun bin beyo', tumeen	NOCHANGE
Mejentak ma nuuktak u beenta'ali'.	Mejentak ma nuuktak u beenta'ali'.	NOCHANGE
Ku ya'aliko'obe' úuchka'ach bine' le máako'obo' chen	Ku ya'aliko'obe' úuchka'ach bine' le máako'obo' chen	NOCHANGE
Úuch bin ka'ache' leeti'o'obe'  u yilmo'ob bin le geerra de kaastas, ma' leeti'o'ob ilmili' u	Úuch bin ka'ache' leeti'o'obe'  u yilmo'ob bin le geerra de kaastas, ma' leeti'o'ob ilmili' u	NOCHANGE
Eee kin kuxtalo'on ichil le síinkretiismo ku ya'ala'alo' tumen pues	Eee kin kuxtalo'on ichil le síinkretiismo ku ya'ala'alo' tumen pues	NOCHANGE
Le ken ila'ak wel ts'o'ok u tajal le jkaakxo'	Le ken ila'ak wel ts'o'ok u tajal le jkaakxo'	NOCHANGE
Ku nijkúunsa'al le	Ku nijkúunsa'al le	NOCHANGE
Táan u ya'akko'ob klo. klo. klo klo, ki	Táan u ya'akko'ob klo. klo. klo klo, ki	NOCHANGE
Ee.. ba'axo'ob, máax kun ts'áaik	Ee.. ba'axo'ob, máax kun ts'áaik	NOCHANGE
E maayas, le úuchben maayaso'obo', le ma' senkech úuchbentako'obo', pues láaili' xan u tuukulo'obe' ma' kxu'ulsa'al	E maayas, le úuchben maayaso'obo', le ma' senkech úuchbentako'obo', pues láaili' xan u tuukulo'obe' ma' kxu'ulsa'al	NOCHANGE
Je'elo' ku ts'áabal túun, ku laj	Je'elo' ku ts'áabal túun, ku laj	NOCHANGE
Ku láaj ts'i'iktik le bak'o', chen ba'ale' téen in na'e'	Ku láaj ts'i'iktik le bak'o', chen ba'ale' téen in na'e'	NOCHANGE
Je'elo' pues tak bejla'ake', ma'atáan in na'atik túun bixij, bix je'el in, in...	Je'elo' pues tak bejla'ake', ma'atáan in na'atik túun bixij, bix je'el in, in...	NOCHANGE
Le buka'aj k'a'abéet wa nojoch wa chichan	Le buka'aj k'a'abéet wa nojoch wa chichan	NOCHANGE
Táan a wilikae' ya'abkach ba'alo'ob yaan te'ej paachilo' je'el u béeytal a jaanta'ale',	Táan a wilikae' ya'abkach ba'alo'ob yaan te'ej paachilo' je'el u béeytal a jaanta'ale',	NOCHANGE
Ku ts'áabal xan xchiináaj	Ku ts'áabal xan xchiináaj	NOCHANGE
Yóok'sal táan u báaxtik le baak le e...	Yóok'sal táan u báaxtik le baak le e...	NOCHANGE
Jaanal pixan, aaaj...	Jaanal pixan, aaaj...	NOCHANGE
Táan u jaantiko'ob pero ma'atáan bin u jaantiko'ob le jach a ti'ilo'	Táan u jaantiko'ob pero ma'atáan bin u jaantiko'ob le jach a ti'ilo'	NOCHANGE
Soldaadoso'  bin beyo', cha' in jan bini' ki bin	Soldaadoso'  bin beyo', cha' in jan bini' ki bin	NOCHANGE
Ku ts'aabal xa'an yóok'ole' ku ts'o'okole' ku mu'ukul,	Ku ts'aabal xa'an yóok'ole' ku ts'o'okole' ku mu'ukul,	NOCHANGE
Ee... noj meyaj, tumeen jump'éel k'iin een...  ko'ox a'alik	Ee... noj meyaj, tumeen jump'éel k'iin een...  ko'ox a'alik	NOCHANGE
Taasa'ale', ken taasa'ak bey le waaj te'ej	Taasa'ale', ken taasa'ak bey le waaj te'ej	NOCHANGE
Jump'éel waaj nojoch,	Jump'éel waaj nojoch,	NOCHANGE
Bey túuno' ee... tak ka úuch túun le geerra de kaastaso' ku ya'alik in noole', ku ya'alik in... in áabueelae'	Bey túuno' ee... tak ka úuch túun le geerra de kaastaso' ku ya'alik in noole', ku ya'alik in... in áabueelae'	NOCHANGE
Tumeen ma' chen waaji'.	Tumeen ma' chen waaji'.	NOCHANGE
Ee.. taanqueil ja'o' yaan ka máansik, yaan jump'éel chan loncheria te'elo'	Ee.. taanqueil ja'o' yaan ka máansik, yaan jump'éel chan loncheria te'elo'	NOCHANGE
Bey jach jaaj le xi'ipal bin u kaxtej  u t'aak'ine' tu ganarta túun bey leeti' ook te'el naj tu yilaj máax le ts'ajaan te'el najo'	Bey jach jaaj le xi'ipal bin u kaxtej  u t'aak'ine' tu ganarta túun bey leeti' ook te'el naj tu yilaj máax le ts'ajaan te'el najo'	NOCHANGE
Ka tu yóotaj u sut ka'atéen de wiinikil bin le... ee...	Ka tu yóotaj u sut ka'atéen de wiinikil bin le... ee...	NOCHANGE
U chan xéet' ja'as, leeti' le ku ts'áabal ich o'ocho',	U chan xéet' ja'as, leeti' le ku ts'áabal ich o'ocho',	NOCHANGE
Tumeen u ti'al mejen paalal tumeen le box kibo'obo', maas jach u ti'al le nukuch máako'obo'	Tumeen u ti'al mejen paalal tumeen le box kibo'obo', maas jach u ti'al le nukuch máako'obo'	NOCHANGE
Tumeen eee... le pixano'obo' ba'ax ku k'amiko'obo' leeti' le u chokol yooxol bino' le	Tumeen eee... le pixano'obo' ba'ax ku k'amiko'obo' leeti' le u chokol yooxol bino' le	NOCHANGE
Le ba'aba'al ku ya'ala'ale'	Le ba'aba'al ku ya'ala'ale'	NOCHANGE
U chuj u báao'ob bin.	U chuj u báao'ob bin.	NOCHANGE
Le wóolistak, yaane'e ee.. bey	Le wóolistak, yaane'e ee.. bey	NOCHANGE
Le ken súutuk de k'aak'asba'alil beya'	Le ken súutuk de k'aak'asba'alil beya'	NOCHANGE
Tumeen tene' ma' uts in wiliki'.	Tumeen tene' ma' uts in wiliki'.	NOCHANGE
Je'el u béeytal in wiko'one' jach jaaj , je'ex u kaxta'al xan le taak'ino'ob ti' le muka'ano'obo'	Je'el u béeytal in wiko'one' jach jaaj , je'ex u kaxta'al xan le taak'ino'ob ti' le muka'ano'obo'	NOCHANGE
Jach nukuch máako'ob ti' teech, teche' jach ni siquiera je'ex kin wa'alik ka'acho'	Jach nukuch máako'ob ti' teech, teche' jach ni siquiera je'ex kin wa'alik ka'acho'	NOCHANGE
Ku ya'alik túun le xi'ipalo' -jacha jaaj le ku ya'alik ten le chan xnuuka'- ki bin, ka jo'op' u jach tukultik	Ku ya'alik túun le xi'ipalo' -jacha jaaj le ku ya'alik ten le chan xnuuka'- ki bin, ka jo'op' u jach tukultik	NOCHANGE
U.. este u... píibil le waajo'.	U.. este u... píibil le waajo'.	NOCHANGE
Ka bin este... tu cha'aj le ts'oono' ka bin tu ts'onaj bin, tu tsayaj bin ti'	Ka bin este... tu cha'aj le ts'oono' ka bin tu ts'onaj bin, tu tsayaj bin ti'	NOCHANGE
Yéetel tu láakal le ba'alo'ob bey ts'áaba'  de ke le paalo' yaan	Yéetel tu láakal le ba'alo'ob bey ts'áaba'  de ke le paalo' yaan	NOCHANGE
Uts tin wich tumeen ku ts'áaik u páajtalil	Uts tin wich tumeen ku ts'áaik u páajtalil	NOCHANGE
Ku jo'ol a júuytik ma' ka'ana'n a cha'ik u táaka'lil',y  ma' k'ana'an xan a cha'aik u	Ku jo'ol a júuytik ma' ka'ana'n a cha'ik u táaka'lil',y  ma' k'ana'an xan a cha'aik u	NOCHANGE
Tumeen  píib le ba'ax ku k'u'ubulti'o'obo'	Tumeen  píib le ba'ax ku k'u'ubulti'o'obo'	NOCHANGE
Ken a t'ablaante le kiibo', le je'ela' je'el u béeytal a beetik, je'el u béeytal a beetik	Ken a t'ablaante le kiibo', le je'ela' je'el u béeytal a beetik, je'el u béeytal a beetik	NOCHANGE
Le maayaso'obo' jach aja'an u tuukulo'obe', pues tu kanaj bix u kanáantik u báao'ob	Le maayaso'obo' jach aja'an u tuukulo'obe', pues tu kanaj bix u kanáantik u báao'ob	NOCHANGE
Yuum k'ujo'ob ku ch'íilpoolta'al deesde úuchej tak te'el k'iinilo'oba' k-ike' beyo', tu'uxak kajalkajile'	Yuum k'ujo'ob ku ch'íilpoolta'al deesde úuchej tak te'el k'iinilo'oba' k-ike' beyo', tu'uxak kajalkajile'	NOCHANGE
Ka ts'áab u k'aaba' le kaajo' polinkin	Ka ts'áab u k'aaba' le kaajo' polinkin	NOCHANGE
Ka bin tu ya'alo'ob bin ti'e'e ba'an ts'o'ok u yiliko'ob.	Ka bin tu ya'alo'ob bin ti'e'e ba'an ts'o'ok u yiliko'ob.	NOCHANGE
Ma'atáan u ye'eskubáao'ob, wa ka xi'iken tin juunale' kin taasko'ob tu ka'atéene', tumeen yaan u taalo'ob tin paaach	Ma'atáan u ye'eskubáao'ob, wa ka xi'iken tin juunale' kin taasko'ob tu ka'atéene', tumeen yaan u taalo'ob tin paaach	NOCHANGE
Ts'o'okole' ka esten a...	Ts'o'okole' ka esten a...	NOCHANGE
Yéetel jump'íit k'uxub.	Yéetel jump'íit k'uxub.	NOCHANGE
U chíimpooltiko'ob le ku tukultik esten...	U chíimpooltiko'ob le ku tukultik esten...	NOCHANGE
Le te'el biix túuno'	Le te'el biix túuno'	NOCHANGE
Ti'al u meeto'ob bin le piraamideso'	Ti'al u meeto'ob bin le piraamideso'	NOCHANGE
Ma'atáan u líik'siko'ob bey  tak  ti' u máan u láak' le	Ma'atáan u líik'siko'ob bey  tak  ti' u máan u láak' le	NOCHANGE
Ku ts'o'okol túune' ken ya'at le beyo' pues ku k'axik yóok'sal ma' u	Ku ts'o'okol túune' ken ya'at le beyo' pues ku k'axik yóok'sal ma' u	NOCHANGE
Ti' leeti'o'obe' jach noj ba'al	Ti' leeti'o'obe' jach noj ba'al	NOCHANGE
Mi'in wooli' bey in tuukul bejla'ak te'ej k'iina', jach táaj ya'ab ba'ax ts'o'ok u k'éexel ichil le t'aano', ichil le tuukulo', ichil le miaatsilo', ya'ab ba'ax ku bin u jelpajal.	Mi'in wooli' bey in tuukul bejla'ak te'ej k'iina', jach táaj ya'ab ba'ax ts'o'ok u k'éexel ichil le t'aano', ichil le tuukulo', ichil le miaatsilo', ya'ab ba'ax ku bin u jelpajal.	NOCHANGE
Ti' le chíikul je'ela'le beetike' jach...	Ti' le chíikul je'ela'le beetike' jach...	NOCHANGE
Le chen ts'o'kok túun u beeta'al le bey yáax	Le chen ts'o'kok túun u beeta'al le bey yáax	NOCHANGE
Je'el u páajtal a ts'áak u láak' u juuch'e' yóoksal u tatal ma'alo'ob ti'al a ts'áaj te'ej	Je'el u páajtal a ts'áak u láak' u juuch'e' yóoksal u tatal ma'alo'ob ti'al a ts'áaj te'ej	NOCHANGE
Le je'elo' jump'éel ba'al tu... tu ta'akaj le eee.. máako'obo' pues ti' bin ma' bin  u chen u... sa'atalti'o'ob.	Le je'elo' jump'éel ba'al tu... tu ta'akaj le eee.. máako'obo' pues ti' bin ma' bin  u chen u... sa'atalti'o'ob.	NOCHANGE
Tumeen  pues, leti' bin u nojoch jala'ach... jump'éel	Tumeen  pues, leti' bin u nojoch jala'ach... jump'éel	NOCHANGE
Ba'ale' , ichil túun le je'elo', leeti'o'obe' ku ya'ak... ku  tsikbáalta'ale jach yaan u muuk'o'ob	Ba'ale' , ichil túun le je'elo', leeti'o'obe' ku ya'ak... ku  tsikbáalta'ale jach yaan u muuk'o'ob	NOCHANGE
Ti' bin jump'éel sajkabe' ti kajlaj tun bin le chan nuuk bino',	Ti' bin jump'éel sajkabe' ti kajlaj tun bin le chan nuuk bino',	NOCHANGE
A juuch', ka cha'aik jun wáal wele' ka na'atik buka'aj le	A juuch', ka cha'aik jun wáal wele' ka na'atik buka'aj le	NOCHANGE
Chokol beyo', k'abéet chokol bin u ts'áabal bin  te'ej meesao'	Chokol beyo', k'abéet chokol bin u ts'áabal bin  te'ej meesao'	NOCHANGE
Tumeen ka'ach bino' jach	Tumeen ka'ach bino' jach	NOCHANGE
Tumeen yaan u bino'ob xan	Tumeen yaan u bino'ob xan	NOCHANGE
Le esten le íinvernadeero ku ya'ala'alo', ts'o'oko tuune' ka k'uchul te'elo', jach tu aktáan beyo' ka ts'áaik, ka ts'áaik u chan vueeltaj beyo'	Le esten le íinvernadeero ku ya'ala'alo', ts'o'oko tuune' ka k'uchul te'elo', jach tu aktáan beyo' ka ts'áaik, ka ts'áaik u chan vueeltaj beyo'	NOCHANGE
Ts'o'okol túune' ku... ku esten u  ts'áabal ichil le piibo'	Ts'o'okol túune' ku... ku esten u  ts'áabal ichil le piibo'	NOCHANGE
Je'elo' ti' leeti'o'ob túune' leete'ej te'ej ee... nukuch túuto'ob ku beetiko'ob beyo'	Je'elo' ti' leeti'o'ob túune' leete'ej te'ej ee... nukuch túuto'ob ku beetiko'ob beyo'	NOCHANGE
Ku ts'áabali', yéetel kaafe', u gaayetail	Ku ts'áabali', yéetel kaafe', u gaayetail	NOCHANGE
Le k'uxubo' ku cha'ik u chakil ichil le...	Le k'uxubo' ku cha'ik u chakil ichil le...	NOCHANGE
Sáam u meente le píibo',	Sáam u meente le píibo',	NOCHANGE
U pantalo'obo'ob ku ya'ala'alo' wa u jol eexo'obo'.	U pantalo'obo'ob ku ya'ala'alo' wa u jol eexo'obo'.	NOCHANGE
Ma'alobtalo' ku jóok'sa'al	Ma'alobtalo' ku jóok'sa'al	NOCHANGE
Leeti'o'ob xane'	Leeti'o'ob xane'	NOCHANGE
Yéetel le...	Yéetel le...	NOCHANGE
Ti'al in bin tak te'elo', k'a'abéet yáax táanile' kin in...	Ti'al in bin tak te'elo', k'a'abéet yáax táanile' kin in...	NOCHANGE
Deesde jóok' tu sajkab bin bey  tu'ux ku kajtal bin bey tu'ux ku weenel bin beya'	Deesde jóok' tu sajkab bin bey  tu'ux ku kajtal bin bey tu'ux ku weenel bin beya'	NOCHANGE
Táan u yilik  táan u jaanta'ala u yiicham bin beyo	Táan u yilik  táan u jaanta'ala u yiicham bin beyo	NOCHANGE
Esten ti'al u beenta'al le jaanal pixan ku ya'ala'alo',	Esten ti'al u beenta'al le jaanal pixan ku ya'ala'alo',	NOCHANGE
Ka bin u yilo'ob bin ba'ax ts'o'ok u kaxtik leeti'.	Ka bin u yilo'ob bin ba'ax ts'o'ok u kaxtik leeti'.	NOCHANGE
Yaan le kya'ala kojunlich, yaan le kya'ala'al esten...	Yaan le kya'ala kojunlich, yaan le kya'ala'al esten...	NOCHANGE
Le beetike' je'el bix ten tu'ux kin meyaj way te'ej chíikula'	Le beetike' je'el bix ten tu'ux kin meyaj way te'ej chíikula'	NOCHANGE
Le muerte bey le máax	Le muerte bey le máax	NOCHANGE
Le ken yat u chan síistal beyo', leeti'e'e ts'o'ok xan  u xa'ak'tik le juuch' yéetel le en...	Le ken yat u chan síistal beyo', leeti'e'e ts'o'ok xan  u xa'ak'tik le juuch' yéetel le en...	NOCHANGE
Wa ka kan a beete'	Wa ka kan a beete'	NOCHANGE
Ba'ale' le túuchicho' yaane' ti' ku bisik yóok'oli', yaane'... yaane' ku ts'áabko'ob yáanal	Ba'ale' le túuchicho' yaane' ti' ku bisik yóok'oli', yaane'... yaane' ku ts'áabko'ob yáanal	NOCHANGE
Uu.. u chan... bix u ya'ala'al le...	Uu.. u chan... bix u ya'ala'al le...	NOCHANGE
Hasta yaan oorae' ka chan kojiko'ob beya' xen te'elo' pal kech ti' leeti'e'e ma'atáan u bin.	Hasta yaan oorae' ka chan kojiko'ob beya' xen te'elo' pal kech ti' leeti'e'e ma'atáan u bin.	NOCHANGE
Pues ku ya'aik wal, ku ya'alik bin le máak bino', pues ma'alob wale'	Pues ku ya'aik wal, ku ya'alik bin le máak bino', pues ma'alob wale'	NOCHANGE
Leeti'ili' u reeyilo' tu láakalo' , leeti' p'áate'	Leeti'ili' u reeyilo' tu láakalo' , leeti' p'áate'	NOCHANGE
Bey túun uchik u yila'al túun bino' eee... juntúul  chan este... chan xwáay tun bin	Bey túun uchik u yila'al túun bino' eee... juntúul  chan este... chan xwáay tun bin	NOCHANGE
Ba'ale' eee... ich túun le je'elo' bejla'ake' ol ts'o'ok u jela'antal	Ba'ale' eee... ich túun le je'elo' bejla'ake' ol ts'o'ok u jela'antal	NOCHANGE
Ch'a' jump'éel responsabilidad, u kanáant le ba'ax ku ye'esa'al ti' tumeen u noolo'	Ch'a' jump'éel responsabilidad, u kanáant le ba'ax ku ye'esa'al ti' tumeen u noolo'	NOCHANGE
Ka t'aan kex wa ma' k'a'abéet u p'áatal u yu'ubo'.	Ka t'aan kex wa ma' k'a'abéet u p'áatal u yu'ubo'.	NOCHANGE
Ba'ale' leeti'o'obe' ma' tu cha'o'obi', tu... ma' tu cha'o'ob u pe'ets'li' tu ta'ako'ob u t'anko'ob, bey u ya'alik in noolo', tu ta'ako'ob u t'anko'ob,	Ba'ale' leeti'o'obe' ma' tu cha'o'obi', tu... ma' tu cha'o'ob u pe'ets'li' tu ta'ako'ob u t'anko'ob, bey u ya'alik in noolo', tu ta'ako'ob u t'anko'ob,	NOCHANGE
Lelo' leti' le úuchben  máako'ob  ka'achilo'	Lelo' leti' le úuchben  máako'ob  ka'achilo'	NOCHANGE
Ka tu ya'alo'ob... le guaardiao' ka tu ya'alaj bin ti' le máako'obo'	Ka tu ya'alo'ob... le guaardiao' ka tu ya'alaj bin ti' le máako'obo'	NOCHANGE
U ti'al máako', bueeno a kimeo'ob n beyo',chen k'uchuko'obe' pues leeti'o'obe' táan u jaanalo'ob'ob bine' chen k'uchuko'obe'	U ti'al máako', bueeno a kimeo'ob n beyo',chen k'uchuko'obe' pues leeti'o'obe' táan u jaanalo'ob'ob bine' chen k'uchuko'obe'	NOCHANGE
Ee... esten ku bin u béeytal bin u jaantiko'ob te'ej bej bin táan u bino'obo'	Ee... esten ku bin u béeytal bin u jaantiko'ob te'ej bej bin táan u bino'obo'	NOCHANGE
Ku ya'ala'alo'	Ku ya'ala'alo'	NOCHANGE
Despuees, ti' ku páatali', tu juunal kun bin u sa'atla'ajal.	Despuees, ti' ku páatali', tu juunal kun bin u sa'atla'ajal.	NOCHANGE
Ts'o'okole' ku páana'al	Ts'o'okole' ku páana'al	NOCHANGE
Ch'ujuk waaj,	Ch'ujuk waaj,	NOCHANGE
Ka chan áalkabtik mi kex veeinte meetros wale', wa maas chan ya'ab	Ka chan áalkabtik mi kex veeinte meetros wale', wa maas chan ya'ab	NOCHANGE
Esten le nukuch máako'obo', le je'elo' puroo mejen xi'ipalaal ku meentik u muuchilo'ob tumeen mu'un béeytal mejen xch'upalaal,	Esten le nukuch máako'obo', le je'elo' puroo mejen xi'ipalaal ku meentik u muuchilo'ob tumeen mu'un béeytal mejen xch'upalaal,	NOCHANGE
Eee... ti' ku weenelo'ob túuni', beeta'an le naj je'elo' ti' u weenel tu láakal máak máax ku je'elel bey tu k'ab	Eee... ti' ku weenelo'ob túuni', beeta'an le naj je'elo' ti' u weenel tu láakal máak máax ku je'elel bey tu k'ab	NOCHANGE
O'och de esten yaan un k'aabo'	O'och de esten yaan un k'aabo'	NOCHANGE
Chen ba'axe' teen kin tukultik túun beyo' wa ya'ab máax ka u kan u meente'	Chen ba'axe' teen kin tukultik túun beyo' wa ya'ab máax ka u kan u meente'	NOCHANGE
Ya'ab máako'ob utstak u nook'o'ob bin yani' táan u yilik yaan taak'ini'	Ya'ab máako'ob utstak u nook'o'ob bin yani' táan u yilik yaan taak'ini'	NOCHANGE
Biniko'ob tu'ux yan bin u	Biniko'ob tu'ux yan bin u	NOCHANGE
Wa ka cha'ak in bine'- ki bin, -wa ka bin tin wetele'- ki bin, -ka bine'ex tin wetele' ma'atáan a... a... esten a...	Wa ka cha'ak in bine'- ki bin, -wa ka bin tin wetele'- ki bin, -ka bine'ex tin wetele' ma'atáan a... a... esten a...	NOCHANGE
Jach seguuro yaan bin u jaantik máak, jaan	Jach seguuro yaan bin u jaantik máak, jaan	NOCHANGE
Ken yat u ts'ookol u meenta'al le waajo'	Ken yat u ts'ookol u meenta'al le waajo'	NOCHANGE
Aasta mix ba'al kin k-kaxtiko'on waya', in kchan knaayo'one' ta'aytak u lúubul.	Aasta mix ba'al kin k-kaxtiko'on waya', in kchan knaayo'one' ta'aytak u lúubul.	NOCHANGE
Uuu... bin  u...	Uuu... bin  u...	NOCHANGE
Éem túun bin le óotsil	Éem túun bin le óotsil	NOCHANGE
Suuk u beeta'ale'	Suuk u beeta'ale'	NOCHANGE
Esten yóok'sal ma' u lúubul lelu'um yóok'ol beyo'	Esten yóok'sal ma' u lúubul lelu'um yóok'ol beyo'	NOCHANGE
Chen ba'ale je'ex u kreero'ob leeti'o'ob, je'ex u chíimpoolalo'obo', bey xan le to'ona' yaan wa ba'axo'ob  ku k'éexel ti'al leti' chen ba'axe' pues...	Chen ba'ale je'ex u kreero'ob leeti'o'ob, je'ex u chíimpoolalo'obo', bey xan le to'ona' yaan wa ba'axo'ob  ku k'éexel ti'al leti' chen ba'axe' pues...	NOCHANGE
Puro láaj, wa ka wile',  láaj u yich éespañooleso'ob yaan ti'	Puro láaj, wa ka wile',  láaj u yich éespañooleso'ob yaan ti'	NOCHANGE
Ku ya'alik bine' -le chan nuuko' ma' jaaji' chen táan u tusiken  yóok'sal ma' in kúchul  te'el tu'ux taak in k'uchulo'	Ku ya'alik bine' -le chan nuuko' ma' jaaji' chen táan u tusiken  yóok'sal ma' in kúchul  te'el tu'ux taak in k'uchulo'	NOCHANGE
Ti'al le je'elo' yaan a jóok'ol tu bejil	Ti'al le je'elo' yaan a jóok'ol tu bejil	NOCHANGE
Ich maayao'one' yáax ku yúuchul siibale' ku ts'o'okole' ku jaanta'al le ku p'áatalo', ma'ach u...	Ich maayao'one' yáax ku yúuchul siibale' ku ts'o'okole' ku jaanta'al le ku p'áatalo', ma'ach u...	NOCHANGE
U tsikbalo'ob bey u yiliko'ob le ka'ano'	U tsikbalo'ob bey u yiliko'ob le ka'ano'	NOCHANGE
Ts'o'okol túun u t'a'abala beyo' ku cha'abal u láaj t'a'abal le che'o'obo'	Ts'o'okol túun u t'a'abala beyo' ku cha'abal u láaj t'a'abal le che'o'obo'	NOCHANGE
Le xa'ano' ti' kun k'axbil le mejen túut, e mejen, mejen waajo'obo', e... e...	Le xa'ano' ti' kun k'axbil le mejen túut, e mejen, mejen waajo'obo', e... e...	NOCHANGE
Jump'éel diia antese' ku bin ch'akbil,	Jump'éel diia antese' ku bin ch'akbil,	NOCHANGE
Le tréeseo' leeti' le esten uu...	Le tréeseo' leeti' le esten uu...	NOCHANGE
Chen ba'axe' ka k'uch bin iknal juntúul le máako' ka jo'op' u káata'a u'uybil ti' ba'ax ku máan u meentej	Chen ba'axe' ka k'uch bin iknal juntúul le máako' ka jo'op' u káata'a u'uybil ti' ba'ax ku máan u meentej	NOCHANGE
Yóok'sal u béeytal u bisiko'ob.	Yóok'sal u béeytal u bisiko'ob.	NOCHANGE
Ts'o'okole' ka' ch'a'ik le bej ti'al a bimbal baantáaj chetumaal	Ts'o'okole' ka' ch'a'ik le bej ti'al a bimbal baantáaj chetumaal	NOCHANGE
Uu. ts'ook túun k'iin bey  ti'al le esten u bino'ob le...	Uu. ts'ook túun k'iin bey  ti'al le esten u bino'ob le...	NOCHANGE
Bejla'ake' eee..beyo' pues...	Bejla'ake' eee..beyo' pues...	NOCHANGE
Es ke leeti'ee' tu kanaj u jaante máak, tu sutaj u báaj de beyilo'	Es ke leeti'ee' tu kanaj u jaante máak, tu sutaj u báaj de beyilo'	NOCHANGE
Ku jaantiko'ob esten sopaa,	Ku jaantiko'ob esten sopaa,	NOCHANGE
Pues leeti' bin tsikbatik le nukuch máako'obo'	Pues leeti' bin tsikbatik le nukuch máako'obo'	NOCHANGE
Tene' ma'ach u meentik beyo', leeti'e'e maas uts yilik xane ' chen u meent le píio'obo'	Tene' ma'ach u meentik beyo', leeti'e'e maas uts yilik xane ' chen u meent le píio'obo'	NOCHANGE
Úuchben maayaso'ob, te'ej maayaso'ob je'ex le yaan te'ej k'iinilo'oba'	Úuchben maayaso'ob, te'ej maayaso'ob je'ex le yaan te'ej k'iinilo'oba'	NOCHANGE
La meetike' leeti'e ma'ach u ts'i'iktik,	La meetike' leeti'e ma'ach u ts'i'iktik,	NOCHANGE
-pero... bix kech bin -  ku ya'alik bin ti'	-pero... bix kech bin -  ku ya'alik bin ti'	NOCHANGE
Ts'o'okol túune'	Ts'o'okol túune'	NOCHANGE
Juntúul xi'ipal le reeyo' , ka tu suto'ob beyo'	Juntúul xi'ipal le reeyo' , ka tu suto'ob beyo'	NOCHANGE
Taal yéetel le chan paalo',	Taal yéetel le chan paalo',	NOCHANGE
Yáanal le mayak che' tu'ux ts'o'ok u láaj ta'asal bey ba'ax ku bisik yóok'ol le	Yáanal le mayak che' tu'ux ts'o'ok u láaj ta'asal bey ba'ax ku bisik yóok'ol le	NOCHANGE
Pues leeti'e'e yaan u béeytal u jaanal ma'alob.	Pues leeti'e'e yaan u béeytal u jaanal ma'alob.	NOCHANGE
Chúumukle... u  waajil el píib ken a meento'	Chúumukle... u  waajil el píib ken a meento'	NOCHANGE
Le je'exe ku ya'ala'al le  mo'ola'ayo'o to'on maayas	Le je'exe ku ya'ala'al le  mo'ola'ayo'o to'on maayas	NOCHANGE
Ma' je'el máaxak je'el u béeytal u  meyajtik tu láakale'	Ma' je'el máaxak je'el u béeytal u  meyajtik tu láakale'	NOCHANGE
Je'ex le kaaldo ku beeta'al ti'leetio'obo',	Je'ex le kaaldo ku beeta'al ti'leetio'obo',	NOCHANGE
Bix u cha'anil u kaajlo'ob, bey tsikbalo'ob ku meyajtiko'obo',  bix u kajlo'ob, bix u kuxtalo'ob	Bix u cha'anil u kaajlo'ob, bey tsikbalo'ob ku meyajtiko'obo',  bix u kajlo'ob, bix u kuxtalo'ob	NOCHANGE
Ka yaanlak ja' ka... te'ej le yuum cháak  le  nukuch máako'obo'	Ka yaanlak ja' ka... te'ej le yuum cháak  le  nukuch máako'obo'	NOCHANGE
Yaan túun xan a...	Yaan túun xan a...	NOCHANGE
Pero ku tsáaik, ku ts'áaik jump'éel u tuup.	Pero ku tsáaik, ku ts'áaik jump'éel u tuup.	NOCHANGE
Wa a k'áat bine' te'elo' yaan a kaxtik ya'abkach taak'ini', pero k'a'abéet a meyaj.	Wa a k'áat bine' te'elo' yaan a kaxtik ya'abkach taak'ini', pero k'a'abéet a meyaj.	NOCHANGE
Ku p'ayko'ob ti'al u ts'áao'ob k'áak' yéetel ja' ti'al u chakiko'ob	Ku p'ayko'ob ti'al u ts'áao'ob k'áak' yéetel ja' ti'al u chakiko'ob	NOCHANGE
Leeti'e'e ma'atáan u jaanal.	Leeti'e'e ma'atáan u jaanal.	NOCHANGE
Ku st'o'okole' ku láalik túun le máantekaj	Ku st'o'okole' ku láalik túun le máantekaj	NOCHANGE
Tak túun tu láak' kíin túune' ku yiliko'ob wa k'áax ja' wa ma' k'áax ja' tia'l u yaantal le nalo'	Tak túun tu láak' kíin túune' ku yiliko'ob wa k'áax ja' wa ma' k'áax ja' tia'l u yaantal le nalo'	NOCHANGE
Chen jump'éel táan piik le jach kóochtako'	Chen jump'éel táan piik le jach kóochtako'	NOCHANGE
Ba'ax túun meeta'ab túune' ka' tun beeta'ab le áak'ab naj túun bino' pues...	Ba'ax túun meeta'ab túune' ka' tun beeta'ab le áak'ab naj túun bino' pues...	NOCHANGE
Le chíimpoolal ti'al le ki'ichkelem kyuum, le kya'ako'ob	Le chíimpoolal ti'al le ki'ichkelem kyuum, le kya'ako'ob	NOCHANGE
Ku p'éep'ko'ob u k'u'uk'mel	Ku p'éep'ko'ob u k'u'uk'mel	NOCHANGE
Tumeen to'one' ya'ab le...	Tumeen to'one' ya'ab le...	NOCHANGE
Chen ba'axe' esten, bey biixo' ku ts'áabal	Chen ba'axe' esten, bey biixo' ku ts'áabal	NOCHANGE
Ti'al le masewáal kajtalilo'ono',	Ti'al le masewáal kajtalilo'ono',	NOCHANGE
Jaan,entoonses  te'el kaj jtúun  te'ej tu'ux úuch le ba'al túun bey te'el k'áaxil beyo' pues ka a'ala'ab tuune'	Jaan,entoonses  te'el kaj jtúun  te'ej tu'ux úuch le ba'al túun bey te'el k'áaxil beyo' pues ka a'ala'ab tuune'	NOCHANGE
U maasil túun bin le máako'obo', pues tu ganarto'ob u taak'in tumeen bey  tu yáanto'ob u	U maasil túun bin le máako'obo', pues tu ganarto'ob u taak'in tumeen bey  tu yáanto'ob u	NOCHANGE
Le ba'al tun je'ela' tu'ux taali', tumeen úuch ka'ache' le nukuch le maayao'obo' wa le nukuch maako'obo'	Le ba'al tun je'ela' tu'ux taali', tumeen úuch ka'ache' le nukuch le maayao'obo' wa le nukuch maako'obo'	NOCHANGE
Te che' bino'.	Te che' bino'.	NOCHANGE
Tak e le paaxo' yaan p'áatal tak te'ej k'iinilo'ob ichilo'ona' je'el le maaya páaxo'	Tak e le paaxo' yaan p'áatal tak te'ej k'iinilo'ob ichilo'ona' je'el le maaya páaxo'	NOCHANGE
Láayli'  xan beyo', yaan u meenta'al jump'éel nuxi'	Láayli'  xan beyo', yaan u meenta'al jump'éel nuxi'	NOCHANGE
Ma'ak tak ka tu u yoojel tu'ux u p'atmaj... tu'ux u ta'akmaj u báajo'ob bey in... áabueelao'ob... esten in... uu,... u áabueelos in	Ma'ak tak ka tu u yoojel tu'ux u p'atmaj... tu'ux u ta'akmaj u báajo'ob bey in... áabueelao'ob... esten in... uu,... u áabueelos in	NOCHANGE
Pues bey túuno' ti'al u jaanto'ob bin tu bejilo'ob  bin le esten le...	Pues bey túuno' ti'al u jaanto'ob bin tu bejilo'ob  bin le esten le...	NOCHANGE
Ku beeta'al túun le e...	Ku beeta'al túun le e...	NOCHANGE
Wóolistak u bisa'ale le xaawo', tu láakal le je'elo'	Wóolistak u bisa'ale le xaawo', tu láakal le je'elo'	NOCHANGE
Le p'uuj túuno' ti'al u yaantal u bak'el	Le p'uuj túuno' ti'al u yaantal u bak'el	NOCHANGE
Ka bin bini, ka ook te'el naj bino',	Ka bin bini, ka ook te'el naj bino',	NOCHANGE
Ichil túun le je'elo' ka jo'op' u bin u... uuu	Ichil túun le je'elo' ka jo'op' u bin u... uuu	NOCHANGE
Nukuch che'o'ob, mejen che'o'ob , kulche'o'ob  te'el bejo', yaan esten...	Nukuch che'o'ob, mejen che'o'ob , kulche'o'ob  te'el bejo', yaan esten...	NOCHANGE
Yéetel u wolisile' ku but'ik le k'óolo',	Yéetel u wolisile' ku but'ik le k'óolo',	NOCHANGE
Esten le jk'ujo'obo'	Esten le jk'ujo'obo'	NOCHANGE
Tak ti'al u k'éechel ti'al u bin te'ej tu najil le xook téelesekundaaria	Tak ti'al u k'éechel ti'al u bin te'ej tu najil le xook téelesekundaaria	NOCHANGE
Yéetel u ta'abil, ts'okole' ku kaxta'al tun jump'éel xa'an	Yéetel u ta'abil, ts'okole' ku kaxta'al tun jump'éel xa'an	NOCHANGE
Suuk u beeta'al tin kaajalo'oni'.	Suuk u beeta'al tin kaajalo'oni'.	NOCHANGE
Este le chan láak'tsilo'ob bin je'el bino' tu biso'ob juntúul chan paal	Este le chan láak'tsilo'ob bin je'el bino' tu biso'ob juntúul chan paal	NOCHANGE
In tsolik  ma'atáan u béeytal u beetike'.	In tsolik  ma'atáan u béeytal u beetike'.	NOCHANGE
Je'el u béeytal in taasik in na'e'- ki bin.	Je'el u béeytal in taasik in na'e'- ki bin.	NOCHANGE
Je'el bix yaan tak te'ej k'iinilo'oba', te'ej tu petenil yúukataana' jach ya'abach	Je'el bix yaan tak te'ej k'iinilo'oba', te'ej tu petenil yúukataana' jach ya'abach	NOCHANGE
Chu'ukul bey u yíicham bin beyo' ka bin	Chu'ukul bey u yíicham bin beyo' ka bin	NOCHANGE
Esten le..le..le k'áat chi' ti'al u yúuchul le	Esten le..le..le k'áat chi' ti'al u yúuchul le	NOCHANGE
Je'ex tu kaajil chan kaj véerakruuse' kaxta'an... le saantoso'ob ichil le... esten le... le saantos	Je'ex tu kaajil chan kaj véerakruuse' kaxta'an... le saantoso'ob ichil le... esten le... le saantos	NOCHANGE
Ku ts'o'okol túune' ka tasláantik esten e..u che'il,	Ku ts'o'okol túune' ka tasláantik esten e..u che'il,	NOCHANGE
Jaan,	Jaan,	NOCHANGE
Jaan, ku ya'alik bine' pajteni' le ba'alo' !, pajteni' le ba'alo'! ki bin ju..	Jaan, ku ya'alik bine' pajteni' le ba'alo' !, pajteni' le ba'alo'! ki bin ju..	NOCHANGE
Le túumben tuukulo'ob, ti' yan le	Le túumben tuukulo'ob, ti' yan le	NOCHANGE
K-u'uyko'on xan jach ki'ichelem u tsikbaltiko'ob, leti' le tutustsikbalo'obo', eúuchben	K-u'uyko'on xan jach ki'ichelem u tsikbaltiko'ob, leti' le tutustsikbalo'obo', eúuchben	NOCHANGE
Je'elo' ku ya'alike'  -pues ma'alo' teen ken ts'onikech- ki bin ti'	Je'elo' ku ya'alike'  -pues ma'alo' teen ken ts'onikech- ki bin ti'	NOCHANGE
Sinkueenta meetros te'elo' yaan jump'éel, jump'éel naji', jump'éel chan úuchben naj	Sinkueenta meetros te'elo' yaan jump'éel, jump'éel naji', jump'éel chan úuchben naj	NOCHANGE
Pues le je'elo' ya'ab waajo', pues le je'elo' jach máan nojoch u píibil,	Pues le je'elo' ya'ab waajo', pues le je'elo' jach máan nojoch u píibil,	NOCHANGE
Ti' u beetiko'ob le kruuso'	Ti' u beetiko'ob le kruuso'	NOCHANGE
In tsikbal yéetel le nukuch máako'obo', le xuuna'ano'obo', le táankelemo'ono', paalalo'obo', pues láayli' leti' xan kts'áako'on k'ajóoltbil	In tsikbal yéetel le nukuch máako'obo', le xuuna'ano'obo', le táankelemo'ono', paalalo'obo', pues láayli' leti' xan kts'áako'on k'ajóoltbil	NOCHANGE
Yóok'sal mix jump'íit u k'ebanil yaan,	Yóok'sal mix jump'íit u k'ebanil yaan,	NOCHANGE
Man t'anik mix máak, yaan a tu'ubsik tak a na', yaan a tu'ubsik  tak tu'ux , tu'ux yaanlajech ka'achil	Man t'anik mix máak, yaan a tu'ubsik tak a na', yaan a tu'ubsik  tak tu'ux , tu'ux yaanlajech ka'achil	NOCHANGE
T'a'ab te'ej úuchik u yúuchul le payalchi'o'o yaan a jóok'sik a t'ab tu jool a naay.	T'a'ab te'ej úuchik u yúuchul le payalchi'o'o yaan a jóok'sik a t'ab tu jool a naay.	NOCHANGE
Maátáan bin u jóok'ol te'ej najo'	Maátáan bin u jóok'ol te'ej najo'	NOCHANGE
Ma' bey u beeta'ali'	Ma' bey u beeta'ali'	NOCHANGE
Ts'o'okol túune' ka k'uchul mi kex treinta wa kuarenta meetrose' yane' esten ti yaan u	Ts'o'okol túune' ka k'uchul mi kex treinta wa kuarenta meetrose' yane' esten ti yaan u	NOCHANGE
Ya'akach ba'ate'el taambalil tu'ux táakpajo'ob	Ya'akach ba'ate'el taambalil tu'ux táakpajo'ob	NOCHANGE
A pantaloono'o, ken bey ti' leeti'a', paktej ken ti'	A pantaloono'o, ken bey ti' leeti'a', paktej ken ti'	NOCHANGE
Ch'up wey ko'on weenele'ki bin  pues... ko'ox na'akal tu k'ab le	Ch'up wey ko'on weenele'ki bin  pues... ko'ox na'akal tu k'ab le	NOCHANGE
Ma'atáan u béeytal a beetik ti'o'ob beya'. ma'atáan u béeytal a wa'alikti'o'ob beya'	Ma'atáan u béeytal a beetik ti'o'ob beya'. ma'atáan u béeytal a wa'alikti'o'ob beya'	NOCHANGE
Yóok'sal ma' xan uk'ul xani' pues	Yóok'sal ma' xan uk'ul xani' pues	NOCHANGE
Chan tsaj tun bino', táan bin u bino'ob te'ej chan kaajo'	Chan tsaj tun bino', táan bin u bino'ob te'ej chan kaajo'	NOCHANGE
Uuu.. kaxta'al tak u yuumil, ichil  le je'elo' ku kaxta'al	Uuu.. kaxta'al tak u yuumil, ichil  le je'elo' ku kaxta'al	NOCHANGE
Kex tumeen tu jaajil ya'ab máak kíimi, ya'ab máak sa'at u kuxtale	Kex tumeen tu jaajil ya'ab máak kíimi, ya'ab máak sa'at u kuxtale	NOCHANGE
Ku taal máako'ob k'ajóoltik, ku táal máako'ob xokik,	Ku taal máako'ob k'ajóoltik, ku táal máako'ob xokik,	NOCHANGE
Ka bin jo'op' u t'anik máak iik, ka bin jo'op' u t'anik u maasil máako'ob ku meyajo'ob te'el tu'ux yano'	Ka bin jo'op' u t'anik máak iik, ka bin jo'op' u t'anik u maasil máako'ob ku meyajo'ob te'el tu'ux yano'	NOCHANGE
Te'elba'ate'el táambal úucho', pues ya'abkach kaajo'ob xan p'áat láayli' yaan te'ej k'iio'oba' je'ex le xjo' tsuuk, je'el bix sakalaaka, je'el bix	Te'elba'ate'el táambal úucho', pues ya'abkach kaajo'ob xan p'áat láayli' yaan te'ej k'iio'oba' je'ex le xjo' tsuuk, je'el bix sakalaaka, je'el bix	NOCHANGE
Ma'atáan in kaxtik bix ken in tsolil ti' leeti'e' ba'axten ma k'a'abéet u tsáaik u tuup leeti'i'.	Ma'atáan in kaxtik bix ken in tsolil ti' leeti'e' ba'axten ma k'a'abéet u tsáaik u tuup leeti'i'.	NOCHANGE
K'ana'an u kanáanta'ale' mix tu'ux ka púuts'uk u chan ooxol.	K'ana'an u kanáanta'ale' mix tu'ux ka púuts'uk u chan ooxol.	NOCHANGE
Ken sáasak bey yaan a meentik le píiba' pues yaan a meentik a k'u'um	Ken sáasak bey yaan a meentik le píiba' pues yaan a meentik a k'u'um	NOCHANGE
U wolik u báai' ka'na'an a júuytik , a júuytik, a júuytik,	U wolik u báai' ka'na'an a júuytik , a júuytik, a júuytik,	NOCHANGE
Le buka'aj waaj ken a píibte' yaan a wilik buka'aj u p'iis	Le buka'aj waaj ken a píibte' yaan a wilik buka'aj u p'iis	NOCHANGE
Óoxtúul wa kantúul mejen paalalo'ob	Óoxtúul wa kantúul mejen paalalo'ob	NOCHANGE
Kpues ku ts'áabal bin le lelo' yóok'sal bine' leeti'o'ob táan u jaantiko'ob le je'elo'	Kpues ku ts'áabal bin le lelo' yóok'sal bine' leeti'o'ob táan u jaantiko'ob le je'elo'	NOCHANGE
Ku máan u ts'áaj vueeltas, ti'al aaaj, ti'al u chukbesik   uu..uuu	Ku máan u ts'áaj vueeltas, ti'al aaaj, ti'al u chukbesik   uu..uuu	NOCHANGE
Ts'o'ok u sa'atal.	Ts'o'ok u sa'atal.	NOCHANGE
Le úuchben máaseáal máako'obo' jach jaaj este... e... e... káastelaano'obo' jach jaaj k'ucho'ob, tumeen	Le úuchben máaseáal máako'obo' jach jaaj este... e... e... káastelaano'obo' jach jaaj k'ucho'ob, tumeen	NOCHANGE
Ku k'as... ku táakpajalo'obo', tumeen ti'al u meenta'al le payalchi'o' mu'un béeytal u táakpajal ko'oleli'	Ku k'as... ku táakpajalo'obo', tumeen ti'al u meenta'al le payalchi'o' mu'un béeytal u táakpajal ko'oleli'	NOCHANGE
Le ma'aj ko'ojtako', leeti' chen je'ex le ktakiko'ob  de boono'ob , de chen... jump'éel	Le ma'aj ko'ojtako', leeti' chen je'ex le ktakiko'ob  de boono'ob , de chen... jump'éel	NOCHANGE
Yaan a tasik u tuunichile'	Yaan a tasik u tuunichile'	NOCHANGE
Ma'ak béeykili'o' koomo jump'éel kaaj ma' jeets'el jump'éelilie'  túun bin u k'éexel kaada j'ab kumáane' túun k'éexel, túun k'éexel, pues...	Ma'ak béeykili'o' koomo jump'éel kaaj ma' jeets'el jump'éelilie'  túun bin u k'éexel kaada j'ab kumáane' túun k'éexel, túun k'éexel, pues...	NOCHANGE
Lee... yuumtsilo'obo',  yaan, ee... ajyuumtsilo', bey u ya'ala'alti'o' wa le aj	Lee... yuumtsilo'obo',  yaan, ee... ajyuumtsilo', bey u ya'ala'alti'o' wa le aj	NOCHANGE
Pues yéetel tu kanáantubáao'ob, yéetel tuu... jóok'o'ob xan	Pues yéetel tu kanáantubáao'ob, yéetel tuu... jóok'o'ob xan	NOCHANGE
Le... u láak' ba'ax xan kin wu'uyik tu yóok'sal xane' pues.. yook'sal le ba'alche'o'ob jach táaj  yaan xan	Le... u láak' ba'ax xan kin wu'uyik tu yóok'sal xane' pues.. yook'sal le ba'alche'o'ob jach táaj  yaan xan	NOCHANGE
Yaan u ba'alil u ni'o'ob ki ten,	Yaan u ba'alil u ni'o'ob ki ten,	NOCHANGE
Bey túuno' ts'o'ok u chokotal bey le...	Bey túuno' ts'o'ok u chokotal bey le...	NOCHANGE
Oo... yaane' ku meetiko'ob  wolis, yaane' ol ma' wolisi'	Oo... yaane' ku meetiko'ob  wolis, yaane' ol ma' wolisi'	NOCHANGE
Le chiichi' túun beyo' ka tu sutaj túun wíinikile'	Le chiichi' túun beyo' ka tu sutaj túun wíinikile'	NOCHANGE
Le ba'al ts'o'ok u yiliko'obo' leeti'o'ob bin u yuumil ka'ach le palaasio	Le ba'al ts'o'ok u yiliko'obo' leeti'o'ob bin u yuumil ka'ach le palaasio	NOCHANGE
Jaan... ka tu yilaj tun bin le ko'olej bin bey ts'o'ok  u	Jaan... ka tu yilaj tun bin le ko'olej bin bey ts'o'ok  u	NOCHANGE
Uu... uu.. yáalal le ka... le kaab	Uu... uu.. yáalal le ka... le kaab	NOCHANGE
Tumeen je'ex le de kaaldo' pues ma'atáan u béeytal u bisiko'ob je'el u wéekel ti'o'ob te'ej bejo'	Tumeen je'ex le de kaaldo' pues ma'atáan u béeytal u bisiko'ob je'el u wéekel ti'o'ob te'ej bejo'	NOCHANGE
Meyajo'ob te'ej k'áaxo', entoonses pues ya'abkach ba'alo'ob yaan ti'al	Meyajo'ob te'ej k'áaxo', entoonses pues ya'abkach ba'alo'ob yaan ti'al	NOCHANGE
Le ken sáasak beya' pues  le wíinko'ob eee...	Le ken sáasak beya' pues  le wíinko'ob eee...	NOCHANGE
Ba'ax máaxti' ken a ts'a'e' wa ti' nukuch máako'obe' booxtak	Ba'ax máaxti' ken a ts'a'e' wa ti' nukuch máako'obe' booxtak	NOCHANGE
Tumeen	Tumeen	NOCHANGE
Ts'o'okole' ku na'aksik nukuch tuunicho'obi', ku kanáantik xan ma'	Ts'o'okole' ku na'aksik nukuch tuunicho'obi', ku kanáantik xan ma'	NOCHANGE
Ba'ax túun ken a ts'áaj te'ej esten le... tu kúuchilo' te'ej	Ba'ax túun ken a ts'áaj te'ej esten le... tu kúuchilo' te'ej	NOCHANGE
Tumeen ka'achilo' ma' de manbil', chen juntarbil, chen ken a ts'áaj teech yéetel a tuukule' ka ts'áaik le ba'ax taak a ts'áako',	Tumeen ka'achilo' ma' de manbil', chen juntarbil, chen ken a ts'áaj teech yéetel a tuukule' ka ts'áaik le ba'ax taak a ts'áako',	NOCHANGE
Jaan, chan xwáay tun beyo'	Jaan, chan xwáay tun beyo'	NOCHANGE
Tak ti'al a jóok'sik túun u láak' jump'éel toopéej, chen a máanse le toope'o' yaan a ka'aj bin ti'al ka laanchaj a bine'	Tak ti'al a jóok'sik túun u láak' jump'éel toopéej, chen a máanse le toope'o' yaan a ka'aj bin ti'al ka laanchaj a bine'	NOCHANGE
Pues leeti'o'obe' láaili'  ku chíimpoltiko'obe', láaili' jeets'el tu tuukulo'obe'	Pues leeti'o'obe' láaili'  ku chíimpoltiko'obe', láaili' jeets'el tu tuukulo'obe'	NOCHANGE
Kaasi bey je'ex u ya'ala'al	Kaasi bey je'ex u ya'ala'al	NOCHANGE
Jeee... esten le boob túuno'  leeti' pues k'aas bin, leeti'e'  jun...	Jeee... esten le boob túuno'  leeti' pues k'aas bin, leeti'e'  jun...	NOCHANGE
E je'elo' tu juunal kun bin u	E je'elo' tu juunal kun bin u	NOCHANGE
U..rango beyo', yaane' góobernaantes yaane' lee...	U..rango beyo', yaane' góobernaantes yaane' lee...	NOCHANGE
U tuukul xan leeti'o'obe' je'el u bee... u beeytal kp'áatlo'on, kjéets'lo'on way tak lu'ume'	U tuukul xan leeti'o'obe' je'el u bee... u beeytal kp'áatlo'on, kjéets'lo'on way tak lu'ume'	NOCHANGE
Le ka ojéelya'an túun bey uchik u yaantal le jboob ku ya'ala'alo'	Le ka ojéelya'an túun bey uchik u yaantal le jboob ku ya'ala'alo'	NOCHANGE
Ka bin k'uch iknal le reey bino', ka bin a'ala'abti'e'e jach jaaj	Ka bin k'uch iknal le reey bino', ka bin a'ala'abti'e'e jach jaaj	NOCHANGE
Le ku meyajtik le ko'olelo'obo', eee... ku meyajtik le máako'obo' ma' tu cha'o'ob in máani'	Le ku meyajtik le ko'olelo'obo', eee... ku meyajtik le máako'obo' ma' tu cha'o'ob in máani'	NOCHANGE
Le xa'ano' ku t'a'abal túun.	Le xa'ano' ku t'a'abal túun.	NOCHANGE
K'aas u le' ja'aso', ka'ana'an xan a	K'aas u le' ja'aso', ka'ana'an xan a	NOCHANGE
K'iine' yaan ami', yaan k'iine' yaan ba'alo'obe' pues k'aa'an a tseliki',	K'iine' yaan ami', yaan k'iine' yaan ba'alo'obe' pues k'aa'an a tseliki',	NOCHANGE
Ko'ox t'aan yok'sal le ku ya'ala'al valoores wa	Ko'ox t'aan yok'sal le ku ya'ala'al valoores wa	NOCHANGE
Ka'ana'an u taasik ya'abkach si', ku meentik le nuxi' jool te'ej yóok'ol	Ka'ana'an u taasik ya'abkach si', ku meentik le nuxi' jool te'ej yóok'ol	NOCHANGE
Treese u yáalal le ka'ano', le sieteo' leeti' le yóok'ol kaabo', siete bin u yáalal le	Treese u yáalal le ka'ano', le sieteo' leeti' le yóok'ol kaabo', siete bin u yáalal le	NOCHANGE
Pues le piimo' ee... yaan u bisiko'ob bin, yaan u bisiko'ob u jaanto'ob.	Pues le piimo' ee... yaan u bisiko'ob bin, yaan u bisiko'ob u jaanto'ob.	NOCHANGE
