Ma' táan u bino'ob koonol tu k'íiwikil koonol	Ma' táan a bin koonol tu k'íiwikil koonol	PERSON:2_SI
Leti'obe' u k'aaba'obe'	Te'exe' a k'aaba'exe'	ASPECT:HAB;PERSON:2_PL
Ma' k'aja'ante'ex buka'aj a ja'abile'exi'	Ma' k'aja'anto'on buka'aj k ja'abili'	PERSON:1_PL
Yaan a suute'ex xook tu naajil xook	Yaan u suuto'ob tu naajil xook	PERSON:3_PL
Le ba'ax ken u ya'alo'ob tech ken a beete' leeti' ken a beetej	Le ba'ax ken u ya'alo'ob tech ken a beete' leeti' ken a beetej	NOCHANGE
Ma' kajakbal tin wotochi'	Ma' kajakbalech tin wotochi'	PERSON:2_SI
Taak in manik ya'abach ba'alo'ob tu k'íiwikil koonol	Je'el in manik ya'abach ba'alob tu k'íiwikil koonole'	ASPECT:INS
To'one' ma' jbúulo'on wáaj	To'one' jbúulo'on wáaj	TYPE:AFF;SUBTYPE:INT
Jach wáaj k'a'abéet u bin merkaado	Jach wáaj k'a'abéet in bin merkaado	PERSON:1_SI
Táan a báaxale'ex báaxal tu naajil báaxal	Táan u báaxalo'ob tu naajil báaxal	PERSON:3_PL
Táan u meyajo'ob ich kool	Táan u meyaj tu kool	PERSON:3_SI
Wa chak ken u meente' pues ku	Wa chak ken u meente' pues ku	NOCHANGE
Ka'ana'an u taasik ya'abkach si' ku meentik le nuxi' jool te'ej yóok'ol	Ka'ana'an u taasik ya'abkach si' ku meentik le nuxi' jool te'ej yóok'ol	NOCHANGE
K'a'abéet in manik ya'abach ba'alob tu k'íiwikil koonol	Suuk in manik ya'abach ba'alob tu k'íiwikil koonol	ASPECT:CUS
Táan a suut tu naajil xook	Táan u suut tu naajil xook	PERSON:3_SI
Ma' ts'oka'an u beeli'	Ma' ts'oka'an a beele'exi'	PERSON:3_PL
Le chan paalo' tumeen ku ya'ala'ale' yaan ku taas taasbil u meenta'alo'ob	Le chan paalo' tumeen ku ya'ala'ale' yaan ku taas taasbil u meenta'alo'ob	NOCHANGE
U k'iinil le jaanal pixano' u ja'abl	U k'iinil le jaanal pixano' u ja'abl	NOCHANGE
To'one' k k'aaba'e'	Teche' a k'aaba'e'	ASPECT:HAB;PERSON:2_SI
Taak in suut koonol merkaado	Táant in suut koonol merkaadoe'	ASPECT:IMM;TENSE:PAS_SIM
Bix u cha'anil u kaajlo'ob bey tsikbalo'ob ku meyajtiko'obo'  bix u kajlo'ob bix u kuxtalo'ob	Bix u cha'anil u kaajlo'ob bey tsikbalo'ob ku meyajtiko'obo'  bix u kajlo'ob bix u kuxtalo'ob	NOCHANGE
To'one' áak'ab wáaj k bin tu k'íiwikil koonol	Leti'e' áak'ab wáaj ku bin tu k'íiwikil koonol	PERSON:3_SI
Káaj in bin koonol tu k'íiwikil koonol	Táant in bin koonol tu k'íiwikil koonole'	ASPECT:IMM
Láayli'  xan beyo' yaan u meenta'al jump'éel nuxi'	Láayli'  xan beyo' yaan u meenta'al jump'éel nuxi'	NOCHANGE
To'one' k u'uyik wáaj ooxol	To'one' k u'uyik wáaj ooxol	PERSON:1_PL
Leti'e' u k'aaba'e'	To'one' k k'aaba'e'	ASPECT:HAB;PERSON:1_PL
Ma' tan u k'íilkabi'	Ma' tan k k'íilkabi'	PERSON:1_PL
Táan wáaj a bine'ex koonol tu k'íiwikil koonol	Táan wáaj k bin koonol tu k'íiwikil koonol	PERSON:1_PL
Táant in suut koonol merkaadoe'	Káaj in suut koonol merkaado	ASPECT:BEG;TENSE:PAS_SIM
Máax yéetel k'a'abéet a bin koonol tu kúuchil báaxal	Máax yéetel suuk a bin koonol tu kúuchil báaxal	SUBTYPE:DEC;ASPECT:CUS
Ta núukaje'ex buka'aj a ja'abile'ex	Tu núukaj buka'aj u ja'abilo'ob	PERSON:3_PL
Ma' tin wilike'ex tu k'íiwikil koonol	Ma' ta wiliken tu k'íiwikil koonol	PERSON:2_SI
k'a'abéet in bin koonol tu k'íiwikil koonol	Kin bin koonol tu k'íiwikil koonol	ASPECT:HAB
Ta'aytak k chukik u ja'abil	Ta'aytak u chukiko'ob u ja'abil	PERSON:3_PL
K'a'abéet in manik suuts' pak'áal tu k'íiwikil koonol	Kin manik nikte'ob tu k'íiwikil koonol	ASPECT:HAB
Te'exe' jbúule'ex	Leti'e' jbúulij	PERSON:3_SI
K'a'abéet in suut koonol merkaado	Táant in suut koonol merkaadoe'	ASPECT:IMM;TENSE:PAS_SIM
Sáansamal ku bin merkaado	Sáansamal ka bin merkaado	PERSON:2_SI
Teche' Yaan tech xook ti' español	To'onen yaanto'on xook ti' español	PERSON:1_PL
Ma' tan u k'íilkabo'obi'	Ma' tan k k'íilkabi'	PERSON:1_PL
Jayp'éel k'iino'ob ku bin merkaado	Jayp'éel k'iino'ob ku bino'ob merkaado	PERSON:3_PL
Táan wáaj u boon tu naajil xook	Táan wáaj a boone'ex xook tu naajil xook	PERSON:2_PL
Te'exe' a jatsmajaba'ex	Teche' a jatsmajabáaj	PERSON:2_SI
Ts'o'ok túun u kíinsik'ob le  ba'alche'o'ob  beyo'	Ts'o'ok túun u kíinsik'ob le  ba'alche'o'ob  beyo'	NOCHANGE
Yaan wáaj k bin koonol tu k'íiwikil koonol	Yaan wáaj u bin koonol tu k'íiwikil koonol	PERSON:3_SI
Kin in suut koonol merkaado	K'a'abéet in suut koonol merkaado	ASPECT:OBL
Le waajo'	Le waajo'	NOCHANGE
Ma' ts'oka'an u beelo'obi'	Ma' ts'oka'an a beele'exi'	PERSON:3_PL
Táan a boon tu naajil xook	Táan k boon tu naajil xook	PERSON:1_PL
Leti'obe' u jatsmajuba'ob	Teche' a jatsmajabáaj	PERSON:2_SI
Kex tumeen tu jaajil ya'ab máak kíimi ya'ab máak sa'at u kuxtale	Kex tumeen tu jaajil ya'ab máak kíimi ya'ab máak sa'at u kuxtale	NOCHANGE
Ma' tu yu'ubik ooxoli'	Ma' tu yu'ubiko'ob ooxoli'	PERSON:3_PL
Yaan wáaj a bin koonol tu k'íiwikil koonol	Yaan wáaj u bin koonol tu k'íiwikil koonol	PERSON:3_SI
Tek núukaj buka'aj k ja'abil	Ta núukaj buka'aj a ja'abil	PERSON:2_SI
Ma' táan a bin ich kooli'	Ma' táan u bino'ob ich kooli'	PERSON:3_PL
Ma' wáaj ta bine'ex merkaado	Ma' wáaj tu bino'ob merkaado	PERSON:3_PL
Yaan u xooko'ob tu naajil xook	Yaan a xooke'ex xook tu naajil xook	PERSON:2_PL
Teche' ajkoonolech ichil merkaado	To'one' ajkoonolo'on ichil merkaado	PERSON:1_PL
Ook'in u bino'ob k'íiwikil koonol	Ook'in a bine'ex k'íiwikil koonol	PERSON:2_PL
Leti'e' ti' u taali'	To'one' ti' in taalo'oni'	PERSON:1_PL
Maas úuchbe ti' teeche' yaan a	Maas úuchbe ti' teeche' yaan a	NOCHANGE
Ma' k'aja'ante'ex buka'aj a ja'abile'exi'	Ma' k'aja'anti' buka'aj u ja'abili'	PERSON:3_SI
To'one' ajkoonolo'on	Teche' ajkoonolech	PERSON:2_SI
Táan u kaxtik a najil	Táan ek kaxtik a najil	PERSON:1_PL
Leti'e' ku bin páak ich kool	Teche' ka bin páak ich kool	PERSON:2_SI
Yóok'sal u béeytal u bisiko'ob	Yóok'sal u béeytal u bisiko'ob	NOCHANGE
Ma' u yojel u ja'abili'	Ma' a wojel u ja'abili'	PERSON:2_SI
Máax yéetel je'el a bin koonol tu kúuchil báaxale'	Máax yéetel suuk a bin koonol tu kúuchil báaxal	SUBTYPE:DEC;ASPECT:CUS
Teche' a jatsmajabáaj	Te'exe' a jatsmajaba'ex	PERSON:2_PL
Sáansamal ku bino'ob merkaado	Sáansamal ka bin merkaado	PERSON:2_SI
Jach wáaj k'a'abéet in bin merkaado	Jach wáaj k'a'abéet u bino'ob merkaado	PERSON:3_PL
Táan wáaj k bin koonol tu k'íiwikil koonol	Táan wáaj u bin koonol tu k'íiwikil koonol	PERSON:3_SI
Ma' k'aja'anti'ob buka'aj u ja'abilo'obi'	Ma' k'aja'anto'on buka'aj k ja'abili'	PERSON:1_PL
Ta'aytak u chukik u ja'abil	Ta'aytak u chukiko'ob u ja'abil	PERSON:3_PL
Lela' bin u jelpesik ya'ab ba'ax ichil le miaatsilo' tumen pues	Lela' bin u jelpesik ya'ab ba'ax ichil le miaatsilo' tumen pues	NOCHANGE
Ook'in u bino'ob tu koolo'ob	Ook'in a bin ich kool	PERSON:2_SI
Te'exe' yaante'ex xook ti' español	Teche' Yaan tech xook ti' español	PERSON:2_SI
Suuk in suut koonol merkaado	Yaan in suut koonol merkaado	ASPECT:COM
Tan k k'íilkab	Tan a k'íilkabe'ex	PERSON:2_PL
To'onen yaanto'on u áanalte'il k xook matemáticas	Te'exe' yaante'ex u áanalte'il u xookil matemáticas	PERSON:2_PL
To'one' k u'uyik wáaj ooxol	Te'exe' ka wu'uyike'ex wáaj ooxol	PERSON:2_PL
Láayli' xan	Láayli' xan	NOCHANGE
Te'exe' bine'ex áalkab te' taam paarkéeo'	Leti'e' bin áalkab te' taam paarkéeo'	PERSON:3_SI
Suuk wáaj in jóok'ol koonol tu k'íiwikil koonol	Kin jóok'ol wáaj koonol tu k'íiwikil koonol	ASPECT:HAB;TENSE:PRE_SIM
To'one' ti' kajakbalo'on tu yotoche'	Te'exe' ti' kajakbale'ex tu yotoche'	PERSON:2_PL
Tu núukaj buka'aj u ja'abil	Tu núukaj buka'aj u ja'abilo'ob	PERSON:3_PL
Sáansamal ka bine'ex merkaado	Sáansamal ku bino'ob merkaado	PERSON:3_PL
Ook'in a bine'ex merkaado	Ook'in u bino'ob merkaado	PERSON:3_PL
Teche' a k'aaba'e'	Te'exe' a k'aaba'exe'	ASPECT:HAB;PERSON:2_PL
K'a'abéet in manik ya'abach ba'alob tu k'íiwikil koonol	Je'el in manik ya'abach ba'alob tu k'íiwikil koonole'	ASPECT:INS
Ma' ta wu'uyik ooxoli'	Ma' tu yu'ubik ooxoli'	PERSON:3_SI
Leti'e' jbúulij	To'one' jbúulo'on	PERSON:1_PL
Suuk in wilikech te' tu kúuchil báaxalo'	K'a'abéet in wilikech te' tu kúuchil báaxalo'	ASPECT:OBL
Maanal k'aasil bix ken takil ba'al bey a wóol ti' chojokbal a ta' tu paach a	Maanal k'aasil bix ken takil ba'al bey a wóol ti' chojokbal a ta' tu paach a	NOCHANGE
Bey a wóol ku t'aan bin te'el mas taamil bino'	Bey a wóol ku t'aan bin te'el mas taamil bino'	NOCHANGE
To'one' k jatsmajekbáaj	Teche' a jatsmajabáaj	PERSON:2_SI
Ma' tin wilike'ex tu k'íiwikil koonol	Ma' tin wilikech tu k'íiwikil koonol	PERSON:1_SI
Ch'a' jump'éel responsabilidad u kanáant le ba'ax ku ye'esa'al ti' tumeen u noolo'	Ch'a' jump'éel responsabilidad u kanáant le ba'ax ku ye'esa'al ti' tumeen u noolo'	NOCHANGE
Yaan wáaj u manik u najil	Mix tu manik u najil	TYPE:NEG;SUBTYPE:DEC;PERSON:3_SI
Táan wáaj u boono'ob tu naajil xook	Táan wáaj u boon tu naajil xook	PERSON:3_SI
Táan a suut tu naajil xook	Táan k suut tu naajil xook	PERSON:1_PL
Leti'obe' ti' kajakbalo'ob tu yotoche'	Te'exe' ti' kajakbale'ex tu yotoche'	PERSON:2_PL
Leti'e' ma' táan u bin koonol tu k'íiwikil koonol	Ma' táan u bino'ob koonol tu k'íiwikil koonol	PERSON:3_PL
Te'exe' bine'ex áalkab te' taam paarkéeo'	Leti'o'obe' bino'ob áalkab te' taam paarkéeo'	PERSON:3_PL
Ma' u yojelo'ob u ja'abili'	Ma' u yojel u ja'abili'	PERSON:3_SI
Suuk in wilikech te' tu kúuchil báaxalo'	Kin wilikech te' tu kúuchil báaxalo'	ASPECT:HAB
Tan u k'íilkabo'ob	Tan a k'íilkab	PERSON:2_SI
Ku jaantiko'ob le ba'alo'ob ku ts'áabal ichil kex chen jun chan xéet' k'úum	Ku jaantiko'ob le ba'alo'ob ku ts'áabal ichil kex chen jun chan xéet' k'úum	NOCHANGE
Jbine'ex yéetel a éetailo'ob merkaado	Jbinech yéetel a éetailo'ob merkaado	PERSON:2_SI
Ma' táan a bine'ex koonol tu k'íiwikil koonol	Ma' táan k bin koonol tu k'íiwikil koonol	PERSON:1_PL
To'one' ajkoonolo'on	Leti'e' ajkoonol	PERSON:3_SI
Jayp'éel k'iino'ob ku bino'ob merkaado	Jayp'éel k'iino'ob ka bine'ex merkaado	PERSON:2_PL
Jayp'éel k'iino'ob ku bin tu k'íiwikil koonol	Jayp'éel k'iino'ob ka bine'ex tu k'íiwikil koonol	PERSON:2_PL
Ma' ta wu'uyik ooxoli'	Ma' tu yu'ubiko'ob ooxoli'	PERSON:3_PL
Táan wáaj u bin koonol tu k'íiwikil koonol	Táan wáaj k bin koonol tu k'íiwikil koonol	PERSON:1_PL
Leti'obe' ts'oka'an wáaj u beelo'ob	Teche' ts'oka'an wáaj a beel	PERSON:2_SI
Le wóolistak yaane'e ee bey	Le wóolistak yaane'e ee bey	NOCHANGE
Ya'abkach múulo'b tu líik'sláanto'ob leeti'o'obe' tu'ux tu p'ato'ob to'one' leeti' le  ba'axo'ob ayik'alkúuntik leti' leee	Ya'abkach múulo'b tu líik'sláanto'ob leeti'o'obe' tu'ux tu p'ato'ob to'one' leeti' le  ba'axo'ob ayik'alkúuntik leti' leee	NOCHANGE
Táan wáaj u bino'ob koonol tu k'íiwikil koonol	Táan wáaj a bine'ex koonol tu k'íiwikil koonol	PERSON:2_PL
Ma' táan ek bin ich kooli'	Ma' táan u bin ich kooli'	PERSON:3_SI
Taak in bin koonol tu k'íiwikil koonol	Kin bin koonol tu k'íiwikil koonol	ASPECT:HAB
Ma' ts'oka'an u beeli'	Ma' ts'oka'an u beelo'obi'	PERSON:3_PL
Leti'obe' táan u bino'ob koonol tu k'íiwikil koonol	Te'exe' táan a bine'ex koonol tu k'íiwikil koonol	PERSON:2_PL
Yaan u báaxal tu naajil báaxal	Yaan u báaxalo'ob tu naajil báaxal	PERSON:3_PL
Jobon hasta chojokbal ti'	Jobon hasta chojokbal ti'	NOCHANGE
Uuuu che káajak u payalchi'o'ob túun bey le nukuch máako'obo'	Uuuu che káajak u payalchi'o'ob túun bey le nukuch máako'obo'	NOCHANGE
Ku esten u tu'upul	Ku esten u tu'upul	NOCHANGE
Yaan wáaj in jóok'ol koonol tu k'íiwikil koonol	Ts'o'ok wáaj in jóok'ol koonol tu k'íiwikil koonol	ASPECT:TER;TENSE:PAS_SIM
Ka bin tu kaxtaj bin uu jun xóot' nook' bine'	Ka bin tu kaxtaj bin uu jun xóot' nook' bine'	NOCHANGE
Taak in suut koonol merkaado	Suuk in suut koonol merkaado	ASPECT:CUS
Ma' taak in bin maan tu k'íiwikil koonoli'	Ma' suuk in bin maan tu k'íiwikil koonoli'	ASPECT:CUS
Te'exe' ti' a taale'exi'	To'one' ti' in taalo'oni'	PERSON:1_PL
Ma' táan a bine'ex koonol tu k'íiwikil koonol	Ma' táan u bino'ob koonol tu k'íiwikil koonol	PERSON:3_PL
Ma' táan a bin ich kooli'	Ma' táan u bin ich kooli'	PERSON:3_SI
Yaan a suute'ex xook tu naajil xook	Yaan u suut tu naajil xook	PERSON:3_SI
Yaan wáaj a bin ich kool	Yaan wáaj ek bin ich kool	PERSON:1_PL
Le píibil waajo' ti'al u beeta'ale'	Le píibil waajo' ti'al u beeta'ale'	NOCHANGE
Táan wáaj u xook tu naajil xook	Táan wáaj a xooke'ex xook tu naajil xook	PERSON:2_PL
Ku ya'aliko'obe' - pues yaan kséegerkko'on yóok'sal k-iliko'on tu'ux bini'-  ku ya'aliko'ob bin ka jo'op' u bin u séegertiko'ob bin	Ku ya'aliko'obe' - pues yaan kséegerkko'on yóok'sal k-iliko'on tu'ux bini'-  ku ya'aliko'ob bin ka jo'op' u bin u séegertiko'ob bin	NOCHANGE
Ku ts'o'okol túune' ku	Ku ts'o'okol túune' ku	NOCHANGE
Pues leeti'e'e yaan u béeytal u jaanal ma'alob	Pues leeti'e'e yaan u béeytal u jaanal ma'alob	NOCHANGE
Ti' bin jump'éel sajkabe' ti kajlaj tun bin le chan nuuk bino'	Ti' bin jump'éel sajkabe' ti kajlaj tun bin le chan nuuk bino'	NOCHANGE
Táan wáaj k bin koonol tu k'íiwikil koonol	Táan wáaj u bin koonol tu k'íiwikil koonol	PERSON:3_SI
Yóok'sal mix jump'íit u k'ebanil yaan	Yóok'sal mix jump'íit u k'ebanil yaan	NOCHANGE
Yaan in bisik ch'ujuko'ob tu k'íiwikil koonol	Yaan in k'a'aytik ch'ujuko'ob tu k'íiwikil koonol	MARK:T
Táan wáaj a bine'ex koonol merkaado	Táan wáaj u bino'ob koonol merkaado	PERSON:3_PL
Mix leti'ob kajakbalo'ob ta wotoch	Mix leti' kajakbal ta wotoch	PERSON:3_SI
Mix te'ex kajakbale'ex ta wotoch	Mix leti'ob kajakbalo'ob ta wotoch	PERSON:3_PL
Jbinech yéetel a éetailo'ob tu k'íiwikil koonol	Leti'obe' jbino'ob yéetel u éetailo'ob tu k'íiwikil koonol	PERSON:3_PL
Ma' tek u'uyik wáaj ooxoli'	Ma' tu yu'ubiko'ob wáaj ooxoli'	PERSON:3_PL
To'one' ti' in taalo'oni'	Teche' ti' a taali'	PERSON:2_SI
Ma' ta wiliken tu k'íiwikil koonol	Ma' tin wilikech tu k'íiwikil koonol	PERSON:1_SI
te'exe' ka báaxale'ex tu naajil xook	to'one' k báaxal tu naajil xook	PERSON:1_PL
Pero yóok'sal u pool le máako'ob sen jaanta'ab beyo'	Pero yóok'sal u pool le máako'ob sen jaanta'ab beyo'	NOCHANGE
Tek núukaj buka'aj k ja'abil	Ta núukaje'ex buka'aj a ja'abile'ex	PERSON:2_PL
Táan u báaxal tu naajil báaxal	Táan k báaxal tu naajil báaxal	PERSON:1_PL
Tu kaxko'ob a najil	Tan k kaxtik a najil	PERSON:1_PL
Táan k báaxal tu naajil báaxal	Táan u báaxal tu naajil báaxal	PERSON:3_SI
Yaan wáaj u bin koonol tu k'íiwikil koonol	Yaan wáaj a bin koonol tu k'íiwikil koonol	PERSON:2_SI
Je'el in manik ya'abach ba'alob tu k'íiwikil koonole'	Táant in manik ya'abach ba'alo'ob tu k'íiwikil koonole'	ASPECT:IMM;TENSE:PAS_SIM
U maama bino' tu jóok'saj bin te'el chan kajtalil bin tu'ux yano'obo'	U maama bino' tu jóok'saj bin te'el chan kajtalil bin tu'ux yano'obo'	NOCHANGE
Jaan ka tu biso'ob túun bin le chan paal ku ya'ako'obe' pues	Jaan ka tu biso'ob túun bin le chan paal ku ya'ako'obe' pues	NOCHANGE
Sáansamal ku bino'ob merkaado	Sáansamal ka bine'ex merkaado	PERSON:2_PL
Yaan wáaj k xook tu naajil xook	Yaan wáaj a xooke'ex xook tu naajil xook	PERSON:2_PL
Le ki'iwajo' ee	Le ki'iwajo' ee	NOCHANGE
Bejla'ake' maas leeti' ktakiko'on	Bejla'ake' maas leeti' ktakiko'on	NOCHANGE
To'one kek bin páak ich kool	Te'exe' ka bine'ex páak tu kool	PERSON:2_PL
Kuxtal maayae' tak bejla'ake' ku meyajchajal	Kuxtal maayae' tak bejla'ake' ku meyajchajal	NOCHANGE
Tu'ux k'íiwikil koonol taak a jóok'ol koonol	Tu'ux k'íiwikil koonol yaan a jóok'ol koonol	ASPECT:COM
Leti'e' ku bin xíimbal ta wotoch	To'one' kek bin xíimbal ta wotoch	PERSON:1_PL
Ma' k a'alik u k'aaba'	Ma' u ya'aliko'ob u k'aaba'	PERSON:3_PL
Ta núukaj buka'aj a ja'abil	Tu núukaj buka'aj u ja'abilo'ob	PERSON:3_PL
Ma' ta wiliken tu k'íiwikil koonol	Ma' tin wiliko'ob tu k'íiwikil koonol	PERSON:1_SI
Ma'  k'abéet u láaj jáabal le kib yóok'ol le tuunich tu'ux ta t'abo'	Ma'  k'abéet u láaj jáabal le kib yóok'ol le tuunich tu'ux ta t'abo'	NOCHANGE
Leti'obe' táan u bino'ob koonol tu k'íiwikil koonol	Leti'obe' táan u bino'ob koonol tu k'íiwikil koonol	PERSON:3_PL
Je'el in manik ya'abach ba'alob tu k'íiwikil koonole'	Taak in manik ya'abach ba'alo'ob tu k'íiwikil koonol	ASPECT:DES
Jach k'a'abéet u bin tu k'íiwikil koonol	Jach k'a'abéet u bino'ob tu k'íiwikil koonol	PERSON:3_PL
Ka bin jo'op' u tsikbaltiko'ob ti' le ba'ax ts'o'ok u yojéeltiko'ob ba'an  ts'o'ok u yiliko'ob	Ka bin jo'op' u tsikbaltiko'ob ti' le ba'ax ts'o'ok u yojéeltiko'ob ba'an  ts'o'ok u yiliko'ob	NOCHANGE
Tu yilo'ob wáaj u sáastal tu kaajalo'ob	Ta wile'ex wáaj u sáastal ta kaajale'ex	PERSON:2_PL
Táan a meyaje'ex ich kool	Táan u meyaj tu kool	PERSON:3_SI
Le ka k'uch le éespañooleso'ob bino' ka  bin u je'elpajal ya'ab ba'ax ichil le kuxtal máasewáalo'	Le ka k'uch le éespañooleso'ob bino' ka  bin u je'elpajal ya'ab ba'ax ichil le kuxtal máasewáalo'	NOCHANGE
Kin manik nikte'ob tu k'íiwikil koonol	Ts'o'ok in manik janal tu k'íiwikil koonol	ASPECT:TER;TENSE:PAS_SIM
Yéetel le	Yéetel le	NOCHANGE
Táan wáaj a báaxale'ex báaxal tu naajil báaxal	Táan wáaj u báaxal tu naajil báaxal	PERSON:3_SI
To'one' áak'ab k bin tu k'íiwikil koonol	Te'exe' áak'ab ka bine'ex tu k'íiwikil koonol	PERSON:2_PL
Táan wáaj u bin koonol tu k'íiwikil koonol	Táan wáaj u bino'ob koonol tu k'íiwikil koonol	PERSON:3_PL
Mix leti' kajakbal ta wotoch	Mix to'on kajakbalo'on ta wotoch	PERSON:1_PL
Jbine'ex yéetel a éetailo'ob merkaado	Jbino'ob yéetel u éetailo'ob merkaado	PERSON:3_PL
To'onen yaanto'on meyaj biología	Leti'e' yaan meyaj ti' biología	PERSON:3_SI
Te'ej jool túuno' yaan a jóok'sik túunxan jump'éel taasa le ki'iwaj  ta beetaj de k'aabo'	Te'ej jool túuno' yaan a jóok'sik túunxan jump'éel taasa le ki'iwaj  ta beetaj de k'aabo'	NOCHANGE
Táan wáaj a báaxale'ex báaxal tu naajil báaxal	Táan wáaj k báaxal tu naajil báaxal	PERSON:1_PL
Ma' táan u bin koonol merkaadoi'	Ma' táan a bine'ex koonol merkaadoi'	PERSON:2_PL
Yaan u xook tu naajil xook	Yaan u xooko'ob tu naajil xook	PERSON:3_PL
Jach wáaj k'a'abéet in bin k'íiwikil koonol	Jach k'a'abéet wáaj a bine'ex tu k'íiwikil koonol	PERSON:2_PL
Táan wáaj k báaxal tu naajil báaxal	Táan wáaj a báaxale'ex báaxal tu naajil báaxal	PERSON:2_PL
Taak in suut koonol merkaado	K'a'abéet in suut koonol merkaado	ASPECT:OBL
Suuk in bin koonol tu k'íiwikil koonol	k'a'abéet in bin koonol tu k'íiwikil koonol	ASPECT:OBL
Tukulto'ob táan u bino'ob ti' jump'éel	Tukulto'ob táan u bino'ob ti' jump'éel	NOCHANGE
Esten yóok'sal ma' u lúubul lelu'um yóok'ol beyo'	Esten yóok'sal ma' u lúubul lelu'um yóok'ol beyo'	NOCHANGE
Teche' ti' a taali'	Leti'e' ti' u taali'	PERSON:3_SI
Máax yéetel táan a bin koonol tu kúuchil báaxal	Máax yéetel taak a bin koonol tu kúuchil báaxal	SUBTYPE:DEC;ASPECT:DES
Yaan u báaxalo'ob tu naajil báaxal	Yaan a báaxal tu naajil báaxal	PERSON:2_SI
Yaan je'ex le k'ajóolta'an tulum jump'éel kaaj tu líik'so'ob	Yaan je'ex le k'ajóolta'an tulum jump'éel kaaj tu líik'so'ob	NOCHANGE
Te'exe' jbine'ex yéetel a éetailo'ob tu k'íiwikil koonol	Leti'obe' jbino'ob yéetel u éetailo'ob tu k'íiwikil koonol	PERSON:3_PL
Kin bin koonol tu k'íiwikil koonol	Yaan in bin koonol tu k'íiwikil koonol	ASPECT:COM
Teche' Yaan tech meyaj biología	To'onen yaanto'on meyaj biología	PERSON:1_PL
Ma' táan a bine'ex ich kooli'	Ma' táan a bin ich kooli'	PERSON:2_SI
Yaan a xooke'ex xook tu naajil xook	Yaan a xook tu naajil xook	PERSON:2_SI
Táan wáaj u bino'ob ich kool	Táan wáaj a bine'ex ich kool	PERSON:2_PL
To'one' ajkoonolo'on ichil merkaado	Leti'e' ajkoonol ichil merkaado	PERSON:3_SI
Yaan u boon tu naajil xook	Yaan u boono'ob tu naajil xook	PERSON:3_PL
Táan a bine'ex koonol merkaado	Táan u bino'ob koonol merkaado	PERSON:3_PL
Ta'aytak u chukiko'ob u ja'abil	Ta'aytak k chukik u ja'abil	PERSON:1_PL
Ma' táan a bin koonol tu k'íiwikil koonol	Leti'e' ma' táan u bin koonol tu k'íiwikil koonol	PERSON:3_SI
Le guaardia túun bino' ka  tu ya'alaje' ma' bin u u	Le guaardia túun bino' ka  tu ya'alaje' ma' bin u u	NOCHANGE
Táan wáaj a bine'ex koonol tu k'íiwikil koonol	Táan wáaj u bin koonol tu k'íiwikil koonol	PERSON:3_SI
Yaan in jaantik ch'ujuko'ob tu k'íiwikil koonol	Yaan in k'a'aytik ch'ujuko'ob tu k'íiwikil koonol	MARK:T
Jun páak ken a manile' ts'o'okole' kux túun u piikil ku ya'ala'alo'	Jun páak ken a manile' ts'o'okole' kux túun u piikil ku ya'ala'alo'	NOCHANGE
To'onen yaanto'on xook ti' español	Te'exe' yaante'ex xook ti' español	PERSON:2_PL
Chen ba'axe' wa u ti'al le mejen paalalo'obo' pues láayli' ma' páap xan kun bentbile'	Chen ba'axe' wa u ti'al le mejen paalalo'obo' pues láayli' ma' páap xan kun bentbile'	NOCHANGE
Ma' tan a k'íilkabe'exi'	Ma' tan k k'íilkabi'	PERSON:1_PL
Tu meentiko'ob janal ich kool	Tu meentik janal ich kool	PERSON:3_SI
To'one' kajakbalo'on weye'	Leti'e' kajakbal weye'	PERSON:3_SI
Leti'obe' kajakbalo'ob weye'	Teche' kajakbalech weye'	PERSON:2_SI
Táan u kaxtik a najil	Tan k kaxtik a najil	PERSON:1_PL
Ma' ts'oka'an u beelo'obi'	Ma' ts'oka'an u beeli'	PERSON:3_SI
Ma' táan a bine'ex koonol merkaadoi'	Ma' táan a bin koonol merkaadoi'	PERSON:2_SI
U obstaakulo' yaan beyo' wa ba'ax  ti' bey ma' in takiko'one' u tojol	U obstaakulo' yaan beyo' wa ba'ax  ti' bey ma' in takiko'one' u tojol	NOCHANGE
Ku meetik jump'éel chan waaje' ku	Ku meetik jump'éel chan waaje' ku	NOCHANGE
Ts'o'ok in manik ya'abach ba'alob tu k'íiwikil koonol	Káaj in manik ya'abach ba'alob tu k'íiwikil koonol	ASPECT:BEG;TENSE:PAS_SIM
Tu'ux kajakbalo'on	Tu'ux kajakbale'ex	PERSON:2_PL
Leti'e' u jatsmajubáaj	Teche' a jatsmajabáaj	PERSON:2_SI
Ma' ts'oka'an k beeli'	Ma' ts'oka'an u beelo'obi'	PERSON:3_PL
Ya'ab wíinik tak le nukuch máako'ob bejala'k te'ej kjtalo' bey u beetiko'ob	Ya'ab wíinik tak le nukuch máako'ob bejala'k te'ej kjtalo' bey u beetiko'ob	NOCHANGE
Yaan a boone'ex xook tu naajil xook	Yaan u boon tu naajil xook	PERSON:3_SI
Ta'aytak a chukik u ja'abil	Ta'aytak u chukiko'ob u ja'abil	PERSON:3_PL
Ma' ts'oka'an a beeli'	Ma' ts'oka'an u beelo'obi'	PERSON:3_PL
To'one' k u'uyik wáaj ooxol	To'one' k u'uyik wáaj ooxol	PERSON:1_PL
Yaan wáaj u bin ich kool	Yaan wáaj u bino'ob ich kool	PERSON:3_PL
Taak in manik ya'abach ba'alo'ob tu k'íiwikil koonol	Káaj in manik ya'abach ba'alob tu k'íiwikil koonol	ASPECT:BEG;TENSE:PAS_SIM
Te' a taale'ex tu kaajil Kopomae'	Te' u taal tu kaajil Kopomae'	PERSON:3_SI
Ta'aytak u chukiko'ob u ja'abil	Ta'aytak u chukik u ja'abil	PERSON:3_SI
Yaan in k'a'aytik ch'ujuko'ob tu k'íiwikil koonol	Yaan in jaantik ch'ujuko'ob tu k'íiwikil koonol	MARK:T
Jach u ya'abile' ooraj ooraj diies minuutos ee	Jach u ya'abile' ooraj ooraj diies minuutos ee	NOCHANGE
Te'exe' ka wu'uyike'ex wáaj ooxol	To'one' k u'uyik wáaj ooxol	PERSON:1_PL
Ma' wáaj tu bino'ob merkaado	Ma' wáaj ta bine'ex merkaado	PERSON:2_PL
Teche' Yaan tech meyaj biología	Te'exe' yaante'ex meyaj biología	PERSON:2_PL
Ma' a wojel u ja'abili'	Ma' k ojel u ja'abili'	PERSON:1_PL
Táan wáaj u bin koonol tu k'íiwikil koonol	Táan wáaj u bino'ob koonol tu k'íiwikil koonol	PERSON:3_PL
To'on te'ej k'iinilo'oba' pues  le ilik xan túun meyajtik lak  knuuktakilo'on	To'on te'ej k'iinilo'oba' pues  le ilik xan túun meyajtik lak  knuuktakilo'on	NOCHANGE
To'one' ts'oka'an wáaj k beel	Te'exe' ts'oka'an wáaj a beele'ex	PERSON:2_PL
Táan k boon tu naajil xook	Táan u boono'ob tu naajil xook	PERSON:3_PL
Tu'ux k'íiwikil koonol yaan a jóok'ol koonol	Tu'ux k'íiwikil koonol káaj a jóok'ol koonol	ASPECT:BEG;TENSE:PAS_SIM
jayp'éel k'iino'ob ku bino'ob tu k'íiwikil koonol	Jayp'éel k'iino'ob ku bin tu k'íiwikil koonol	PERSON:3_SI
Waye' leti' ku paa'xal tak ti' le k'iinilo'oba'  ti' le  ee kaajo'ob pues táakpaja'ano'ob te'el ichil seentros séeremoniaaleso' ku	Waye' leti' ku paa'xal tak ti' le k'iinilo'oba'  ti' le  ee kaajo'ob pues táakpaja'ano'ob te'el ichil seentros séeremoniaaleso' ku	NOCHANGE
Jach k'a'abéet u bino'ob merkaado	Jach k'a'abéet in bin merkaado	PERSON:1_SI
Eeej che'a' te'ej tu'ux yaan le najo' ki bin bey tun le áak'ab bino' ka bin na'ako'obi'	Eeej che'a' te'ej tu'ux yaan le najo' ki bin bey tun le áak'ab bino' ka bin na'ako'obi'	NOCHANGE
Teche' a jatsmajabáaj	To'one' k jatsmajekbáaj	PERSON:1_PL
Suuk in suut koonol merkaado	Kin in suut koonol merkaado	ASPECT:HAB
Leti'e' ku bin xíimbal ta wotoch	Leti'e' ku bin xíimbal ta wotoch	PERSON:3_SI
J-jaano'on merkaado	J-jaane'ex merkaado	PERSON:2_PL
-pero bix kech bin -  ku ya'alik bin ti'	-pero bix kech bin -  ku ya'alik bin ti'	NOCHANGE
Táan wáaj ek bin ich kool	Táan wáaj u bino'ob ich kool	PERSON:3_PL
Ka'abeje' yaan a bin koonol merkaado	Ka'abeje' yaan u bino'ob koonol merkaado	PERSON:3_PL
Ka ts'áab u k'aaba' le kaajo' polinkin	Ka ts'áab u k'aaba' le kaajo' polinkin	NOCHANGE
ku yu'ubik wáaj ooxol	To'one' k u'uyik wáaj ooxol	PERSON:1_PL
Ma' táan u bino'ob koonol merkaadoi'	Ma' táan k bin koonol merkaadoi'	PERSON:3_PL
In wu'uymajo' leeti' le geerra de kaastas ku ya'ala'alo'	In wu'uymajo' leeti' le geerra de kaastas ku ya'ala'alo'	NOCHANGE
Yaan in suut koonol merkaado	K'a'abéet in suut koonol merkaado	ASPECT:OBL
Eee meen juntúul nojoch máak ba'ale'	Eee meen juntúul nojoch máak ba'ale'	NOCHANGE
Bejla'ak tun tu k'inile' u k'áat máake' ka ta'aka'ak le nook'o'obo'	Bejla'ak tun tu k'inile' u k'áat máake' ka ta'aka'ak le nook'o'obo'	NOCHANGE
Yaan a xook tu naajil xook	Yaan k xook tu naajil xook	PERSON:1_PL
Suuk in manik ya'abach ba'alob tu k'íiwikil koonol	Je'el in manik ya'abach ba'alob tu k'íiwikil koonole'	ASPECT:INS
Yaan a suut tu naajil xook	Yaan a suute'ex xook tu naajil xook	PERSON:2_PL
Ma' suuk in bin maan tu k'íiwikil koonoli'	Ma' k'a'abéet in bin maan tu k'íiwikil koonoli'	ASPECT:OBL
Ta meentik janal ich kool	Tu meentik janal ich kool	PERSON:3_SI
Uk'ul le waajo'ob ken u biso' u u loolilo'ob u kibilo'ob	Uk'ul le waajo'ob ken u biso' u u loolilo'ob u kibilo'ob	NOCHANGE
Leti'e' ku bin páak ich kool	To'one kek bin páak ich kool	PERSON:1_PL
Leti'e' ti' u taali'	Teche' ti' a taali'	PERSON:2_SI
Ku xa'ak'ta'al le juuch' yéetel le siklo'	Ku xa'ak'ta'al le juuch' yéetel le siklo'	NOCHANGE
Jach wáaj k'a'abéet u bino'ob merkaado	Jach wáaj k'a'abéet in bin merkaado	PERSON:1_SI
Te'exe' a jatsmajaba'ex	Leti'e' u jatsmajubáaj	PERSON:3_SI
Yaan wáaj u bino'ob koonol tu k'íiwikil koonol	Yaan wáaj u bino'ob koonol tu k'íiwikil koonol	PERSON:3_PL
Le beetike' ku ya'alale' ku beeta'al bey de  esten de táamali'lo' wa to'obil waaj	Le beetike' ku ya'alale' ku beeta'al bey de  esten de táamali'lo' wa to'obil waaj	NOCHANGE
Leti'e' yaan meyaj ti' biología	Te'exe' yaante'ex meyaj biología	PERSON:2_PL
Mix teech kajakbalech ta wotoch	Mix to'on kajakbalo'on ta wotoch	PERSON:1_PL
K'aaynajech tu naajil xook	k'aaynajo'ob tu naajil xook	PERSON:3_PL
Ook'in a bine'ex ta koole'ex	Ook'in u bino'ob tu koolo'ob	PERSON:3_PL
Te'exe' ti' kajakbale'ex tu yotoche'	To'one' ti' kajakbalo'on tu yotoche'	PERSON:1_PL
Sáam u meente le píibo'	Sáam u meente le píibo'	NOCHANGE
Suuk in suut koonol merkaado	Taak in suut koonol merkaado	ASPECT:DES
Jbinech yéetel a éetailo'ob merkaado	Jbine'ex yéetel a éetailo'ob merkaado	PERSON:2_PL
Táan a boon tu naajil xook	Táan u boon tu naajil xook	PERSON:3_SI
Yaan wáaj a bin koonol tu k'íiwikil koonol	Yaan wáaj u bino'ob koonol tu k'íiwikil koonol	PERSON:3_PL
Ma' k'aja'antech buka'aj a ja'abili'	Ma' k'aja'anto'on buka'aj k ja'abili'	PERSON:1_PL
Ma' tan u k'íilkabo'obi'	Ma' tan a k'íilkabe'exi'	PERSON:2_PL
Táan u boono'ob tu naajil xook	Táan a boon tu naajil xook	PERSON:2_SI
Táan a bine'ex koonol merkaado	Táan a bin koonol merkaado	PERSON:2_SI
Leti'e' ma' táan u bin koonol tu k'íiwikil koonol	Leti'e' ma' táan u bin koonol tu k'íiwikil koonol	PERSON:3_SI
Yaan a suut tu naajil xook	Yaan u suuto'ob tu naajil xook	PERSON:3_PL
Ya'ab máax ku k'áat óolal	Ya'ab máax ku k'áat óolal	NOCHANGE
Ku bino'ob le pixano'obo'	Ku bino'ob le pixano'obo'	NOCHANGE
Máax yéetel suuk a bin koonol tu kúuchil báaxal	Máax yéetel k'a'abéet a bin koonol tu kúuchil báaxal	SUBTYPE:DEC;ASPECT:OBL
Leti'e' ajkoonol	To'one' ajkoonolo'on	PERSON:1_PL
Yaan wáaj a bin ich kool	Yaan wáaj u bino'ob ich kool	PERSON:3_PL
Leti'e' jbúulij	Te'exe' jbúule'ex	PERSON:2_PL
Ma' kajakbale'ex tin wotochi'	Mix leti' kajakbal ta wotoch	PERSON:3_SI
Sáansamal ku bino'ob koonol merkaado	Sáansamal ka bine'ex koonol merkaado	PERSON:2_PL
Leti'obe' táan u bino'ob koonol tu k'íiwikil koonol	Táan a bin koonol tu k'íiwikil koonol	PERSON:2_SI
Kin in suut koonol merkaado	Káaj in suut koonol merkaado	ASPECT:BEG;TENSE:PAS_SIM
Tak ti'al u jóok'sa'al le	Tak ti'al u jóok'sa'al le	NOCHANGE
Leti'e' kajakbal weye'	Te'exe' kajakbale'ex weye'	PERSON:2_PL
Ts'oka'an wáaj k beel	Ts'oka'an wáaj a beele'ex	PERSON:3_PL
K'a'abéet in suut koonol merkaado	Kin in suut koonol merkaado	ASPECT:HAB
Táan a báaxale'ex báaxal tu naajil báaxal	Táan u báaxal tu naajil báaxal	PERSON:3_SI
To'one' k báaxal paarkée	Te'exe' ka báaxale'ex paarkée	PERSON:2_PL
Te'exe' ka báaxale'ex paarkée	To'one' k báaxal paarkée	PERSON:1_PL
Yaana kaxtik puro máak yaan u k'uchul tu'ux yaan máako'ob puuro káaltal wíiniko'ob	Yaana kaxtik puro máak yaan u k'uchul tu'ux yaan máako'ob puuro káaltal wíiniko'ob	NOCHANGE
Yaan wáaj a bine'ex koonol tu k'íiwikil koonol	Yaan wáaj u bino'ob koonol tu k'íiwikil koonol	PERSON:3_PL
Káaj in suut koonol merkaado	Ts'o'ok in suut koonol merkaado	ASPECT:TER;TENSE:PAS_SIM
Tu kaxtik a najil	Táan u kaxtik a najil	PERSON:3_SI
Le je'elo' yaan yila' yéetel buka'aj	Le je'elo' yaan yila' yéetel buka'aj	NOCHANGE
Ka'abeje' yaan u bino'ob koonol merkaado	Ka'abeje' yaan a bin koonol merkaado	PERSON:2_SI
Yaan u boon tu naajil xook	Yaan a boon tu naajil xook	PERSON:2_SI
Tan k k'íilkab	Tan u k'íilkabo'ob	PERSON:3_PL
Tu núukaj buka'aj u ja'abilo'ob	Ta núukaj buka'aj a ja'abil	PERSON:2_SI
Ma' tak ilaj u sáastal k kaajali'	Ma' ta wile'ex u sáastal ta kaajale'exi'	PERSON:2_PL
Yaan u boono'ob tu naajil xook	Yaan u boon tu naajil xook	PERSON:3_SI
Yaan u suut tu naajil xook	Yaan a suut tu naajil xook	PERSON:2_SI
Yaan ek jochik chak nal tek kool	Yaan a jochik chak nal ta kool	PERSON:2_SI
Táan in manik ya'abach ba'alob tu k'íiwikil koonol	Táant in manik ya'abach ba'alo'ob tu k'íiwikil koonole'	ASPECT:IMM;TENSE:PAS_SIM
Yaan u báaxalo'ob tu naajil báaxal	Yaan a báaxale'ex báaxal tu naajil báaxal	PERSON:2_PL
Táan u xook tu naajil xook	Táan k xook tu naajil xook	PERSON:1_PL
Yaan wáaj a bine'ex koonol merkaado	Yaan wáaj k bin koonol merkaado	PERSON:1_PL
U chuj u báao'ob bin	U chuj u báao'ob bin	NOCHANGE
Ts'oka'an wáaj a beele'ex	Ts'oka'an wáaj u beelo'ob	PERSON:3_PL
Yaan wáaj u bin ich kool	Yaan wáaj a bine'ex ich kool	PERSON:2_PL
Jayp'éel k'iino'ob ka bine'ex merkaado	Jayp'éel k'iino'ob ku bin merkaado	PERSON:3_SI
Ma' tu yu'ubik wáaj ooxoli'	Ma' tu yu'ubiko'ob wáaj ooxoli'	PERSON:3_PL
Ma' u yojelo'ob u ja'abili'	Ma' a wojele'ex u ja'abili'	PERSON:2_PL
Ka'anal k'a'abéet u na'aksik ma'atáan u béeytal u na'akalo'	Ka'anal k'a'abéet u na'aksik ma'atáan u béeytal u na'akalo'	NOCHANGE
Leti'obe' táan u bino'ob koonol tu k'íiwikil koonol	Te'exe' táan a bine'ex koonol tu k'íiwikil koonol	PERSON:2_PL
Chen ba'ale je'ex u kreero'ob leeti'o'ob je'ex u chíimpoolalo'obo' bey xan le to'ona' yaan wa ba'axo'ob  ku k'éexel ti'al leti' chen ba'axe' pues	Chen ba'ale je'ex u kreero'ob leeti'o'ob je'ex u chíimpoolalo'obo' bey xan le to'ona' yaan wa ba'axo'ob  ku k'éexel ti'al leti' chen ba'axe' pues	NOCHANGE
Ts'o'ok in suut koonol merkaado	Káaj in suut koonol merkaado	ASPECT:BEG;TENSE:PAS_SIM
Yóok'sal ma' xan uk'ul xani' pues	Yóok'sal ma' xan uk'ul xani' pues	NOCHANGE
Ma' tu yilaj u sáastal tu kaajali'	Ma' ta wile'ex u sáastal ta kaajale'exi'	PERSON:2_PL
Sáansamal ka bine'ex merkaado	Sáansamal ka bin merkaado	PERSON:2_SI
Taak in suut koonol merkaado	Káaj in suut koonol merkaado	ASPECT:BEG;TENSE:PAS_SIM
Yaan wáaj k bin koonol merkaado	Yaan wáaj a bine'ex koonol merkaado	PERSON:2_PL
Ka tu kíinso'ob bin tu tóokajo'ob bin	Ka tu kíinso'ob bin tu tóokajo'ob bin	NOCHANGE
Ma' táan u bin ich kooli'	Ma' táan a bin ich kooli'	PERSON:2_SI
Yaan k suut tu naajil xook	Yaan u suut tu naajil xook	PERSON:3_SI
Le chen in woojel	Le chen in woojel	NOCHANGE
Táan wáaj k bin koonol tu k'íiwikil koonol	Táan wáaj u bino'ob koonol tu k'íiwikil koonol	PERSON:3_PL
Tumeen a woojel le píibo' yaan a meentik	Tumeen a woojel le píibo' yaan a meentik	NOCHANGE
Táan a boone'ex xook tu naajil xook	Táan u boon tu naajil xook	PERSON:3_SI
Yaan in suut koonol merkaado	Táant in suut koonol merkaadoe'	ASPECT:IMM;TENSE:PAS_SIM
Ma' tan k k'íilkabi'	Ma' tan a k'íilkabe'exi'	PERSON:2_PL
Ma' tu yu'ubiko'ob ooxoli'	Ma' tu yu'ubiko'ob ooxoli'	PERSON:3_PL
Yaan u báaxalo'ob tu naajil báaxal	Yaan k báaxal tu naajil báaxal	PERSON:1_PL
Je'el in bin koonol tu k'íiwikil koonole'	Ts'o'ok in bin koonol tu k'íiwikil koonol	ASPECT:TER;TENSE:PAS_SIM
Táan a suute'ex xook tu naajil xook	Táan u suut tu naajil xook	PERSON:3_SI
Leti'e' u jatsmajubáaj	To'one' k jatsmajekbáaj	PERSON:1_PL
Te' a taal tu kaajil Kopomae'	Te' u taal tu kaajil Kopomae'	PERSON:3_SI
Ma' táan k bin koonol merkaadoi'	Ma' táan u bin koonol merkaadoi'	PERSON:3_SI
Te'exe' yaante'ex u áanalte'il u xookil matemáticas	Teche' Yaan tech u áanalte'il a xook matemáticas	PERSON:2_SI
Tu'ux kajakbalo'on	Tu'ux kajakbalo'ob	PERSON:3_PL
Leti'e' u k'aaba'e'	To'one' in k'aaba'one'	ASPECT:HAB;PERSON:1_PL
U yo'och k'oja'an  ma'atáan a ts'aaik u xa'ak' jach ya'ab	U yo'och k'oja'an  ma'atáan a ts'aaik u xa'ak' jach ya'ab	NOCHANGE
Yaan wáaj u bino'ob koonol tu k'íiwikil koonol	Yaan wáaj u bin koonol tu k'íiwikil koonol	PERSON:3_SI
Táan a meyaj ich kool	Táan ek meyaj ich kool	PERSON:1_PL
Ma' kajakbale'ex tin wotochi'	Mix te'ex kajakbale'ex ta wotoch	PERSON:2_PL
Táan a xook tu naajil xook	Táan a xooke'ex xook tu naajil xook	PERSON:2_PL
Te'exe' ma' jbúule'ex wáaj	Leti'e' ma' jbúul wáaj	PERSON:3_SI
Je'el u béeytal u táakpajalo'ob ti'al  le este le  meet ki'il waajo' chen lejaajo' ku	Je'el u béeytal u táakpajalo'ob ti'al  le este le  meet ki'il waajo' chen lejaajo' ku	NOCHANGE
Le in wu'uymaj u tsikbalta'al  tumeen in noolo'ob tumeen le máako'ob  u u k'ajóolmo'ob jun p'íit yóok'sal le	Le in wu'uymaj u tsikbalta'al  tumeen in noolo'ob tumeen le máako'ob  u u k'ajóolmo'ob jun p'íit yóok'sal le	NOCHANGE
Ts'okole' ku pixik yéetel u le' ja'aso' bey u beetik leeti'o'	Ts'okole' ku pixik yéetel u le' ja'aso' bey u beetik leeti'o'	NOCHANGE
Yaan in manik ya'abach ba'alob tu k'íiwikil koonol	Táant in manik ya'abach ba'alo'ob tu k'íiwikil koonole'	ASPECT:IMM;TENSE:PAS_SIM
Leti'obe' u k'aaba'obe'	Teche' a k'aaba'e'	ASPECT:HAB;PERSON:2_SI
Ma' k'aja'antech buka'aj a ja'abili'	Ma' k'aja'anti' buka'aj u ja'abili'	PERSON:3_SI
Táan wáaj u bin koonol tu k'íiwikil koonol	Táan wáaj u bino'ob koonol tu k'íiwikil koonol	PERSON:3_PL
Leti'obe' jbino'ob yéetel u éetailo'ob tu k'íiwikil koonol	Jbinech yéetel a éetailo'ob tu k'íiwikil koonol	PERSON:2_SI
Teche' ma' jbúulechi'	Te'exe' ma' jbúule'exi'	PERSON:2_PL
Ku t'a'abal	Ku t'a'abal	NOCHANGE
E maayas le úuchben maayaso'obo' le ma' senkech úuchbentako'obo' pues láaili' xan u tuukulo'obe' ma' kxu'ulsa'al	E maayas le úuchben maayaso'obo' le ma' senkech úuchbentako'obo' pues láaili' xan u tuukulo'obe' ma' kxu'ulsa'al	NOCHANGE
Jach k'a'abéet wáaj u bin tu k'íiwikil koonol	Jach k'a'abéet wáaj u bino'ob tu k'íiwikil koonol	PERSON:3_PL
Táan in manik ya'abach ba'alob tu k'íiwikil koonol	Taak in manik ya'abach ba'alo'ob tu k'íiwikil koonol	ASPECT:DES
Le píibo' ts'okol u pu'ulul le píibo' pues	Le píibo' ts'okol u pu'ulul le píibo' pues	NOCHANGE
Leti'o'obe' ku yu'ubiko'ob ooxol	ku yu'ubik wáaj ooxol	PERSON:3_SI
Jach k'a'abéet u bino'ob merkaado	Jach k'a'abéet a bine'ex merkaado	PERSON:2_PL
Táan k bin koonol tu k'íiwikil koonol	Leti'obe' táan u bino'ob koonol tu k'íiwikil koonol	PERSON:3_PL
Cha'aik ya'abkach loolo'ob lool	Cha'aik ya'abkach loolo'ob lool	NOCHANGE
E je'elo' ka bin u k'éexel tumeen leeti'o'obe' tu taaso'ob u láak' tuukul ichil le máasewáal	E je'elo' ka bin u k'éexel tumeen leeti'o'obe' tu taaso'ob u láak' tuukul ichil le máasewáal	NOCHANGE
Te' a taale'ex tu kaajil Kopomae'	Te' a taal tu kaajil Kopomae'	PERSON:2_SI
Leti'e' ku bin paak'áal ich kool	Te'exe' ka taale'ex paak'áal ich kool	PERSON:2_PL
Ma' tan a k'íilkabi'	Ma' tan a k'íilkabe'exi'	PERSON:2_PL
To'one' áak'ab wáaj k bin tu k'íiwikil koonol	To'one' ma' áak'ab wáaj k bin tu k'íiwikil koonoli'	TYPE:NEG;SUBTYPE:INT
Te' k taal tu kaajil Kopomae'	Te' a taale'ex tu kaajil Kopomae'	PERSON:2_PL
Leti'e' ma' jbúul wáaj	To'one' ma' jbúulo'on wáaj	PERSON:1_PL
Táan a bin koonol tu k'íiwikil koonol	Táan k bin koonol tu k'íiwikil koonol	PERSON:1_PL
Úuchik  ku u u u t'i'itkubáaj máak esteen beyo' pues tak e le le ba'alo'ob taasa'ab tumeen le e ee e	Úuchik  ku u u u t'i'itkubáaj máak esteen beyo' pues tak e le le ba'alo'ob taasa'ab tumeen le e ee e	NOCHANGE
Pues bey túuno' ti'al u jaanto'ob bin tu bejilo'ob  bin le esten le	Pues bey túuno' ti'al u jaanto'ob bin tu bejilo'ob  bin le esten le	NOCHANGE
A yáax beente le ets'kúunsajo'	A yáax beente le ets'kúunsajo'	NOCHANGE
Ja'as k'úum	Ja'as k'úum	NOCHANGE
Ts'áako'ob u tuupo'o ba'ax túun jach bejla'ak ma' in	Ts'áako'ob u tuupo'o ba'ax túun jach bejla'ak ma' in	NOCHANGE
Ma' kajakbale'ex tin wotochi'	Mix teech kajakbalech ta wotoch	PERSON:2_SI
Ma' táan u bino'ob koonol tu k'íiwikil koonol	Ma' táan k bin koonol tu k'íiwikil koonol	PERSON:1_PL
Táan wáaj u bino'ob koonol tu k'íiwikil koonol	Táan wáaj u bin koonol tu k'íiwikil koonol	PERSON:3_SI
Yaan a xook tu naajil xook	Yaan u xooko'ob tu naajil xook	PERSON:3_PL
Ma' ta wile'ex u sáastal ta kaajale'exi'	Ma' tu yilaj u sáastal tu kaajali'	PERSON:3_SI
Ka'abeje' yaan a bine'ex koonol	Ka'abeje' yaan a bin koonol	PERSON:2_SI
Yaan wáaj u báaxalo'ob tu naajil báaxal	Yaan wáaj k báaxal tu naajil báaxal	PERSON:1_PL
Ma' u yojelo'ob u ja'abili'	Ma' a wojel u ja'abili'	PERSON:2_SI
Hasta bey u láaj tu'up u p'áatal bey chen chen chúuke'	Hasta bey u láaj tu'up u p'áatal bey chen chen chúuke'	NOCHANGE
te'exe' ka báaxale'ex tu naajil xook	leti'e ku báaxal tu naajil xook	PERSON:3_SI
Ma' ta wu'uyike'ex wáaj ooxoli'	Te'exe' ka wu'uyike'ex wáaj ooxol	TYPE:AFF;SUBTYPE:INT
Yaan a boon tu naajil xook	Yaan u boono'ob tu naajil xook	PERSON:3_PL
Yaan wáaj a xooke'ex xook tu naajil xook	Yaan wáaj u xooko'ob tu naajil xook	PERSON:3_PL
Pues ma' ya'abi' chen ba'ale' wa ti'al u	Pues ma' ya'abi' chen ba'ale' wa ti'al u	NOCHANGE
Táan u bin koonol merkaado	Táan a bin koonol merkaado	PERSON:2_SI
Táan xan u t'a'abal le k'áak'o'	Táan xan u t'a'abal le k'áak'o'	NOCHANGE
Ba'ax ja'abil jsíije'ex	Ba'ax ja'abil jsíijo'ob	PERSON:3_PL
Ma' jach k'a'abéet wáaj u bin tu k'íiwikil koonoli'	Ma' jach k'a'abéet wáaj a bine'ex k'íiwikil koonoli'	PERSON:2_PL
Te' u taal tu kaajil Kopomae'	Te' u taalo'ob tu kaajil Kopomae'	PERSON:3_PL
Je'elo' pues tak bejla'ake' ma'atáan in na'atik túun bixij bix je'el in in	Je'elo' pues tak bejla'ake' ma'atáan in na'atik túun bixij bix je'el in in	NOCHANGE
Teche' ajkoonolech ichil merkaado	Leti'e' ajkoonol ichil merkaado	PERSON:3_SI
Ta wile'ex wáaj u sáastal ta kaajale'ex	k ilaj wáaj u sáastal k kaajal	PERSON:1_PL
Táan a xook tu naajil xook	Táan u xook tu naajil xook	PERSON:3_SI
Teche' Yaan tech u áanalte'il a xook matemáticas	To'onen yaanto'on u áanalte'il k xook matemáticas	PERSON:1_PL
K'a'abéet in manik suuts' pak'áal tu k'íiwikil koonol	Táant in manik ch'ujuk pak'áal tu k'íiwikil koonole'	ASPECT:IMM;TENSE:PAS_SIM
Táan wáaj u bino'ob koonol tu k'íiwikil koonol	Táan wáaj u bin koonol tu k'íiwikil koonol	PERSON:3_SI
U u yuumtsilo'ob xane'	U u yuumtsilo'ob xane'	NOCHANGE
Wa ten tin wa'alaj in ts'áaik juuch' wa teen tin wa'alaj in ts'áaik sikil wa bixe' yaan in ts'áaik	Wa ten tin wa'alaj in ts'áaik juuch' wa teen tin wa'alaj in ts'áaik sikil wa bixe' yaan in ts'áaik	NOCHANGE
to'one' k báaxal tu naajil xook	Teche' ka báaxal tu naajil xook	PERSON:2_SI
Yaan wáaj a báaxale'ex báaxal tu naajil báaxal	Yaan wáaj u báaxalo'ob tu naajil báaxal	PERSON:3_PL
Te'exe' kajakbale'ex weye'	Teche' kajakbalech weye'	PERSON:2_SI
Ken sáasak bey yaan a meentik le píiba' pues yaan a meentik a k'u'um	Ken sáasak bey yaan a meentik le píiba' pues yaan a meentik a k'u'um	NOCHANGE
Tan a k'íilkabe'ex	Tan a k'íilkab	PERSON:2_SI
Ta meentike'ex janal ich kool	Tu meentiko'ob janal ich kool	PERSON:3_PL
Ma' jach k'a'abéet u bino'ob tu k'íiwikil koonoli'	Ma' jach k'a'abéet u bin k'íiwikil koonoli'	PERSON:3_SI
Je'elo' ka k'uch tun  esten ti' jump'éel bej beya' ka tu satubáae' te'ej máako'ob bino' sataj u báae' ka bin u yáalkab bin	Je'elo' ka k'uch tun  esten ti' jump'éel bej beya' ka tu satubáae' te'ej máako'ob bino' sataj u báae' ka bin u yáalkab bin	NOCHANGE
Ma' tu yu'ubik ooxoli'	Ma' ta wu'uyik ooxoli'	PERSON:2_SI
Yéetel le u chokwa'ilo' le chocolaate'	Yéetel le u chokwa'ilo' le chocolaate'	NOCHANGE
Táan a báaxal tu naajil báaxal	Táan a báaxale'ex báaxal tu naajil báaxal	PERSON:2_PL
Ts'oka'an wáaj u beelo'ob	Ts'oka'an wáaj a beel	PERSON:2_SI
Ku ya'alik bin le chan xnuuk ti' le xi'ipalo'-tu'ux ka bin winik - ki bin	Ku ya'alik bin le chan xnuuk ti' le xi'ipalo'-tu'ux ka bin winik - ki bin	NOCHANGE
Ma' táan a bin koonol tu k'íiwikil koonol	Ma' táan u bino'ob koonol tu k'íiwikil koonol	PERSON:3_PL
Ma' tek u'uyik wáaj ooxoli'	Ma' tu yu'ubik wáaj ooxoli'	PERSON:3_SI
Ma' u ya'alik u k'aaba'	Ma' a wa'alike'ex u k'aaba'	PERSON:2_PL
Ku báajal u meyajto'ob túun ichil u meyajtiko'obo'	Ku báajal u meyajto'ob túun ichil u meyajtiko'obo'	NOCHANGE
Teche' kajakbalech weye'	Leti'obe' kajakbalo'ob weye'	PERSON:3_PL
Taak in suut koonol merkaado	Yaan in suut koonol merkaado	ASPECT:COM
Ka suunaj bin ka'atéen tu chan kajtalile'	Ka suunaj bin ka'atéen tu chan kajtalile'	NOCHANGE
Tu'ux k'íiwikil koonol yaan a jóok'ol koonol	Tu'ux k'íiwikil koonol k'a'abéet a jóok'ol koonol	ASPECT:OBL
Táan a boone'ex xook tu naajil xook	Táan a boon tu naajil xook	PERSON:2_SI
To'one' k u'uyik wáaj ooxol	Leti'o'obe' ku yu'ubiko'ob ooxol	PERSON:3_PL
Ts'o'okole' pues tumeen úuch ka'ache' le chen ila'ak a takmaj a iipile'	Ts'o'okole' pues tumeen úuch ka'ache' le chen ila'ak a takmaj a iipile'	NOCHANGE
U áabuelos in bauela je'elo' ka bino'obe' ti' láaj ti'ano'ob túune'  ti' p'áat inalo'obe' ma' tu ka e'esaj u báaj bin ti' le eee	U áabuelos in bauela je'elo' ka bino'obe' ti' láaj ti'ano'ob túune'  ti' p'áat inalo'obe' ma' tu ka e'esaj u báaj bin ti' le eee	NOCHANGE
Ma' tan k k'íilkabi'	Ma' tan u k'íilkabo'obi'	PERSON:3_PL
Yaan wáaj ek bin ich kool	Yaan wáaj a bine'ex ich kool	PERSON:2_PL
Ts'oka'an wáaj u beel	Ts'oka'an wáaj u beelo'ob	PERSON:3_PL
Kux túun u nook'il ken a tak'ilo'	Kux túun u nook'il ken a tak'ilo'	NOCHANGE
Te'exe' ajkoonole'ex	Teche' ajkoonolech	PERSON:2_SI
Le e' boob wa ka jóok'oko' pues seguuro yaan u jaanta'alo'ob wa kaabal wa yóok'ol  bej yano'ob jaa	Le e' boob wa ka jóok'oko' pues seguuro yaan u jaanta'alo'ob wa kaabal wa yóok'ol  bej yano'ob jaa	NOCHANGE
Taak in manik ya'abach ba'alo'ob tu k'íiwikil koonol	K'a'abéet in manik ya'abach ba'alob tu k'íiwikil koonol	ASPECT:OBL
Ta núukaje'ex buka'aj a ja'abile'ex	Tu núukaj buka'aj u ja'abil	PERSON:3_SI
Táan wáaj a boone'ex xook tu naajil xook	Táan wáaj u boon tu naajil xook	PERSON:3_SI
Táan a bin koonol merkaado	Táan u bino'ob koonol merkaado	PERSON:3_PL
Mix leti' kajakbal ta wotoch	Mix teech kajakbalech ta wotoch	PERSON:2_SI
Ba'ax ja'abil jsíijij	Ba'ax ja'abil jsíijo'ob	PERSON:3_PL
Tu kaxtik a najil	Táan ek kaxtik a najil	PERSON:1_PL
Yaan wáaj u bino'ob ich kool	Yaan wáaj u bin ich kool	PERSON:3_SI
Ma' wáaj jach k'a'abéet u bin merkaadoi'	Ma' wáaj jach k'a'abéet u bino'ob merkaadoi'	PERSON:3_PL
Leti'e' ajkoonol ichil merkaado	Te'exe' ajkoonole'ex ichil merkaado	PERSON:2_PL
Táan wáaj u bino'ob ich kool	Táan wáaj u bin ich kool	PERSON:2_SI
Ta'aytak u chukik u ja'abil	Ta'aytak a chukik u ja'abil	PERSON:2_SI
k ilaj wáaj u sáastal k kaajal	Ta wile'ex wáaj u sáastal ta kaajale'ex	PERSON:2_PL
Ka in papaj tsikbalmil in taata tsikbalmil ti' teen	Ka in papaj tsikbalmil in taata tsikbalmil ti' teen	NOCHANGE
Yaan wáaj u bin koonol tu k'íiwikil koonol	Yaan wáaj k bin koonol tu k'íiwikil koonol	PERSON:1_PL
Táan ek kaxtik a najil	Tu kaxko'ob a najil	PERSON:3_PL
Te'exe' táan a bine'ex koonol tu k'íiwikil koonol	Leti'obe' táan u bino'ob koonol tu k'íiwikil koonol	PERSON:3_PL
Jach k'a'abéet u bino'ob tu k'íiwikil koonol	Jach k'a'abéet in bin tu k'íiwikil koonol	PERSON:1_SI
leti'e ku báaxal tu naajil xook	Teche' ka báaxal tu naajil xook	PERSON:2_SI
Táan u xooko'ob tu naajil xook	Táan u xook tu naajil xook	PERSON:3_SI
Ku ts'okol túune' je'ex in wa'alik techo' ku ts'áak jump'éel	Ku ts'okol túune' je'ex in wa'alik techo' ku ts'áak jump'éel	NOCHANGE
Tan k kaxtik a najil	Táan ek kaxtik a najil	PERSON:1_PL
Táan k suut tu naajil xook	Táan u suuto'ob tu naajil xook	PERSON:3_PL
Ma' k a'alik u k'aaba'	Ma' a wa'alike'ex u k'aaba'	PERSON:2_PL
Leti'e' ku báaxal paarkée	Leti'obe' ku báaxalo'ob paarkée	PERSON:3_PL
Yaan wáaj u bino'ob koonol merkaado	Yaan wáaj k bin koonol merkaado	PERSON:1_PL
ku yu'ubik wáaj ooxol	To'one' k u'uyik wáaj ooxol	PERSON:1_PL
Jach k'a'abéet wáaj u bino'ob tu k'íiwikil koonol	Jach k'a'abéet wáaj a bine'ex tu k'íiwikil koonol	PERSON:2_PL
Teche' ti' kajakbalech tu yotoche'	Leti'e' ti' kajakbal tu yotoche'	PERSON:3_SI
Tu'ux k'íiwikil koonol taak a jóok'ol koonol	Tu'ux k'íiwikil koonol káaj a jóok'ol koonol	ASPECT:BEG;TENSE:PAS_SIM
Jayp'éel k'iino'ob ka bine'ex tu k'íiwikil koonol	Jayp'éel k'iino'ob ku bin tu k'íiwikil koonol	PERSON:3_SI
To'one' k k'aaba'e'	Te'exe' a k'aaba'exe'	ASPECT:HAB;PERSON:2_PL
Kin wilikech te' tu kúuchil báaxalo'	K'a'abéet in wilikech te' tu kúuchil báaxalo'	ASPECT:OBL
Te' u taal tu kaajil Kopomae'	Te' a taal tu kaajil Kopomae'	PERSON:2_SI
Táant in suut koonol merkaadoe'	Ts'o'ok in suut koonol merkaado	ASPECT:TER;TENSE:PAS_SIM
Leti'obe' ku báaxalo'ob paarkée	Te'exe' ka báaxale'ex paarkée	PERSON:2_PL
Je'el in manik ya'abach ba'alob tu k'íiwikil koonole'	Yaan in manik ya'abach ba'alob tu k'íiwikil koonol	ASPECT:COM
Ku jóok's'aal le che'o'ob ku buuts'ilaankilo' ku p'a'atal  le jach	Ku jóok's'aal le che'o'ob ku buuts'ilaankilo' ku p'a'atal  le jach	NOCHANGE
Táan u kaaxtik a wotoch	Táan ek kaxtik a wotoch	PERSON:1_PL
Yaan a jochike'ex chak nal ta koole'ex	Yaan ek jochik chak nal tek kool	PERSON:1_PL
Te'exe' ma' jbúule'exi'	To'one' ma' jbúulo'oni'	PERSON:1_PL
Yaan a báaxal tu naajil báaxal	Yaan a báaxale'ex báaxal tu naajil báaxal	PERSON:2_PL
Bey uuuu k'a'k'atts'áabil ken a ts'aaj beya'	Bey uuuu k'a'k'atts'áabil ken a ts'aaj beya'	NOCHANGE
Yaan in bin koonol tu k'íiwikil koonol	k'a'abéet in bin koonol tu k'íiwikil koonol	ASPECT:OBL
Yaan a boon tu naajil xook	Yaan u boon tu naajil xook	PERSON:3_SI
Tene' tun bejla'aj túune' pues	Tene' tun bejla'aj túune' pues	NOCHANGE
Jach k'a'abéet wáaj a bine'ex tu k'íiwikil koonol	Jach k'a'abéet wáaj u bin tu k'íiwikil koonol	PERSON:3_SI
Le ba'al tun je'ela' tu'ux taali' tumeen úuch ka'ache' le nukuch le maayao'obo' wa le nukuch maako'obo'	Le ba'al tun je'ela' tu'ux taali' tumeen úuch ka'ache' le nukuch le maayao'obo' wa le nukuch maako'obo'	NOCHANGE
Teche' ti' a taali'	Leti'obe' ti' u taalo'obi'	PERSON:3_PL
Ta'aytak u chukiko'ob u ja'abil	Ta'aytak a chukik u ja'abil	PERSON:2_SI
U píibil le jaanal pixano'	U píibil le jaanal pixano'	NOCHANGE
Ma'atáan u ye'eskubáao'ob wa ka xi'iken tin juunale' kin taasko'ob tu ka'atéene' tumeen yaan u taalo'ob tin paaach	Ma'atáan u ye'eskubáao'ob wa ka xi'iken tin juunale' kin taasko'ob tu ka'atéene' tumeen yaan u taalo'ob tin paaach	NOCHANGE
Ma' tu yu'ubik ooxoli'	Ma' tu yu'ubiko'ob ooxoli'	PERSON:3_PL
Te'exe' áak'ab wáaj ka bine'ex tu k'íiwikil koonol	Teche' áak'ab wáaj ka bin tu k'íiwikil koonol	PERSON:2_SI
Teche' ajkoonolech ichil merkaado	Te'exe' ajkoonole'ex ichil merkaado	PERSON:2_PL
Ts'oka'an wáaj u beelo'ob	Ts'oka'an wáaj a beele'ex	PERSON:3_PL
Ma túun in woojel tu lákali' ba'ale' le kin wilik u meenta'alo' leeti' ken in wilik	Ma túun in woojel tu lákali' ba'ale' le kin wilik u meenta'alo' leeti' ken in wilik	NOCHANGE
Ka tu ya'alo'ob le guaardiao' ka tu ya'alaj bin ti' le máako'obo'	Ka tu ya'alo'ob le guaardiao' ka tu ya'alaj bin ti' le máako'obo'	NOCHANGE
Yaan a k'uchul ti' jump'éel tu'ux yaan a súutul	Yaan a k'uchul ti' jump'éel tu'ux yaan a súutul	NOCHANGE
Yaan wáaj a bine'ex koonol merkaado	Yaan wáaj u bin koonol merkaado	PERSON:3_SI
Buka'ajil máak ku	Buka'ajil máak ku	NOCHANGE
Te'exe' áak'ab wáaj ka bine'ex tu k'íiwikil koonol	To'one' áak'ab wáaj k bin tu k'íiwikil koonol	PERSON:1_PL
ku ts'íibo'ob tu naajil xook	ka ts'íibe'ex tu naajil xook	PERSON:2_PL
Jweeno'ob merkaado	Jweene'ex merkaado	PERSON:2_PL
Tu yilo'ob wáaj u sáastal tu kaajalo'ob	k ilaj wáaj u sáastal k kaajal	PERSON:1_PL
Yaan u xook tu naajil xook	Yaan a xook tu naajil xook	PERSON:2_SI
Te' a taale'ex tu kaajil Kopomae'	Te' u taalo'ob tu kaajil Kopomae'	PERSON:3_PL
Taak in manik ya'abach ba'alo'ob tu k'íiwikil koonol	Táant in manik ya'abach ba'alo'ob tu k'íiwikil koonole'	ASPECT:IMM;TENSE:PAS_SIM
Le je'ela' k'as talam u tsoololil bey u tsikbalil	Le je'ela' k'as talam u tsoololil bey u tsikbalil	NOCHANGE
Te'exe' ka wu'uyike'ex wáaj ooxol	To'one' k u'uyik wáaj ooxol	PERSON:1_PL
Yaan in manik ya'abach ba'alob tu k'íiwikil koonol	Suuk in manik ya'abach ba'alob tu k'íiwikil koonol	ASPECT:CUS
Te'exe' táan a bine'ex koonol tu k'íiwikil koonol	Táan u bin koonol tu k'íiwikil koonol	PERSON:3_SI
Jweenech ich kool	Jweene'ex ich kool	PERSON:2_PL
Yaan wáaj a bine'ex ich kool	Yaan wáaj u bino'ob ich kool	PERSON:3_PL
Yaan in bisik ch'ujuko'ob tu k'íiwikil koonol	Yaan in jaantik ch'ujuko'ob tu k'íiwikil koonol	MARK:T
To'one' ti' k taali'	Teche' ti' a taali'	PERSON:2_SI
Tu'ux k'íiwikil koonol suuk a jóok'ol koonol	Tu'ux k'íiwikil koonol yaan a jóok'ol koonol	ASPECT:COM
Táan u bin koonol tu k'íiwikil koonol	Te'exe' táan a bine'ex koonol tu k'íiwikil koonol	PERSON:2_PL
Yaan u suut tu naajil xook	Yaan u suuto'ob tu naajil xook	PERSON:3_PL
Leti'e' kajakbal weye'	Teche' kajakbalech weye'	PERSON:2_SI
Leti'e' áak'ab ku bin tu k'íiwikil koonol	Te'exe' áak'ab ka bine'ex tu k'íiwikil koonol	PERSON:2_PL
Tu meentiko'ob janal ich kool	Ta meentike'ex janal ich kool	PERSON:2_PL
Ma' jach k'a'abéet u bino'ob tu k'íiwikil koonoli'	Ma' jach k'a'abéet a bine'ex k'íiwikil koonoli'	PERSON:2_PL
Kaaldo wa esten kaax ku kíinsa'ale'	Kaaldo wa esten kaax ku kíinsa'ale'	NOCHANGE
Ka wiliken merkaado	Kin wilike'ex merkaado	PERSON:1_PL
Kaajlo'ob tu'ux eee jach a'ik aja'an u tuukulo'obe' tumeen je'el bix ti'al klu'umil to'on kintaana roj	Kaajlo'ob tu'ux eee jach a'ik aja'an u tuukulo'obe' tumeen je'el bix ti'al klu'umil to'on kintaana roj	NOCHANGE
Leti'e' yaan xook ti' español	To'onen yaanto'on xook ti' español	PERSON:1_PL
Je'el in manik ya'abach ba'alob tu k'íiwikil koonole'	Táan in manik ya'abach ba'alob tu k'íiwikil koonol	ASPECT:PRG
Tak'ik yóok'ol bey u chan maake'	Tak'ik yóok'ol bey u chan maake'	NOCHANGE
Táan wáaj u xook tu naajil xook	Táan wáaj k xook tu naajil xook	PERSON:1_PL
Tu kaxtik a najil	Tu kaxko'ob a najil	PERSON:3_PL
Leti'obe' u k'aaba'obe'	Leti'e' u k'aaba'e'	ASPECT:HAB;PERSON:3_SI
Ti'al le pixano'obo'	Ti'al le pixano'obo'	NOCHANGE
Jweene'ex merkaado	Jweeno'ob merkaado	PERSON:3_PL
Leti'e' áak'ab ku bin merkaado	Te'exe' áak'ab ka bine'ex merkaado	PERSON:2_PL
Ma' táan a bin koonol merkaadoi'	Ma' táan a bine'ex koonol merkaadoi'	PERSON:2_PL
Yaan k báaxal tu naajil báaxal	Yaan u báaxal tu naajil báaxal	PERSON:3_SI
Te'exe' ajkoonole'ex ichil merkaado	Leti'e' ajkoonol ichil merkaado	PERSON:3_SI
Ku ya'ala'alo'	Ku ya'ala'alo'	NOCHANGE
Ma' tin wiliko'ob tu k'íiwikil koonol	Ma' ta wiliken tu k'íiwikil koonol	PERSON:2_SI
Suuk in manik ya'abach ba'alob tu k'íiwikil koonol	Táant in manik ya'abach ba'alo'ob tu k'íiwikil koonole'	ASPECT:IMM;TENSE:PAS_SIM
ka ts'íib tu naajil xook	ka ts'íibe'ex tu naajil xook	PERSON:2_PL
Ma' ya'ab ku beetiki' tumeen to'one' mas ki' k-u'uyik le	Ma' ya'ab ku beetiki' tumeen to'one' mas ki' k-u'uyik le	NOCHANGE
Yaan wáaj u bino'ob ich kool	Yaan wáaj a bine'ex ich kool	PERSON:2_PL
Ma' wáaj jach k'a'abéet u bino'ob merkaadoi'	Ma' wáaj jach k'a'abéet u bin merkaadoi'	PERSON:3_SI
Táan wáaj u bino'ob koonol tu k'íiwikil koonol	Táan wáaj u bino'ob koonol tu k'íiwikil koonol	PERSON:3_PL
Táan u bin koonol tu k'íiwikil koonol	Leti'obe' táan u bino'ob koonol tu k'íiwikil koonol	PERSON:3_PL
Leti'obe' ts'oka'an wáaj u beelo'ob	Te'exe' ts'oka'an wáaj a beele'ex	PERSON:2_PL
Ka binij ka jo'op' u bin bin tu kuchaj u u chan nook ba'alo'ob beyo' jump'íit chan jaanal tu kaxtaj beyo'  tu kuchaj	Ka binij ka jo'op' u bin bin tu kuchaj u u chan nook ba'alo'ob beyo' jump'íit chan jaanal tu kaxtaj beyo'  tu kuchaj	NOCHANGE
Jach wáaj k'a'abéet in bin k'íiwikil koonol	Jach k'a'abéet wáaj u bino'ob tu k'íiwikil koonol	PERSON:3_PL
Jach k'a'abéet u bin tu k'íiwikil koonol	Jach k'a'abéet in bin tu k'íiwikil koonol	PERSON:1_SI
Te'exe' táan a bine'ex koonol tu k'íiwikil koonol	Táan a bin koonol tu k'íiwikil koonol	PERSON:2_SI
Ma' táan a bine'ex koonol merkaadoi'	Ma' táan u bin koonol merkaadoi'	PERSON:3_SI
Leti'e' ti' u taali'	Te'exe' ti' a taale'exi'	PERSON:2_PL
Ma' tu yilo'ob u sáastal tu kaajalo'obi'	Ma' ta wilaj u sáastal ta kaajali'	PERSON:2_SI
Nukuch waaj ku beeta'al túutil waaj ma' túutil waaji' le  nukuch waaj ku beeta'al yéetel le	Nukuch waaj ku beeta'al túutil waaj ma' túutil waaji' le  nukuch waaj ku beeta'al yéetel le	NOCHANGE
Yaan u boono'ob tu naajil xook	Yaan a boon tu naajil xook	PERSON:2_SI
K'iine' yaan ami' yaan k'iine' yaan ba'alo'obe' pues k'aa'an a tseliki'	K'iine' yaan ami' yaan k'iine' yaan ba'alo'obe' pues k'aa'an a tseliki'	NOCHANGE
Máax yéetel je'el a bin koonol tu kúuchil báaxale'	Máax yéetel táan a bin koonol tu kúuchil báaxal	SUBTYPE:DEC;ASPECT:PRG
Teche' áak'ab ka bin merkaado	Te'exe' áak'ab ka bine'ex merkaado	PERSON:2_PL
Ee esten ku bin u béeytal bin u jaantiko'ob te'ej bej bin táan u bino'obo'	Ee esten ku bin u béeytal bin u jaantiko'ob te'ej bej bin táan u bino'obo'	NOCHANGE
Suuk in bin koonol tu k'íiwikil koonol	Yaan in bin koonol tu k'íiwikil koonol	ASPECT:COM
To'one' áak'ab kek bin merkaado	Te'exe' áak'ab ka bine'ex merkaado	PERSON:2_PL
Kib de koloores ti' le mejen paalalo'obo' ti' le nukuch máako'obo' box kib	Kib de koloores ti' le mejen paalalo'obo' ti' le nukuch máako'obo' box kib	NOCHANGE
Ma' wáaj tu bin merkaado	Ma' wáaj ta bine'ex merkaado	PERSON:2_PL
Ba'ax ja'abil jsíijo'ob	Ba'ax ja'abil jsíije'ex	PERSON:2_PL
Jach k'a'abéet u bin tu k'íiwikil koonol	Jach k'a'abéet a bine'ex tu k'íiwikil koonol	PERSON:2_PL
Teche' ka báaxal paarkée	Leti'e' ku báaxal paarkée	PERSON:3_SI
Táan wáaj u bin koonol tu k'íiwikil koonol	Táan wáaj a bine'ex koonol tu k'íiwikil koonol	PERSON:2_PL
Tu ts'ook le bejo'	Tu ts'ook le bejo'	NOCHANGE
Táan k bin koonol merkaado	Táan a bin koonol merkaado	PERSON:2_SI
Ka t'aan kex wa ma' k'a'abéet u p'áatal u yu'ubo'	Ka t'aan kex wa ma' k'a'abéet u p'áatal u yu'ubo'	NOCHANGE
Tu yilo'ob wáaj u sáastal tu kaajalo'ob	Tu yilaj wáaj u sáastal tu kaajal	PERSON:3_SI
Jach ma'ach u buuts'ilaankilo' k'ana'an u kanáanta'ale' ma' u	Jach ma'ach u buuts'ilaankilo' k'ana'an u kanáanta'ale' ma' u	NOCHANGE
Táan wáaj a boone'ex xook tu naajil xook	Táan wáaj u boono'ob tu naajil xook	PERSON:3_PL
Leeti' bine' ma' tu meentaj kueenta te'el tu'ux ku	Leeti' bine' ma' tu meentaj kueenta te'el tu'ux ku	NOCHANGE
ka ts'íibe'ex tu naajil xook	ku ts'íibo'ob tu naajil xook	PERSON:3_PL
Ku beeta'al ti'al u k'a'ajsa'al le le	Ku beeta'al ti'al u k'a'ajsa'al le le	NOCHANGE
Ook'in u bino'ob tu koolo'ob	Ook'in a bine'ex ta koole'ex	PERSON:2_PL
K'a'abéet in manik ya'abach ba'alob tu k'íiwikil koonol	Táan in manik ya'abach ba'alob tu k'íiwikil koonol	ASPECT:PRG
Te'exe' jbúule'ex	To'one' jbúulo'on	PERSON:1_PL
Tak túun tu láak' kíin túune' ku yiliko'ob wa k'áax ja' wa ma' k'áax ja' tia'l u yaantal le nalo'	Tak túun tu láak' kíin túune' ku yiliko'ob wa k'áax ja' wa ma' k'áax ja' tia'l u yaantal le nalo'	NOCHANGE
Ma' taak in bin maan tu k'íiwikil koonoli'	Ma' k'a'abéet in bin maan tu k'íiwikil koonoli'	ASPECT:OBL
Tek núukaj buka'aj k ja'abil	Tu núukaj buka'aj u ja'abilo'ob	PERSON:3_PL
Ma' táan u bin ich kooli'	Ma' táan u bino'ob ich kooli'	PERSON:3_PL
Yaan wáaj u bin koonol merkaado	Yaan wáaj a bine'ex koonol merkaado	PERSON:2_PL
Ku ts'áabal túun sebooyai' ku ts'áabal aajoi'	Ku ts'áabal túun sebooyai' ku ts'áabal aajoi'	NOCHANGE
Ti' ka pakto'ob wa ka kulakech a wil u jaanal	Ti' ka pakto'ob wa ka kulakech a wil u jaanal	NOCHANGE
Wa le máax meyajtiko'ob le ch'a'aj cháako'	Wa le máax meyajtiko'ob le ch'a'aj cháako'	NOCHANGE
Táan ek kaxtik a najil	Tan k kaxtik a najil	PERSON:1_PL
Táan wáaj u bino'ob koonol merkaado	Táan wáaj a bine'ex koonol merkaado	PERSON:2_PL
Ma' jach k'a'abéet wáaj u bino'ob tu k'íiwikil koonoli'	Ma' jach k'a'abéet wáaj u bin tu k'íiwikil koonoli'	PERSON:3_SI
Teche' ma' jbúulechi'	To'one' ma' jbúulo'oni'	PERSON:1_PL
Yaan a ts'áaik sujuy nook' saki'	Yaan a ts'áaik sujuy nook' saki'	NOCHANGE
Ma' táan u bino'ob ich kooli'	Ma' táan a bin ich kooli'	PERSON:2_SI
Táan u boono'ob tu naajil xook	Táan a boone'ex xook tu naajil xook	PERSON:2_PL
Yaan wáaj u bino'ob koonol merkaado	Yaan wáaj a bin koonol merkaado	PERSON:2_SI
Ku yiko'ob túune' ti' bin pekekbal le chan xnuk tun  bin beya' chilikbal bin	Ku yiko'ob túune' ti' bin pekekbal le chan xnuk tun  bin beya' chilikbal bin	NOCHANGE
Ma' jach k'a'abéet a bine'ex k'íiwikil koonoli'	Ma' jach k'a'abéet u bin k'íiwikil koonoli'	PERSON:3_SI
Ts'o'ok a juch'ik  a k'u'um ts'o'ok a p'o'ok a k'u'um ts'o'ok a juch'ik a k'u'uk	Ts'o'ok a juch'ik  a k'u'um ts'o'ok a p'o'ok a k'u'um ts'o'ok a juch'ik a k'u'uk	NOCHANGE
Táan a xook tu naajil xook	Táan u xooko'ob tu naajil xook	PERSON:3_PL
Máax yéetel k'a'abéet a bin koonol tu kúuchil báaxal	Máax yéetel táan a bin koonol tu kúuchil báaxal	SUBTYPE:DEC;ASPECT:PRG
Tumeen le ba'ax bin je'elo' tats' máan bin ku meeti u yóol le ts'oon ti' ma'atáan u kíinsa'al de por si leeti'e'e ma' ts'áab ti' kíinsbili'	Tumeen le ba'ax bin je'elo' tats' máan bin ku meeti u yóol le ts'oon ti' ma'atáan u kíinsa'al de por si leeti'e'e ma' ts'áab ti' kíinsbili'	NOCHANGE
Ma' táan u bin koonol merkaadoi'	Ma' táan u bino'ob koonol merkaadoi'	PERSON:3_PL
Ch'ujuk waaj	Ch'ujuk waaj	NOCHANGE
Jach k'a'abéet wáaj a bine'ex tu k'íiwikil koonol	Jach k'a'abéet wáaj u bino'ob tu k'íiwikil koonol	PERSON:3_PL
Teche' ts'oka'an wáaj a beel	Te'exe' ts'oka'an wáaj a beele'ex	PERSON:2_PL
Bey jach jaaj le xi'ipal bin u kaxtej  u t'aak'ine' tu ganarta túun bey leeti' ook te'el naj tu yilaj máax le ts'ajaan te'el najo'	Bey jach jaaj le xi'ipal bin u kaxtej  u t'aak'ine' tu ganarta túun bey leeti' ook te'el naj tu yilaj máax le ts'ajaan te'el najo'	NOCHANGE
To'one' in k'aaba'one'	Te'exe' a k'aaba'exe'	ASPECT:HAB;PERSON:2_PL
Táan in manik ya'abach ba'alob tu k'íiwikil koonol	Ts'o'ok in manik ya'abach ba'alob tu k'íiwikil koonol	ASPECT:TER;TENSE:PAS_SIM
Ma' suuk in bin maan tu k'íiwikil koonoli'	Ma' taak in bin maan tu k'íiwikil koonoli'	ASPECT:DES
Ma' jach k'a'abéet wáaj a bine'ex k'íiwikil koonoli'	Ma' jach k'a'abéet wáaj u bin tu k'íiwikil koonoli'	PERSON:3_SI
Jach k'a'abéet a bine'ex tu k'íiwikil koonol	Jach k'a'abéet u bin tu k'íiwikil koonol	PERSON:3_SI
Yaan wáaj u bin koonol tu k'íiwikil koonol	Yaan wáaj u bino'ob koonol tu k'íiwikil koonol	PERSON:3_PL
Ba'ax ja'abil jsíijij	Ba'ax ja'abil jsíije'ex	PERSON:2_PL
Tu'ux k'íiwikil koonol taak a jóok'ol koonol	Tu'ux k'íiwikil koonol suuk a jóok'ol koonol	ASPECT:CUS
Te'exe' a jatsmajaba'ex	To'one' k jatsmajekbáaj	PERSON:1_PL
Yaan in suut koonol merkaado	Káaj in suut koonol merkaado	ASPECT:BEG;TENSE:PAS_SIM
Yaan in manik ch'ujuko'ob tu k'íiwikil koonol	Kin manik nikte'ob tu k'íiwikil koonol	ASPECT:HAB
Te'ej ba'al je'el jach	Te'ej ba'al je'el jach	NOCHANGE
Táan u báaxalo'ob tu naajil báaxal	Táan u báaxal tu naajil báaxal	PERSON:3_SI
To'one' ajkoonolo'on	Te'exe' ajkoonole'ex	PERSON:2_PL
To'one' k k'aaba'e'	To'one' in k'aaba'one'	ASPECT:HAB;PERSON:1_PL
Ts'oka'an wáaj a beel	Ts'oka'an wáaj k beel	PERSON:1_PL
Kin in suut koonol merkaado	Ts'o'ok in suut koonol merkaado	ASPECT:TER;TENSE:PAS_SIM
Suuk in manik ya'abach ba'alob tu k'íiwikil koonol	Yaan in manik ya'abach ba'alob tu k'íiwikil koonol	ASPECT:COM
Ma' k'aja'anti'ob buka'aj u ja'abilo'obi'	Ma' k'aja'anti' buka'aj u ja'abili'	PERSON:3_SI
Ku ts'áabal túun xan le ki'ibo'obo'	Ku ts'áabal túun xan le ki'ibo'obo'	NOCHANGE
Ta'aytak k chukik u ja'abil	Ta'aytak a chukik u ja'abil	PERSON:2_SI
Táan wáaj ek bin ich kool	Táan wáaj u bin ich kool	PERSON:2_SI
To'one' ti' in taalo'oni'	Te'exe' ti' a taale'exi'	PERSON:2_PL
Ma' kajakbale'ex tin wotochi'	Mix to'on kajakbalo'on ta wotoch	PERSON:1_PL
Le jaanal pixan ka beetik bey ti' leeti'o'obo'	Le jaanal pixan ka beetik bey ti' leeti'o'obo'	NOCHANGE
Le táasche'o'ob beeta'abo'	Le táasche'o'ob beeta'abo'	NOCHANGE
Te'exe' ti' a taale'exi'	Teche' ti' a taali'	PERSON:2_SI
Ma' kajakbalo'ob tin wotochi'	Ma' kajakbalech tin wotochi'	PERSON:2_SI
Yaan wáaj u bino'ob koonol merkaado	Yaan wáaj a bine'ex koonol merkaado	PERSON:2_PL
Tan k kaxtik a najil	Tu kaxtik a najil	PERSON:3_SI
Tu lákaal ts'áab ti' jach jaaj ayik'alchaj bin tak leeti'	Tu lákaal ts'áab ti' jach jaaj ayik'alchaj bin tak leeti'	NOCHANGE
Te'ej meesao' wa te'ej kúuchil tu'ux ken a	Te'ej meesao' wa te'ej kúuchil tu'ux ken a	NOCHANGE
Suuk in bin koonol tu k'íiwikil koonol	Taak in bin koonol tu k'íiwikil koonol	ASPECT:DES
In natsil tene' ma' jach chen tu chan p'íis yóoks'al ki'ibok le juch'o' chen ba'al' ma' jach	In natsil tene' ma' jach chen tu chan p'íis yóoks'al ki'ibok le juch'o' chen ba'al' ma' jach	NOCHANGE
Leti'e' ti' kajakbal tu yotoche'	Leti'obe' ti' kajakbalo'ob tu yotoche'	PERSON:3_PL
Táan a meyaje'ex ich kool	Táan u meyajo'ob ich kool	PERSON:3_PL
Taak in manik ya'abach ba'alo'ob tu k'íiwikil koonol	Yaan in manik ya'abach ba'alob tu k'íiwikil koonol	ASPECT:COM
Leti'obe' táan u bino'ob koonol tu k'íiwikil koonol	Táan u bin koonol tu k'íiwikil koonol	PERSON:3_SI
Táan wáaj u bin koonol tu k'íiwikil koonol	Táan wáaj u bin koonol tu k'íiwikil koonol	PERSON:3_SI
Yaan u xooko'ob tu naajil xook	Yaan u xook tu naajil xook	PERSON:3_SI
Ka'abeje' yaan u bino'ob koonol	Ka'abeje' yaan a bine'ex koonol	PERSON:2_PL
Yaan wáaj u báaxalo'ob tu naajil báaxal	Yaan wáaj a báaxale'ex báaxal tu naajil báaxal	PERSON:2_PL
Ma' ta wu'uyike'ex ooxoli'	Ma' ta wu'uyik ooxoli'	PERSON:2_SI
Ma' táan u bino'ob koonol tu k'íiwikil koonol	Leti'e' ma' táan u bin koonol tu k'íiwikil koonol	PERSON:3_SI
K'a'abéet in wilikech te' tu kúuchil báaxalo'	Kin wilikech te' tu kúuchil báaxalo'	ASPECT:HAB
Leti'o'obe' ku yu'ubiko'ob ooxol	To'one' k u'uyik wáaj ooxol	PERSON:1_PL
Táan wáaj u bino'ob koonol tu k'íiwikil koonol	Táan wáaj u bin koonol tu k'íiwikil koonol	PERSON:3_SI
Ts'o'okol túune'	Ts'o'okol túune'	NOCHANGE
Ma' tan a k'íilkabi'	Ma' tan u k'íilkabi'	PERSON:3_SI
Te'exe' ts'oka'an wáaj a beele'ex	Teche' ts'oka'an wáaj a beel	PERSON:2_SI
ka ts'íibe'ex tu naajil xook	ka ts'íib tu naajil xook	PERSON:2_SI
Je'el in manik ya'abach ba'alob tu k'íiwikil koonole'	K'a'abéet in manik ya'abach ba'alob tu k'íiwikil koonol	ASPECT:OBL
Yaan u xooko'ob tu naajil xook	Yaan a xook tu naajil xook	PERSON:2_SI
Táan in manik ya'abach ba'alob tu k'íiwikil koonol	Yaan in manik ya'abach ba'alob tu k'íiwikil koonol	ASPECT:COM
Le ken sáasak beya' pues  le wíinko'ob eee	Le ken sáasak beya' pues  le wíinko'ob eee	NOCHANGE
To'one' k u'uyik wáaj ooxol	ku yu'ubik wáaj ooxol	PERSON:3_SI
Máax kun náats'al bin te'el naj tbino' de kiinsbil u meentik tumeen leetie'  ma' u k'áat ka ojéelta'ak  tun bin	Máax kun náats'al bin te'el naj tbino' de kiinsbil u meentik tumeen leetie'  ma' u k'áat ka ojéelta'ak  tun bin	NOCHANGE
Este le chan láak'tsilo'ob bin je'el bino' tu biso'ob juntúul chan paal	Este le chan láak'tsilo'ob bin je'el bino' tu biso'ob juntúul chan paal	NOCHANGE
Ma' tu yilaj u sáastal tu kaajali'	Ma' tu yilo'ob u sáastal tu kaajalo'obi'	PERSON:3_PL
Te'exe' ti' kajakbale'ex tu yotoche'	Leti'obe' ti' kajakbalo'ob tu yotoche'	PERSON:3_PL
Leti'obe' ts'oka'an wáaj u beelo'ob	Leti'e' ts'oka'an wáaj u beel	PERSON:3_SI
Ma' a wojele'ex u ja'abili'	Ma' u yojel u ja'abili'	PERSON:3_SI
To'one' ts'oka'an wáaj k beel	Teche' ts'oka'an wáaj a beel	PERSON:2_SI
Te'exe' ma' jbúule'ex wáaj	To'one' ma' jbúulo'on wáaj	PERSON:1_PL
Tsikbalte ti' teen bix kuxlik ka'ach e úuchben maayao'obo'	Tsikbalte ti' teen bix kuxlik ka'ach e úuchben maayao'obo'	NOCHANGE
Pues yéetel tu kanáantubáao'ob yéetel tuu jóok'o'ob xan	Pues yéetel tu kanáantubáao'ob yéetel tuu jóok'o'ob xan	NOCHANGE
Suuk in suut koonol merkaado	Káaj in suut koonol merkaado	ASPECT:BEG;TENSE:PAS_SIM
Ma' ts'oka'an a beele'exi'	Ma' ts'oka'an k beeli'	PERSON:1_PL
Ma' táan u bin koonol merkaadoi'	Ma' táan a bin koonol merkaadoi'	PERSON:2_SI
Táan in wilike' ya'ab le ya'ab le tsikbal tuuso'ob ku meenta'al bey tu yóok'sal le e'boobo'	Táan in wilike' ya'ab le ya'ab le tsikbal tuuso'ob ku meenta'al bey tu yóok'sal le e'boobo'	NOCHANGE
Ma' táan u bino'ob koonol merkaadoi'	Ma' táan a bine'ex koonol merkaadoi'	PERSON:2_PL
Ee ba'axo'ob máax kun ts'áaik	Ee ba'axo'ob máax kun ts'áaik	NOCHANGE
Puro láaj wa ka wile'  láaj u yich éespañooleso'ob yaan ti'	Puro láaj wa ka wile'  láaj u yich éespañooleso'ob yaan ti'	NOCHANGE
Ma'k  ichil bin bey u ya'alik bin bey te'ej máako'obo' ka bin cha'ab u bin ka a'ala'ab bin ti'e' - yaan in yaan in wiko'on tu'ux ka bin- ki bin	Ma'k  ichil bin bey u ya'alik bin bey te'ej máako'obo' ka bin cha'ab u bin ka a'ala'ab bin ti'e' - yaan in yaan in wiko'on tu'ux ka bin- ki bin	NOCHANGE
Je'elo' ku ts'áabal túun ku laj	Je'elo' ku ts'áabal túun ku laj	NOCHANGE
Ka'abeje' yaan a bin koonol	Ka'abeje' yaan a bine'ex koonol	PERSON:2_PL
Táan a xooke'ex xook tu naajil xook	Táan u xooko'ob tu naajil xook	PERSON:3_PL
Yaan in suut koonol merkaado	Ts'o'ok in suut koonol merkaado	ASPECT:TER;TENSE:PAS_SIM
To'one' ti' k taali'	Leti'e' ti' u taali'	PERSON:3_SI
Táan ek kaxtik a najil	Táan u kaxtiko'ob a naajil	PERSON:3_PL
Ma' k'aja'ante'ex buka'aj a ja'abile'exi'	Ma' k'aja'antech buka'aj a ja'abili'	PERSON:2_SI
Yaan u jochiko'ob chak nal tu koolo'ob	Yaan a jochike'ex chak nal ta koole'ex	PERSON:2_PL
Jach k'a'abéet in bin tu k'íiwikil koonol	Jach k'a'abéet u bin tu k'íiwikil koonol	PERSON:3_SI
Kin bin koonol tu k'íiwikil koonol	Taak in bin koonol tu k'íiwikil koonol	ASPECT:DES
Relijioon katoolika ku ya'ala'alo' ichil túun	Relijioon katoolika ku ya'ala'alo' ichil túun	NOCHANGE
Ma' táan k bin koonol tu k'íiwikil koonol	Ma' táan a bin koonol tu k'íiwikil koonol	PERSON:2_SI
Ma' tu yu'ubiko'ob ooxoli'	Ma' ta wu'uyik ooxoli'	PERSON:2_SI
Nukuch waajo'ob xaan u tajalo' chúumuk ku ts'áabal	Nukuch waajo'ob xaan u tajalo' chúumuk ku ts'áabal	NOCHANGE
Ma' táan ek bin ich kooli'	Ma' táan a bine'ex ich kooli'	PERSON:2_PL
Ma' k'aja'anti' buka'aj u ja'abili'	Ma' k'aja'anti'ob buka'aj u ja'abilo'obi'	PERSON:3_PL
Táan k suut tu naajil xook	Táan u suut tu naajil xook	PERSON:3_SI
Bejla'ake' eeebeyo' pues	Bejla'ake' eeebeyo' pues	NOCHANGE
Táan u bin koonol tu k'íiwikil koonol	Táan k bin koonol tu k'íiwikil koonol	PERSON:1_PL
Táan wáaj u boono'ob tu naajil xook	Táan wáaj k boon tu naajil xook	PERSON:1_PL
k'a'abéet in bin koonol tu k'íiwikil koonol	Yaan in bin koonol tu k'íiwikil koonol	ASPECT:COM
Jach wáaj k'a'abéet u bin merkaado	Jach wáaj k'a'abéet u bino'ob merkaado	PERSON:3_PL
Ustako'obo' ti'al u ts'áaj te'ej yóok'ol le meesao' ti'al xan u payalchi'ita'al	Ustako'obo' ti'al u ts'áaj te'ej yóok'ol le meesao' ti'al xan u payalchi'ita'al	NOCHANGE
Yaan wáaj u bino'ob ich kool	Yaan wáaj a bin ich kool	PERSON:2_SI
Yaan u báaxal tu naajil báaxal	Yaan k báaxal tu naajil báaxal	PERSON:1_PL
Yaan in manik ya'abach ba'alob tu k'íiwikil koonol	Táan in manik ya'abach ba'alob tu k'íiwikil koonol	ASPECT:PRG
Te'exe' ti' kajakbale'ex tu yotoche'	Leti'e' ti' kajakbal tu yotoche'	PERSON:3_SI
Te' u taalo'ob tu kaajil Kopomae'	Te' a taal tu kaajil Kopomae'	PERSON:2_SI
Te' a taale'ex tu kaajil Kopomae'	Te' k taal tu kaajil Kopomae'	PERSON:1_PL
Jweeno'ob ich kool	Jweenech ich kool	PERSON:2_SI
Táan a xook tu naajil xook	Táan k xook tu naajil xook	PERSON:1_PL
Táan wáaj a bine'ex ich kool	Táan wáaj u bino'ob ich kool	PERSON:3_PL
Leti'e' yaan xook ti' español	Te'exe' yaante'ex xook ti' español	PERSON:2_PL
Táan u kaxtik a najil	Tu kaxko'ob a najil	PERSON:3_PL
Ta'aytak u chukiko'ob u ja'abil	Ta'aytak a chukike'ex u ja'abil	PERSON:2_PL
Ma' u yojel u ja'abili'	Ma' k ojel u ja'abili'	PERSON:1_PL
Ts'oka'an wáaj u beel	Ts'oka'an wáaj a beele'ex	PERSON:3_PL
Kin manik nikte'ob tu k'íiwikil koonol	Táant in manik ch'ujuk pak'áal tu k'íiwikil koonole'	ASPECT:IMM;TENSE:PAS_SIM
Ma' ta wile'ex u sáastal ta kaajale'exi'	Ma' tak ilaj u sáastal k kaajali'	PERSON:1_PL
Teche' ajkoonolech	Te'exe' ajkoonole'ex	PERSON:2_PL
To'one' jbúulo'on	Leti'e' jbúulij	PERSON:3_SI
U jóok'sa'al túun le píibo' ts'o'ok u jóok'sa'al bey le píibo'	U jóok'sa'al túun le píibo' ts'o'ok u jóok'sa'al bey le píibo'	NOCHANGE
Te'exe' ts'oka'an wáaj a beele'ex	To'one' ts'oka'an wáaj k beel	PERSON:1_PL
Ma' táan u bino'ob koonol tu k'íiwikil koonol	Leti'e' ma' táan u bin koonol tu k'íiwikil koonol	PERSON:3_SI
Táan k bin koonol merkaado	Táan u bino'ob koonol merkaado	PERSON:3_PL
Táan u kaxtik a najil	Táan u kaxtiko'ob a naajil	PERSON:3_PL
Ma' ta wilaj u sáastal ta kaajali'	Ma' ta wile'ex u sáastal ta kaajale'exi'	PERSON:2_PL
Yaan u ba'alil u ni'o'ob ki ten	Yaan u ba'alil u ni'o'ob ki ten	NOCHANGE
Ma' ts'oka'an in beeli'	Tene' ma' ts'oka'an in beeli'	TYPE:NEG;SUBTYPE:DEC
Yóok'sal táan u báaxtik le baak le e	Yóok'sal táan u báaxtik le baak le e	NOCHANGE
Ook'in a bine'ex k'íiwikil koonol	Ook'in u bino'ob k'íiwikil koonol	PERSON:3_PL
Táan u boon tu naajil xook	Táan k boon tu naajil xook	PERSON:1_PL
Máan xan yaan maantekai' tumeen	Máan xan yaan maantekai' tumeen	NOCHANGE
To'one' ti' k taali'	Leti'obe' ti' u taalo'obi'	PERSON:3_PL
Yaan in suut koonol merkaado	Suuk in suut koonol merkaado	ASPECT:CUS
Leti'obe' ku báaxalo'ob paarkée	Leti'e' ku báaxal paarkée	PERSON:3_SI
Le ch'a'aj cháako' ku beeta'al beya'	Le ch'a'aj cháako' ku beeta'al beya'	NOCHANGE
Máax yéetel je'el a bin koonol tu kúuchil báaxale'	Máax yéetel k'a'abéet a bin koonol tu kúuchil báaxal	SUBTYPE:DEC;ASPECT:OBL
Mix to'on kajakbalo'on ta wotoch	Mix teech kajakbalech ta wotoch	PERSON:2_SI
Xtok'tuunichi' yaan jump'éel tuuniche' xtok' tuunich  ya'ala'ale' le beyo'	Xtok'tuunichi' yaan jump'éel tuuniche' xtok' tuunich  ya'ala'ale' le beyo'	NOCHANGE
Te' a taal tu kaajil Kopomae'	Te' k taal tu kaajil Kopomae'	PERSON:1_PL
Yaan in k'a'aytik ch'ujuko'ob tu k'íiwikil koonol	Yaan in bisik ch'ujuko'ob tu k'íiwikil koonol	MARK:S
Táan wáaj a bine'ex koonol tu k'íiwikil koonol	Táan wáaj u bin koonol tu k'íiwikil koonol	PERSON:3_SI
Yaan le kya'ala kojunlich yaan le kya'ala'al esten	Yaan le kya'ala kojunlich yaan le kya'ala'al esten	NOCHANGE
Teche' ts'oka'an wáaj a beel	To'one' ts'oka'an wáaj k beel	PERSON:1_PL
Leti'e' ajkoonol ichil merkaado	Teche' ajkoonolech ichil merkaado	PERSON:2_SI
Chen ba'axe' teen kin tukultik túun beyo' wa ya'ab máax ka u kan u meente'	Chen ba'axe' teen kin tukultik túun beyo' wa ya'ab máax ka u kan u meente'	NOCHANGE
Ti' leeti'o'obe' le taak'ino' le ooroso' ee jach nojbe'en ti' leeti'o'ob	Ti' leeti'o'obe' le taak'ino' le ooroso' ee jach nojbe'en ti' leeti'o'ob	NOCHANGE
Te'exe' ka báaxale'ex paarkée	Leti'obe' ku báaxalo'ob paarkée	PERSON:3_PL
Yaan u boono'ob tu naajil xook	Yaan k boon tu naajil xook	PERSON:1_PL
Máax ba'axe' ku yáax cho'ik te'ej juuch'	Máax ba'axe' ku yáax cho'ik te'ej juuch'	NOCHANGE
Yaan wáaj u bino'ob koonol tu k'íiwikil koonol	Yaan wáaj k bin koonol tu k'íiwikil koonol	PERSON:1_PL
Yaan wáaj a bin koonol tu k'íiwikil koonol	Yaan wáaj u bin koonol tu k'íiwikil koonol	PERSON:3_SI
Leti'o'obe' bino'ob áalkab te' taam paarkéeo'	Leti'e' bin áalkab te' taam paarkéeo'	PERSON:3_SI
Yaan wáaj u bin ich kool	Yaan wáaj ek bin ich kool	PERSON:1_PL
To'onen yaanto'on xook ti' español	Teche' Yaan tech xook ti' español	PERSON:2_SI
Te'exe' a k'aaba'exe'	To'one' in k'aaba'one'	ASPECT:HAB;PERSON:1_PL
To'one' ma' jbúulo'oni'	Leti'e' ma' jbúuli'	PERSON:3_SI
Leti' túun le máako'ob le wiít'o'ob  yéetel le esten le e	Leti' túun le máako'ob le wiít'o'ob  yéetel le esten le e	NOCHANGE
Táan k bin koonol tu k'íiwikil koonol	Te'exe' táan a bine'ex koonol tu k'íiwikil koonol	PERSON:2_PL
Le bix u meeta'ale' ee	Le bix u meeta'ale' ee	NOCHANGE
Jach mix  ma' utsi'	Jach mix  ma' utsi'	NOCHANGE
Táan k boon tu naajil xook	Táan a boon tu naajil xook	PERSON:2_SI
Yaan k xook tu naajil xook	Yaan a xook tu naajil xook	PERSON:2_SI
Yaan k suut tu naajil xook	Yaan a suute'ex xook tu naajil xook	PERSON:2_PL
Táan a suut tu naajil xook	Táan a suute'ex xook tu naajil xook	PERSON:2_PL
Táan a boone'ex xook tu naajil xook	Táan k boon tu naajil xook	PERSON:1_PL
Jach k'a'abéet a bine'ex merkaado	Jach k'a'abéet in bin merkaado	PERSON:1_SI
Yaan in jaantik ch'ujuko'ob tu k'íiwikil koonol	Yaan in bisik ch'ujuko'ob tu k'íiwikil koonol	MARK:S
Ma' tan u k'íilkabi'	Ma' tan a k'íilkabe'exi'	PERSON:2_PL
U tuukul xan leeti'o'obe' je'el u bee u beeytal kp'áatlo'on kjéets'lo'on way tak lu'ume'	U tuukul xan leeti'o'obe' je'el u bee u beeytal kp'áatlo'on kjéets'lo'on way tak lu'ume'	NOCHANGE
Táan wáaj a bine'ex koonol tu k'íiwikil koonol	Táan wáaj u bino'ob koonol tu k'íiwikil koonol	PERSON:3_PL
Ku p'ayko'ob ti'al u ts'áao'ob k'áak' yéetel ja' ti'al u chakiko'ob	Ku p'ayko'ob ti'al u ts'áao'ob k'áak' yéetel ja' ti'al u chakiko'ob	NOCHANGE
To'one' kek bin paak'áal ich kool	Leti'e' ku bin paak'áal ich kool	PERSON:3_SI
Jayp'éel k'iino'ob ku bino'ob merkaado	Jayp'éel k'iino'ob ku bin merkaado	PERSON:3_SI
P'elik  láaj u mejen le' ken a jóok's beyo'	P'elik  láaj u mejen le' ken a jóok's beyo'	NOCHANGE
Táan a suute'ex xook tu naajil xook	Táan u suuto'ob tu naajil xook	PERSON:3_PL
Yaan wáaj u xooko'ob tu naajil xook	Yaan wáaj a xooke'ex xook tu naajil xook	PERSON:2_PL
Leti'e' u k'aaba'e'	Leti'obe' u k'aaba'obe'	ASPECT:HAB;PERSON:3_PL
To'one' áak'ab kek bin merkaado	Teche' áak'ab ka bin merkaado	PERSON:2_SI
Teche' ma' jbúulechi'	Leti'e' ma' jbúuli'	PERSON:3_SI
To'one' ma' wáaj áak'ab kek bin merkaadoi'	Leti'e' ma' wáaj áak'ab ku bin merkaadoi'	PERSON:3_SI
Teche' ajkoonolech	Leti'e' ajkoonol	PERSON:3_SI
Ka t'óot'ik te'ej bejo' leeti' ken a láaj t'o'ot' te'ej bej  tu'ux	Ka t'óot'ik te'ej bejo' leeti' ken a láaj t'o'ot' te'ej bej  tu'ux	NOCHANGE
Teche' a k'aaba'e'	Leti'obe' u k'aaba'obe'	ASPECT:HAB;PERSON:3_PL
Yaan k xook tu naajil xook	Yaan a xooke'ex xook tu naajil xook	PERSON:2_PL
Ken k'uchuk le nukuch máako'ob  jach a ti'ilo' bino' le yuum a ti'ile'exo'	Ken k'uchuk le nukuch máako'ob  jach a ti'ilo' bino' le yuum a ti'ile'exo'	NOCHANGE
Táan a meyaje'ex ich kool	Táan a meyaj ich kool	PERSON:2_SI
Taal bin u chu'ukul tun bin le máako'	Taal bin u chu'ukul tun bin le máako'	NOCHANGE
Leti'obe' ti' u taalo'obi'	To'one' ti' k taali'	PERSON:1_PL
Te'exe' a k'aaba'exe'	Teche' a k'aaba'e'	ASPECT:HAB;PERSON:2_SI
Uk'ulo' ku beetiko'ob le nukuch túuto'	Uk'ulo' ku beetiko'ob le nukuch túuto'	NOCHANGE
Te'exe' ka wu'uyike'ex wáaj ooxol	Leti'o'obe' ku yu'ubiko'ob ooxol	PERSON:3_PL
Ma' táan u bin koonol merkaadoi'	Ma' táan k bin koonol merkaadoi'	PERSON:3_PL
Leti'e' ma' wáaj áak'ab ku bin merkaadoi'	Te'exe' ma' wáaj áak'ab ka bine'ex merkaadoi'	PERSON:2_PL
Te'exe' yaante'ex wáaj meyaj ti' biología	Leti'e' yaan wáaj meyaj ti' biología	PERSON:3_SI
Ma' táan u bino'ob koonol tu k'íiwikil koonol	Ma' táan u bino'ob koonol tu k'íiwikil koonol	PERSON:3_PL
Leti'e' ku bin paak'áal ich kool	To'one' kek bin paak'áal ich kool	PERSON:1_PL
Táan u bino'ob koonol merkaado	Táan u bin koonol merkaado	PERSON:3_SI
To'one' ts'oka'an wáaj k beel	Leti'obe' ts'oka'an wáaj u beelo'ob	PERSON:3_PL
Le ku meyajtik le ko'olelo'obo' eee ku meyajtik le máako'obo' ma' tu cha'o'ob in máani'	Le ku meyajtik le ko'olelo'obo' eee ku meyajtik le máako'obo' ma' tu cha'o'ob in máani'	NOCHANGE
Ba'ale' bejla'ake' le p'úujo' ol ol ma'ach u meenta'al	Ba'ale' bejla'ake' le p'úujo' ol ol ma'ach u meenta'al	NOCHANGE
Chen ba'axe' ma' yáax esten	Chen ba'axe' ma' yáax esten	NOCHANGE
Yaan a jochik chak nal ta kool	Yaan ek jochik chak nal tek kool	PERSON:1_PL
Yaan wáaj u bin koonol tu k'íiwikil koonol	Yaan wáaj a bin koonol tu k'íiwikil koonol	PERSON:2_SI
Leti'e' yaan meyaj ti' biología	Teche' Yaan tech meyaj biología	PERSON:2_SI
Ta míistik in najil	Táan a míistik in najil	PERSON:2_SI
Táan a xooke'ex xook tu naajil xook	Táan k xook tu naajil xook	PERSON:1_PL
Ka tu yilaj bin bey ts'o'ok u chu'uul bin bey le máako' lúub u ts'oon túun  bin le máako' le x	Ka tu yilaj bin bey ts'o'ok u chu'uul bin bey le máako' lúub u ts'oon túun  bin le máako' le x	NOCHANGE
Táan a meyaj ich kool	Táan a meyaje'ex ich kool	PERSON:2_PL
Yaan in manik ch'ujuko'ob tu k'íiwikil koonol	Ts'o'ok in manik janal tu k'íiwikil koonol	ASPECT:TER;TENSE:PAS_SIM
Táan a meyaje'ex ich kool	Táan ek meyaj ich kool	PERSON:1_PL
Leti'e' yaan meyaj ti' biología	To'onen yaanto'on meyaj biología	PERSON:1_PL
Ka bin tu yilaj u tíip'il juntúul nuxi' ba'al bin	Ka bin tu yilaj u tíip'il juntúul nuxi' ba'al bin	NOCHANGE
Beey ts'okole' nojoch u ts'a'ay	Beey ts'okole' nojoch u ts'a'ay	NOCHANGE
Táan wáaj u bino'ob ich kool	Táan wáaj ek bin ich kool	PERSON:1_PL
Jach k'a'abéet a bine'ex merkaado	Jach k'a'abéet u bin merkaado	PERSON:3_SI
Teche' a k'aaba'e'	Leti'e' u k'aaba'e'	ASPECT:HAB;PERSON:3_SI
Yaan a xooke'ex xook tu naajil xook	Yaan u xooko'ob tu naajil xook	PERSON:3_PL
Tan k kaxtik a najil	Tu kaxko'ob a najil	PERSON:3_PL
Ma' jach k'a'abéet a bine'ex k'íiwikil koonoli'	Ma' jach k'a'abéet u bino'ob tu k'íiwikil koonoli'	PERSON:3_PL
To'one' bino'on áalkab te' taam paarkéeo'	Leti'e' bin áalkab te' taam paarkéeo'	PERSON:3_SI
Yáanal le mayak che' tu'ux ts'o'ok u láaj ta'asal bey ba'ax ku bisik yóok'ol le	Yáanal le mayak che' tu'ux ts'o'ok u láaj ta'asal bey ba'ax ku bisik yóok'ol le	NOCHANGE
Ka'abeje' yaan a bine'ex koonol merkaado	Ka'abeje' yaan u bino'ob koonol merkaado	PERSON:3_PL
Yaan k báaxal tu naajil báaxal	Yaan u báaxalo'ob tu naajil báaxal	PERSON:3_PL
Ichil le ichil le ch'a'aj cháako'  tak tin kaajale' ku beeta'al le cha'aj cháako' esteen	Ichil le ichil le ch'a'aj cháako'  tak tin kaajale' ku beeta'al le cha'aj cháako' esteen	NOCHANGE
Suuk in suut koonol merkaado	K'a'abéet in suut koonol merkaado	ASPECT:OBL
Táan wáaj k xook tu naajil xook	Táan wáaj a xooke'ex xook tu naajil xook	PERSON:2_PL
Teche' áak'ab ka bin merkaado	To'one' áak'ab kek bin merkaado	PERSON:1_PL
P'a'atal mix jun xéet' che' wa táan u buuts'ilaankili' tumeen je'el u	P'a'atal mix jun xéet' che' wa táan u buuts'ilaankili' tumeen je'el u	NOCHANGE
Yaan wáaj a bin koonol merkaado	Yaan wáaj k bin koonol merkaado	PERSON:1_PL
Tu núukaj buka'aj u ja'abil	Ta núukaje'ex buka'aj a ja'abile'ex	PERSON:2_PL
Ka bin esten tu t'aabaj tu t'abaj je'el bix yoojelil u ta'abal bin  chenba'ale' ka tu ta'abaj tu t'abaj	Ka bin esten tu t'aabaj tu t'abaj je'el bix yoojelil u ta'abal bin  chenba'ale' ka tu ta'abaj tu t'abaj	NOCHANGE
Jbinech yéetel a éetailo'ob merkaado	Jbino'ob yéetel u éetailo'ob merkaado	PERSON:3_PL
Le chen ts'o'kok túun u beeta'al le bey yáax	Le chen ts'o'kok túun u beeta'al le bey yáax	NOCHANGE
Ma' k'a'abéet in bin maan tu k'íiwikil koonoli'	Ma' taak in bin maan tu k'íiwikil koonoli'	ASPECT:DES
Táan wáaj a xooke'ex xook tu naajil xook	Táan wáaj u xook tu naajil xook	PERSON:3_SI
Ma' k'aja'anti' buka'aj u ja'abili'	Ma' k'aja'ante'ex buka'aj a ja'abile'exi'	PERSON:2_PL
Ma' ta wilaj u sáastal ta kaajali'	Ma' tak ilaj u sáastal k kaajali'	PERSON:1_PL
Leti'o'obe' ku yu'ubiko'ob ooxol	To'one' k u'uyik wáaj ooxol	PERSON:1_PL
Yaan in bin koonol tu k'íiwikil koonol	Suuk in bin koonol tu k'íiwikil koonol	ASPECT:CUS
Yaan wáaj k bin koonol tu k'íiwikil koonol	Yaan wáaj u bin koonol tu k'íiwikil koonol	PERSON:3_SI
Leti'e' bin áalkab te' taam paarkéeo'	Leti'o'obe' bino'ob áalkab te' taam paarkéeo'	PERSON:3_PL
Jayp'éel k'iino'ob ku bin tu k'íiwikil koonol	jayp'éel k'iino'ob ku bino'ob tu k'íiwikil koonol	PERSON:3_PL
Yaan wáaj u bin koonol merkaado	Yaan wáaj u bino'ob koonol merkaado	PERSON:3_PL
Taak in manik ya'abach ba'alo'ob tu k'íiwikil koonol	Táan in manik ya'abach ba'alob tu k'íiwikil koonol	ASPECT:PRG
Táan wáaj a bine'ex koonol merkaado	Táan wáaj k bin koonol merkaado	PERSON:1_PL
Ma' u yojel u ja'abili'	Ma' a wojele'ex u ja'abili'	PERSON:2_PL
Táanil ma' jach lúubsa'ab u yóolo'ob	Táanil ma' jach lúubsa'ab u yóolo'ob	NOCHANGE
Te'exe' ka báaxale'ex paarkée	Leti'e' ku báaxal paarkée	PERSON:3_SI
Te'exe' ts'oka'an wáaj a beele'ex	Leti'obe' ts'oka'an wáaj u beelo'ob	PERSON:3_PL
Ma' táan u bin ich kooli'	Ma' táan a bine'ex ich kooli'	PERSON:2_PL
Táan u boon tu naajil xook	Táan a boon tu naajil xook	PERSON:2_SI
Tumeen le je'elo' ku yaantal u muuchilo'ob ti'al u k'áatiko'ob le ja'o' leeti'o'ob ken u k'áato'ob le ja'o'	Tumeen le je'elo' ku yaantal u muuchilo'ob ti'al u k'áatiko'ob le ja'o' leeti'o'ob ken u k'áato'ob le ja'o'	NOCHANGE
Tu'ux kajakbalech	Tu'ux kajakbalo'ob	PERSON:3_PL
Leeti' le úuchben máako'ob pues le bin	Leeti' le úuchben máako'ob pues le bin	NOCHANGE
Yaan a báaxal tu naajil báaxal	Yaan u báaxal tu naajil báaxal	PERSON:3_SI
Leti'e' bin áalkab te' taam paarkéeo'	Te'exe' bine'ex áalkab te' taam paarkéeo'	PERSON:2_PL
Máax yéetel taak a bin koonol tu kúuchil báaxal	Máax yéetel táan a bin koonol tu kúuchil báaxal	SUBTYPE:DEC;ASPECT:PRG
U este u píibil le waajo'	U este u píibil le waajo'	NOCHANGE
Jach k'a'abéet in bin merkaado	Jach k'a'abéet a bine'ex merkaado	PERSON:2_PL
Táan u meyaj tu kool	Táan ek meyaj ich kool	PERSON:1_PL
Ku ya'ala'alo'	Ku ya'ala'alo'	NOCHANGE
U jaajile' ma' jump'éelilo'on je'el bix  way maayaso'on kintaana roo maayas yúukataan mayas	U jaajile' ma' jump'éelilo'on je'el bix  way maayaso'on kintaana roo maayas yúukataan mayas	NOCHANGE
Leti'obe' ku báaxalo'ob paarkée	Teche' ka báaxal paarkée	PERSON:2_SI
Ta núukaj buka'aj a ja'abil	Ta núukaje'ex buka'aj a ja'abile'ex	PERSON:2_PL
Ma' ta wilaj u sáastal ta kaajali'	Ma' tu yilo'ob u sáastal tu kaajalo'obi'	PERSON:3_PL
Leti'e' ma' táan u bin koonol tu k'íiwikil koonol	Ma' táan k bin koonol tu k'íiwikil koonol	PERSON:1_PL
Ma' tu yu'ubiko'ob wáaj ooxoli'	Ma' ta wu'uyike'ex wáaj ooxoli'	PERSON:2_PL
Leti'e' áak'ab wáaj ku bin merkaado	Te'exe' áak'ab wáaj ka bine'ex merkaado	PERSON:2_PL
Ma' ta wiliken tu k'íiwikil koonol	Ma' tin wilike'ex tu k'íiwikil koonol	PERSON:1_SI
To'one' ti' in taalo'oni'	To'one' ti' k taali'	PERSON:1_PL
Jach chen bin máak ku jaantik chen ba'ale  xiib bin ku jaantik u pool tun bin le máako'obo'bey bin chen bin leeti' ku jaantik	Jach chen bin máak ku jaantik chen ba'ale  xiib bin ku jaantik u pool tun bin le máako'obo'bey bin chen bin leeti' ku jaantik	NOCHANGE
To'one' in k'aaba'one'	Leti'e' u k'aaba'e'	ASPECT:HAB;PERSON:3_SI
Ma' ts'oka'an a beele'exi'	Ma' ts'oka'an u beeli'	PERSON:3_SI
Yaan wáaj k bin koonol merkaado	Yaan wáaj a bin koonol merkaado	PERSON:2_SI
Yaan a báaxal tu naajil báaxal	Yaan u báaxalo'ob tu naajil báaxal	PERSON:3_PL
Táan u bin koonol merkaado	Táan k bin koonol merkaado	PERSON:1_PL
Ma' jach k'a'abéet u bin k'íiwikil koonoli'	Ma' jach k'a'abéet u bino'ob tu k'íiwikil koonoli'	PERSON:3_PL
Teche' ka báaxal tu naajil xook	te'exe' ka báaxale'ex tu naajil xook	PERSON:2_PL
Bey u ya'alik ten jump'éel k'iin bine' le xi'ipalo' ku ya'alik bin ti' u mama bine'  tu na' bine'	Bey u ya'alik ten jump'éel k'iin bine' le xi'ipalo' ku ya'alik bin ti' u mama bine'  tu na' bine'	NOCHANGE
Yaan wáaj u bin koonol tu k'íiwikil koonol	Yaan wáaj u bino'ob koonol tu k'íiwikil koonol	PERSON:3_PL
Ta'aytak a chukik u ja'abil	Ta'aytak k chukik u ja'abil	PERSON:1_PL
Tu'ux k'íiwikil koonol yaan a jóok'ol koonol	Tu'ux k'íiwikil koonol suuk a jóok'ol koonol	ASPECT:CUS
Teche' Yaan tech meyaj biología	Leti'e' yaan meyaj ti' biología	PERSON:3_SI
Ya'ab ba'ax yaanto'on ich maaya  yaanto'on xan ich káastelaan in in	Ya'ab ba'ax yaanto'on ich maaya  yaanto'on xan ich káastelaan in in	NOCHANGE
Leti'obe' ti' u taalo'obi'	Te'exe' ti' a taale'exi'	PERSON:2_PL
Ka'abeje' yaan a bin koonol	Ka'abeje' yaan u bino'ob koonol	PERSON:3_PL
E ayiik'alil ku p'áatik to'on kch'i'ibalo'ob	E ayiik'alil ku p'áatik to'on kch'i'ibalo'ob	NOCHANGE
U che'eile' yaan u bin ch'akbil	U che'eile' yaan u bin ch'akbil	NOCHANGE
Te'exe' yaante'ex xook ti' español	Leti'e' yaan xook ti' español	PERSON:3_SI
Tumeen ma' chen waaji'	Tumeen ma' chen waaji'	NOCHANGE
Tu'ux kajakbalo'ob	Tu'ux kajakbalo'on	PERSON:1_PL
Despuees ti' ku páatali' tu juunal kun bin u sa'atla'ajal	Despuees ti' ku páatali' tu juunal kun bin u sa'atla'ajal	NOCHANGE
Ku ya'ala'ale' mejen paalal tumeen leeti'o'obe'	Ku ya'ala'ale' mejen paalal tumeen leeti'o'obe'	NOCHANGE
Chen ba'ax túune' esteee koomo ke u cha'a'maj u tsoone' kex táan u ts'onik le ba'alo' ma'atáan esten  u kíimil bin	Chen ba'ax túune' esteee koomo ke u cha'a'maj u tsoone' kex táan u ts'onik le ba'alo' ma'atáan esten  u kíimil bin	NOCHANGE
Kin bin koonol tu k'íiwikil koonol	Suuk in bin koonol tu k'íiwikil koonol	ASPECT:CUS
Eee wolis túuno' leeti'e'e ba'ax ku beetik xane' pues ku meetik  jump'éel chan	Eee wolis túuno' leeti'e'e ba'ax ku beetik xane' pues ku meetik  jump'éel chan	NOCHANGE
Yaan wáaj u bin koonol tu k'íiwikil koonol	Yaan wáaj u bin koonol tu k'íiwikil koonol	PERSON:3_SI
Leti'e' ma' táan u bin koonol tu k'íiwikil koonol	Ma' táan u bino'ob koonol tu k'íiwikil koonol	PERSON:3_PL
Ta'aytak a chukik u ja'abil	Ta'aytak u chukik u ja'abil	PERSON:3_SI
Yaan a boone'ex xook tu naajil xook	Yaan a boon tu naajil xook	PERSON:2_SI
K'a'abéet in manik suuts' pak'áal tu k'íiwikil koonol	Ts'o'ok in manik janal tu k'íiwikil koonol	ASPECT:TER;TENSE:PAS_SIM
Ma' táan k bin koonol tu k'íiwikil koonol	Leti'e' ma' táan u bin koonol tu k'íiwikil koonol	PERSON:3_SI
Yaan túun xan a	Yaan túun xan a	NOCHANGE
Yaan wáaj u báaxal tu naajil báaxal	Yaan wáaj k báaxal tu naajil báaxal	PERSON:1_PL
Tu'ux k'íiwikil koonol k'a'abéet a jóok'ol koonol	Tu'ux k'íiwikil koonol taak a jóok'ol koonol	ASPECT:DES
Jela'an eee wolistak túuno' ku bin u ts'áako'ob u kruusil u kruusil tu chúumuk	Jela'an eee wolistak túuno' ku bin u ts'áako'ob u kruusil u kruusil tu chúumuk	NOCHANGE
Táan a meyaj ich kool	Táan u meyajo'ob ich kool	PERSON:3_PL
Te'el miil óochocieentos kuareenta y sieete ka ba'ate'eltalnaj le	Te'el miil óochocieentos kuareenta y sieete ka ba'ate'eltalnaj le	NOCHANGE
Jach wáaj k'a'abéet in bin merkaado	Jach wáaj k'a'abéet a bine'ex merkaado	PERSON:2_PL
To'onen yaanto'on u áanalte'il k xook matemáticas	Teche' Yaan tech u áanalte'il a xook matemáticas	PERSON:2_SI
Táan k xook tu naajil xook	Táan u xook tu naajil xook	PERSON:3_SI
Jach k'a'abéet u bino'ob tu k'íiwikil koonol	Jach k'a'abéet u bin tu k'íiwikil koonol	PERSON:3_SI
Mix to'on kajakbalo'on ta wotoch	Mix te'ex kajakbale'ex ta wotoch	PERSON:2_PL
To'one' áak'ab wáaj kek bin merkaado	Leti'e' áak'ab wáaj ku bin merkaado	PERSON:3_SI
Te'exe' ajkoonole'ex	Leti'e' ajkoonol	PERSON:3_SI
Ba'ale' in	Ba'ale' in	NOCHANGE
Yaan wáaj u bino'ob koonol tu k'íiwikil koonol	Yaan wáaj k bin koonol tu k'íiwikil koonol	PERSON:1_PL
Ma' ts'oka'an a beeli'	Ma' ts'oka'an u beeli'	PERSON:3_SI
Nojoch bey bejla'ak yaan kin wilik	Nojoch bey bejla'ak yaan kin wilik	NOCHANGE
Pues leeti'o'obe' láaili'  ku chíimpoltiko'obe' láaili' jeets'el tu tuukulo'obe'	Pues leeti'o'obe' láaili'  ku chíimpoltiko'obe' láaili' jeets'el tu tuukulo'obe'	NOCHANGE
Le ken ila'ak wel ts'o'ok u tajal le jkaakxo'	Le ken ila'ak wel ts'o'ok u tajal le jkaakxo'	NOCHANGE
Je'ex le je'elo' jump'éel ba'aj jach	Je'ex le je'elo' jump'éel ba'aj jach	NOCHANGE
Yaan a báaxale'ex báaxal tu naajil báaxal	Yaan k báaxal tu naajil báaxal	PERSON:1_PL
Taasbil u beeta'alo'ob ka béeychajak u jaanalo'ob	Taasbil u beeta'alo'ob ka béeychajak u jaanalo'ob	NOCHANGE
Ts'oka'an wáaj u beel	Ts'oka'an wáaj k beel	PERSON:1_PL
Táan u suuto'ob tu naajil xook	Táan a suute'ex xook tu naajil xook	PERSON:2_PL
Ki'iboktako'obo' ya'abe' ka láaj	Ki'iboktako'obo' ya'abe' ka láaj	NOCHANGE
Táan wáaj u bin koonol tu k'íiwikil koonol	Táan wáaj u bino'ob koonol tu k'íiwikil koonol	PERSON:3_PL
Ki'imak u yóolo'ob u bino'ob tu koolo'ob	Ki'imak a wóol a bin ich kool	PERSON:2_SI
Leti'e' bin áalkab te' taam paarkéeo'	To'one' bino'on áalkab te' taam paarkéeo'	PERSON:1_PL
Yaan wáaj a báaxale'ex báaxal tu naajil báaxal	Yaan wáaj u báaxal tu naajil báaxal	PERSON:3_SI
K'a'abéet in wilikech te' tu kúuchil báaxalo'	Táan in wilikech te' tu kúuchil báaxalo'	ASPECT:PRG
Jbino'ob yéetel u éetailo'ob merkaado	Jbine'ex yéetel a éetailo'ob merkaado	PERSON:2_PL
Ma' tan k k'íilkabi'	Ma' tan a k'íilkabi'	PERSON:2_SI
Ma' kajakbalech tin wotochi'	Ma' kajakbalo'ob tin wotochi'	PERSON:3_PL
To'one' áak'ab k bin tu k'íiwikil koonol	Leti'e' áak'ab ku bin tu k'íiwikil koonol	PERSON:3_SI
Táan wáaj u boon tu naajil xook	Táan wáaj k boon tu naajil xook	PERSON:1_PL
Le bix u t'a'abal le píibo' ku	Le bix u t'a'abal le píibo' ku	NOCHANGE
Le beetik túun tene' tin wilik beyo' le beetik ma' jach ya'ab máax takiki'	Le beetik túun tene' tin wilik beyo' le beetik ma' jach ya'ab máax takiki'	NOCHANGE
Leti'e' ku bin páak ich kool	Te'exe' ka bine'ex páak tu kool	PERSON:2_PL
To'one' ma' wáaj áak'ab kek bin merkaadoi'	Te'exe' ma' wáaj áak'ab ka bine'ex merkaadoi'	PERSON:2_PL
Leti'e' ts'oka'an wáaj u beel	Teche' ts'oka'an wáaj a beel	PERSON:2_SI
Táant in manik ya'abach ba'alo'ob tu k'íiwikil koonole'	Káaj in manik ya'abach ba'alob tu k'íiwikil koonol	ASPECT:BEG;TENSE:PAS_SIM
Yaan k xook tu naajil xook	Yaan u xook tu naajil xook	PERSON:3_SI
Tumeen bejla'ake' ku ya'alale' ma' es ke le paalalo'obo' yaan tojbe'enil ti' leeti'o'ob	Tumeen bejla'ake' ku ya'alale' ma' es ke le paalalo'obo' yaan tojbe'enil ti' leeti'o'ob	NOCHANGE
Óoxtúul wa kantúul mejen paalalo'ob	Óoxtúul wa kantúul mejen paalalo'ob	NOCHANGE
Teche' kajakbalech weye'	Leti'e' kajakbal weye'	PERSON:3_SI
To'one' ti' in taalo'oni'	Leti'e' ti' u taali'	PERSON:3_SI
Leti'obe' kajakbalo'ob weye'	Leti'e' kajakbal weye'	PERSON:3_SI
K'a'abéet in wilikech te' tu kúuchil báaxalo'	Suuk in wilikech te' tu kúuchil báaxalo'	ASPECT:CUS
Táan u boono'ob tu naajil xook	Táan u boon tu naajil xook	PERSON:3_SI
Mix leti' kajakbal ta wotoch	Mix te'ex kajakbale'ex ta wotoch	PERSON:2_PL
To'one' k báaxal paarkée	Leti'e' ku báaxal paarkée	PERSON:3_SI
Tek núukaj buka'aj k ja'abil	Tu núukaj buka'aj u ja'abil	PERSON:3_SI
Táan in manik ya'abach ba'alob tu k'íiwikil koonol	Suuk in manik ya'abach ba'alob tu k'íiwikil koonol	ASPECT:CUS
Táan wáaj u báaxal tu naajil báaxal	Táan wáaj k báaxal tu naajil báaxal	PERSON:1_PL
Leti'e' ma' táan u bin koonol tu k'íiwikil koonol	Ma' táan a bine'ex koonol tu k'íiwikil koonol	PERSON:2_PL
Ma' ts'oka'an u beelo'obi'	Leti'obe' ma' ts'oka'an u beelo'obi'	TYPE:NEG;SUBTYPE:DEC
Jayp'éel k'iino'ob ku bin merkaado	Jayp'éel k'iino'ob ka bine'ex merkaado	PERSON:2_PL
Ook'in a bin ich kool	Ook'in a bine'ex ta koole'ex	PERSON:2_PL
Leti'e' ts'oka'an wáaj u beel	To'one' ts'oka'an wáaj k beel	PERSON:1_PL
Ma' suuk in bin maan tu k'íiwikil koonoli'	Ma' káaj in bin maan tu k'íiwikil koonoli'	ASPECT:BEG;TENSE:PAS_SIM
Te'exe' áak'ab ka bine'ex tu k'íiwikil koonol	Teche' áak'ab ka bin tu k'íiwikil koonol	PERSON:2_SI
Ki'imak u yóolo'ob u bino'ob merkaado	Ki'imak a wóol a bin merkaado	PERSON:2_SI
Ook'in a bin merkaado	Ook'in u bino'ob merkaado	PERSON:3_PL
Jach wáaj k'a'abéet in bin merkaado	Jach wáaj k'a'abéet u bin merkaado	PERSON:3_SI
Ma' ta wu'uyike'ex ooxoli'	Ma' tu yu'ubiko'ob ooxoli'	PERSON:3_PL
Mix to'on kajakbalo'on ta wotoch	Mix leti'ob kajakbalo'ob ta wotoch	PERSON:3_PL
Ma' ts'oka'an u beelo'obi'	Ma' ts'oka'an a beeli'	PERSON:2_SI
Yaan wáaj u bino'ob koonol tu k'íiwikil koonol	Yaan wáaj a bin koonol tu k'íiwikil koonol	PERSON:2_SI
Mix to'on kajakbalo'on ta wotoch	Ma' kajakbale'ex tin wotochi'	PERSON:2_PL
Úuchben maayaso'ob te'ej maayaso'ob je'ex le yaan te'ej k'iinilo'oba'	Úuchben maayaso'ob te'ej maayaso'ob je'ex le yaan te'ej k'iinilo'oba'	NOCHANGE
Tumeen ka'ach bino' jach	Tumeen ka'ach bino' jach	NOCHANGE
Ma' tu yilaj u sáastal tu kaajali'	Ma' tak ilaj u sáastal k kaajali'	PERSON:1_PL
Táan k báaxal tu naajil báaxal	Táan u báaxalo'ob tu naajil báaxal	PERSON:3_PL
Tu meentik janal ich kool	Tu meentiko'ob janal ich kool	PERSON:3_PL
Teche' ka báaxal paarkée	To'one' k báaxal paarkée	PERSON:1_PL
Ka'abeje' yaan a bine'ex koonol merkaado	Ka'abeje' yaan a bin koonol merkaado	PERSON:2_SI
Ook'in u bino'ob merkaado	Ook'in a bine'ex merkaado	PERSON:2_PL
Teche' a jatsmajabáaj	Leti'obe' u jatsmajuba'ob	PERSON:3_PL
óok'otnajo'on tu naajil xook	óok'otnaje'ex tu naajil xook	PERSON:3_PL
Ku ya'aliko'obe' pues ba'axk'in ochocieentos seisieentos	Ku ya'aliko'obe' pues ba'axk'in ochocieentos seisieentos	NOCHANGE
Tan u k'íilkabo'ob	Tan k k'íilkab	PERSON:1_PL
Táan k suut tu naajil xook	Táan a suut tu naajil xook	PERSON:2_SI
To'one' k jatsmajekbáaj	Te'exe' a jatsmajaba'ex	PERSON:2_PL
Táan wáaj a bine'ex ich kool	Táan wáaj u bin ich kool	PERSON:2_SI
Chen ba'axe' le je'ela' le ti' le mejen paalalo' yaan a jóok'sik apartée	Chen ba'axe' le je'ela' le ti' le mejen paalalo' yaan a jóok'sik apartée	NOCHANGE
Te'exe' bine'ex áalkab te' taam paarkéeo'	To'one' bino'on áalkab te' taam paarkéeo'	PERSON:1_PL
Mix to'on kajakbalo'on ta wotoch	Mix leti' kajakbal ta wotoch	PERSON:3_SI
Táan wáaj k bin koonol tu k'íiwikil koonol	Táan wáaj u bino'ob koonol tu k'íiwikil koonol	PERSON:3_PL
Ma' tu yu'ubik ooxoli'	Ma' ta wu'uyike'ex ooxoli'	PERSON:2_PL
Yaan a boon tu naajil xook	Yaan k boon tu naajil xook	PERSON:1_PL
Leti'e' ma' jbúul wáaj	Te'exe' ma' jbúule'ex wáaj	PERSON:2_PL
Chen ka tu yilo'ob bin u k'uchulo'ob ti' jump'éel áaktun tun beya' ku yikliko'ob jach beya'  ti' bin weekel u k'i'ik'el bin le	Chen ka tu yilo'ob bin u k'uchulo'ob ti' jump'éel áaktun tun beya' ku yikliko'ob jach beya'  ti' bin weekel u k'i'ik'el bin le	NOCHANGE
Chúumukle u  waajil el píib ken a meento'	Chúumukle u  waajil el píib ken a meento'	NOCHANGE
óok'otnajech tu naajil xook	óok'otnaje'ex tu naajil xook	PERSON:3_PL
Ma' tu yu'ubik wáaj ooxoli'	Ma' ta wu'uyike'ex wáaj ooxoli'	PERSON:2_PL
Yaan a tasik u tuunichile'	Yaan a tasik u tuunichile'	NOCHANGE
Leti'e' áak'ab wáaj ku bin tu k'íiwikil koonol	Leti'e' ma' áak'ab wáaj ku bin tu k'íiwikil koonoli'	TYPE:NEG;SUBTYPE:INT;PERSON:2_SI
Táan wáaj k xook tu naajil xook	Táan wáaj u xooko'ob tu naajil xook	PERSON:3_PL
Ta'aytak a chukike'ex u ja'abil	Ta'aytak k chukik u ja'abil	PERSON:1_PL
Chen ba'axe' bejla'ak túune' le ee	Chen ba'axe' bejla'ak túune' le ee	NOCHANGE
K'a'abéet in suut koonol merkaado	Káaj in suut koonol merkaado	ASPECT:BEG;TENSE:PAS_SIM
Táan wáaj u báaxalo'ob tu naajil báaxal	Táan wáaj k báaxal tu naajil báaxal	PERSON:1_PL
Le ba'ax ku ya'alik ti' le chan nuuko' leetie'e' ka tu kaxtaj bin le e	Le ba'ax ku ya'alik ti' le chan nuuko' leetie'e' ka tu kaxtaj bin le e	NOCHANGE
Tu'ux kajakbalo'ob	Tu'ux kajakbale'ex	PERSON:2_PL
Leti'obe' ti' kajakbalo'ob tu yotoche'	To'one' ti' kajakbalo'on tu yotoche'	PERSON:1_PL
Ma' kajakbale'ex tin wotochi'	Mix leti'ob kajakbalo'ob ta wotoch	PERSON:3_PL
Esten ti'al u beenta'al le jaanal pixan ku ya'ala'alo'	Esten ti'al u beenta'al le jaanal pixan ku ya'ala'alo'	NOCHANGE
Santa muerte ale'  mina'an le	Santa muerte ale'  mina'an le	NOCHANGE
Táan in wilikech te' tu kúuchil báaxalo'	K'a'abéet in wilikech te' tu kúuchil báaxalo'	ASPECT:OBL
Le wolis waajo'oo' le je'elo' k'as	Le wolis waajo'oo' le je'elo' k'as	NOCHANGE
Yaan u suut tu naajil xook	Yaan a suute'ex xook tu naajil xook	PERSON:2_PL
Máax yéetel táan a bin koonol tu kúuchil báaxal	Máax yéetel suuk a bin koonol tu kúuchil báaxal	SUBTYPE:DEC;ASPECT:CUS
Leti'e' ti' kajakbal tu yotoche'	Te'exe' ti' kajakbale'ex tu yotoche'	PERSON:2_PL
Yaan wáaj k bin koonol tu k'íiwikil koonol	Yaan wáaj a bin koonol tu k'íiwikil koonol	PERSON:2_SI
Ma' tan a k'íilkabe'exi'	Ma' tan u k'íilkabi'	PERSON:3_SI
Leti'obe' ti' kajakbalo'ob tu yotoche'	Teche' ti' kajakbalech tu yotoche'	PERSON:2_SI
Si le je'ela' in wa'ake' ma' chen k'aak'as ba'ali  ka bin ooko'ob bin  te'el ichilo'	Si le je'ela' in wa'ake' ma' chen k'aak'as ba'ali  ka bin ooko'ob bin  te'el ichilo'	NOCHANGE
Táan u suuto'ob tu naajil xook	Táan u suut tu naajil xook	PERSON:3_SI
Tu kaxko'ob a najil	Tu kaxtik a najil	PERSON:3_SI
Yaan a boone'ex xook tu naajil xook	Yaan k boon tu naajil xook	PERSON:1_PL
Ba'atelnajo'ob te' tu kúuchil báaxalo'	Ba'atelnajech te' tu kúuchil báaxalo'	PERSON:2_SI
Táan ek meyaj ich kool	Táan a meyaje'ex ich kool	PERSON:2_PL
Yaan wíinike' ku kolaartik yaan wíinike' ku	Yaan wíinike' ku kolaartik yaan wíinike' ku	NOCHANGE
Lee yuumtsilo'obo'  yaan ee ajyuumtsilo' bey u ya'ala'alti'o' wa le aj	Lee yuumtsilo'obo'  yaan ee ajyuumtsilo' bey u ya'ala'alti'o' wa le aj	NOCHANGE
Ma' táan u bino'ob ich kooli'	Ma' táan a bine'ex ich kooli'	PERSON:2_PL
Jach k'a'abéet in bin merkaado	Jach k'a'abéet u bino'ob merkaado	PERSON:3_PL
Táan u kaxtiko'ob a naajil	Táan u kaxtik a najil	PERSON:3_SI
Ma' a wojele'ex u ja'abili'	Ma' u yojelo'ob u ja'abili'	PERSON:3_PL
Ba'ale' wa ka bine' yaan a kaxta'al yéetel a waalo'ob yéetel a láak'tsilo'ob yaan u taasa'alo'ob ku ya'ala'al bin ti'	Ba'ale' wa ka bine' yaan a kaxta'al yéetel a waalo'ob yéetel a láak'tsilo'ob yaan u taasa'alo'ob ku ya'ala'al bin ti'	NOCHANGE
Tan k kaxtik a najil	Táan u kaxtiko'ob a naajil	PERSON:3_PL
Ts'o'ok in manik ya'abach ba'alob tu k'íiwikil koonol	Táant in manik ya'abach ba'alo'ob tu k'íiwikil koonole'	ASPECT:IMM;TENSE:PAS_SIM
Mix te'ex kajakbale'ex ta wotoch	Mix leti' kajakbal ta wotoch	PERSON:3_SI
Jayp'éel k'iino'ob ka bine'ex merkaado	Jayp'éel k'iino'ob ku bino'ob merkaado	PERSON:3_PL
De k'aab le ki'iwaj ku beenta'ala'	De k'aab le ki'iwaj ku beenta'ala'	NOCHANGE
Ma' u ya'aliko'ob u k'aaba'	Ma' k a'alik u k'aaba'	PERSON:1_PL
leti'e ku báaxal tu naajil xook	te'exe' ka báaxale'ex tu naajil xook	PERSON:2_PL
Yaan u suuto'ob tu naajil xook	Yaan a suute'ex xook tu naajil xook	PERSON:2_PL
K'a'abéet in suut koonol merkaado	Yaan in suut koonol merkaado	ASPECT:COM
Ma' kajakbalo'ob tin wotochi'	Ma' kajakbal tin wotochi'	PERSON:3_SI
Táan ek meyaj ich kool	Táan a meyaj ich kool	PERSON:2_SI
Ma' táan u bino'ob koonol tu k'íiwikil koonol	Ma' táan u bino'ob koonol tu k'íiwikil koonol	PERSON:3_PL
Le píibo' ts'o'ok xan u jáabal u che'ile'	Le píibo' ts'o'ok xan u jáabal u che'ile'	NOCHANGE
Yaan wáaj k báaxal tu naajil báaxal	Yaan wáaj u báaxalo'ob tu naajil báaxal	PERSON:3_PL
Tan u k'íilkabo'ob	Tan a k'íilkabe'ex	PERSON:2_PL
Yaan ek jochik chak nal tek kool	Yaan a jochike'ex chak nal ta koole'ex	PERSON:2_PL
Ba'ale' le túuchicho' yaane' ti' ku bisik yóok'oli' yaane' yaane' ku ts'áabko'ob yáanal	Ba'ale' le túuchicho' yaane' ti' ku bisik yóok'oli' yaane' yaane' ku ts'áabko'ob yáanal	NOCHANGE
Táan u báaxalo'ob tu naajil báaxal	Táan a báaxal tu naajil báaxal	PERSON:2_SI
Ma' táan a bine'ex koonol tu k'íiwikil koonol	Leti'e' ma' táan u bin koonol tu k'íiwikil koonol	PERSON:3_SI
K'a'abéet in manik ya'abach ba'alob tu k'íiwikil koonol	Yaan in manik ya'abach ba'alob tu k'íiwikil koonol	ASPECT:COM
Káaj in manik ya'abach ba'alob tu k'íiwikil koonol	Ts'o'ok in manik ya'abach ba'alob tu k'íiwikil koonol	ASPECT:TER;TENSE:PAS_SIM
Ma' tu yu'ubiko'ob ooxoli'	Ma' tu yu'ubik ooxoli'	PERSON:3_SI
U ti'al máako' bueeno a kimeo'ob n beyo'chen k'uchuko'obe' pues leeti'o'obe' táan u jaanalo'ob'ob bine' chen k'uchuko'obe'	U ti'al máako' bueeno a kimeo'ob n beyo'chen k'uchuko'obe' pues leeti'o'obe' táan u jaanalo'ob'ob bine' chen k'uchuko'obe'	NOCHANGE
Jaan ka tun bin	Jaan ka tun bin	NOCHANGE
Ma' wáaj tu bino'ob merkaado	Ma' wáaj tu bin merkaado	PERSON:2_PL
Táan u bin koonol tu k'íiwikil koonol	Táan a bin koonol tu k'íiwikil koonol	PERSON:2_SI
Ba'ax túun ken u beeto'obe' le binka'aj túun tasbil le waajo'	Ba'ax túun ken u beeto'obe' le binka'aj túun tasbil le waajo'	NOCHANGE
Leti'obe' ti' u taalo'obi'	Teche' ti' a taali'	PERSON:2_SI
Ma' táan u bino'ob koonol merkaadoi'	Ma' táan a bin koonol merkaadoi'	PERSON:2_SI
Te'exe' yaante'ex wáaj meyaj ti' biología	To'onen yaanto'on wáaj meyaj ti' biología	PERSON:1_PL
Leti'e' u k'aaba'e'	Te'exe' a k'aaba'exe'	ASPECT:HAB;PERSON:2_PL
Ma' k'aja'anto'on buka'aj k ja'abili'	Ma' k'aja'antech buka'aj a ja'abili'	PERSON:2_SI
Je'elo'  ka bino'ob tun bin jump'éel k'iin beyo' ka tu jóok'so'ob bin  le reeyo' bey ya'abo'obo'	Je'elo'  ka bino'ob tun bin jump'éel k'iin beyo' ka tu jóok'so'ob bin  le reeyo' bey ya'abo'obo'	NOCHANGE
Taak in suut koonol merkaado	Kin in suut koonol merkaado	ASPECT:HAB
To'one' ma' jbúulo'oni'	Teche' ma' jbúulechi'	PERSON:2_SI
Táan u boon tu naajil xook	Táan a boone'ex xook tu naajil xook	PERSON:2_PL
J-jaane'ex merkaado	J-jaanech merkaado	PERSON:2_SI
Ma' tan u k'íilkabo'obi'	Ma' tan u k'íilkabi'	PERSON:3_SI
-chan xnuuko' ku ya'alik bin ti' leeti'e'  -pero chan winik  le tu'ux ka bino' táan a túun a wilik óoxp'éel bej yani'- ki bin	-chan xnuuko' ku ya'alik bin ti' leeti'e'  -pero chan winik  le tu'ux ka bino' táan a túun a wilik óoxp'éel bej yani'- ki bin	NOCHANGE
Teche' jbúulech	To'one' jbúulo'on	PERSON:1_PL
Saajak u	Saajak u	NOCHANGE
Ma' tak ilaj u sáastal k kaajali'	Ma' tu yilaj u sáastal tu kaajali'	PERSON:3_SI
Tu'ux kajakbalo'ob	Tu'ux kajakbal	PERSON:3_SI
Ma' kajakbalech tin wotochi'	Ma' kajakbalo'on tin wotochi'	PERSON:1_PL
Ba'atelnajech te' tu kúuchil báaxalo'	Ba'atelnaje'ex te' tu kúuchil báaxalo'	PERSON:2_PL
Yaan wáaj k bin koonol tu k'íiwikil koonol	Yaan wáaj u bino'ob koonol tu k'íiwikil koonol	PERSON:3_PL
Yaan wáaj a bine'ex koonol tu k'íiwikil koonol	Yaan wáaj u bin koonol tu k'íiwikil koonol	PERSON:3_SI
Táan wáaj a báaxale'ex báaxal tu naajil báaxal	Táan wáaj u báaxalo'ob tu naajil báaxal	PERSON:3_PL
Tu'ux kajakbal	Tu'ux kajakbalo'ob	PERSON:3_PL
Yaan wáaj k báaxal tu naajil báaxal	Yaan wáaj a báaxale'ex báaxal tu naajil báaxal	PERSON:2_PL
Leti' bine' ma' tu cha'ao'ob u máan bin le meejilo'ob inal le nuxi' reey bino'  le nojoch reeyo'	Leti' bine' ma' tu cha'ao'ob u máan bin le meejilo'ob inal le nuxi' reey bino'  le nojoch reeyo'	NOCHANGE
Teche' ts'oka'an wáaj a beel	Leti'e' ts'oka'an wáaj u beel	PERSON:3_SI
Yaan k suut tu naajil xook	Yaan a suut tu naajil xook	PERSON:2_SI
Ka'abeje' yaan a bin koonol merkaado	Ka'abeje' yaan a bine'ex koonol merkaado	PERSON:2_PL
Tu'ux k'íiwikil koonol yaan a jóok'ol koonol	Tu'ux k'íiwikil koonol taak a jóok'ol koonol	ASPECT:DES
Ka tu bisaj bin kajtal tu chan palaasio rey tumeen ts'áab tak u naay	Ka tu bisaj bin kajtal tu chan palaasio rey tumeen ts'áab tak u naay	NOCHANGE
Leti'e' ajkoonol ichil merkaado	To'one' ajkoonolo'on ichil merkaado	PERSON:1_PL
Ma' jach k'a'abéet u bin tu kooli'	Ma' wáaj jach k'a'abéet u bin tu kooli'	TYPE:NEG;SUBTYPE:INT
Kíim le k'aak'as ba'al yaan te'ela' ku ya'ako'ob bin	Kíim le k'aak'as ba'al yaan te'ela' ku ya'ako'ob bin	NOCHANGE
Tu'ux k'íiwikil koonol suuk a jóok'ol koonol	Tu'ux k'íiwikil koonol káaj a jóok'ol koonol	ASPECT:BEG;TENSE:PAS_SIM
Yaan wáaj k xook tu naajil xook	Yaan wáaj u xooko'ob tu naajil xook	PERSON:3_PL
Jaanal pixan aaaj	Jaanal pixan aaaj	NOCHANGE
Yaan wáaj a bin koonol merkaado	Yaan wáaj a bine'ex koonol merkaado	PERSON:2_PL
Táan u báaxalo'ob tu naajil báaxal	Táan a báaxale'ex báaxal tu naajil báaxal	PERSON:2_PL
Ma' k'aja'anto'on buka'aj k ja'abili'	Ma' k'aja'anti'ob buka'aj u ja'abilo'obi'	PERSON:3_PL
Le úuchben ch'i'ibalo'obo'	Le úuchben ch'i'ibalo'obo'	NOCHANGE
Táan u báaxal tu naajil báaxal	Táan a báaxale'ex báaxal tu naajil báaxal	PERSON:2_PL
Soldaadoso'  bin beyo' cha' in jan bini' ki bin	Soldaadoso'  bin beyo' cha' in jan bini' ki bin	NOCHANGE
Yaan u báaxal tu naajil báaxal	Yaan a báaxal tu naajil báaxal	PERSON:2_SI
Táan wáaj a bine'ex koonol tu k'íiwikil koonol	Táan wáaj u bino'ob koonol tu k'íiwikil koonol	PERSON:3_PL
U cha'am'ob bin che' u ch'amo'ob máaskab tu láakal u ch'a'amo'obleeti'o'obe' taak u	U cha'am'ob bin che' u ch'amo'ob máaskab tu láakal u ch'a'amo'obleeti'o'obe' taak u	NOCHANGE
Leti'e' yaan wáaj meyaj ti' biología	To'onen yaanto'on wáaj meyaj ti' biología	PERSON:1_PL
Leti'e' ma' táan u bin koonol tu k'íiwikil koonol	Ma' táan a bin koonol tu k'íiwikil koonol	PERSON:2_SI
Ook'in a bine'ex k'íiwikil koonol	Ook'in a bin tu k'íiwikil koonol	PERSON:2_SI
Este áanjeleso'ob ku yu'uba'al u t'aano'ob	Este áanjeleso'ob ku yu'uba'al u t'aano'ob	NOCHANGE
Ma' a wojel u ja'abili'	Ma' a wojele'ex u ja'abili'	PERSON:2_PL
Taak in bin koonol tu k'íiwikil koonol	Yaan in bin koonol tu k'íiwikil koonol	ASPECT:COM
To'one' k jatsmajekbáaj	Leti'e' u jatsmajubáaj	PERSON:3_SI
Ma' táan ek bin ich kooli'	Ma' táan u bino'ob ich kooli'	PERSON:3_PL
To'one' in k'aaba'one'	To'one' k k'aaba'e'	ASPECT:HAB;PERSON:1_PL
Leti'e' u jatsmajubáaj	Leti'obe' u jatsmajuba'ob	PERSON:3_PL
Teche' áak'ab wáaj ka bin tu k'íiwikil koonol	Leti'e' áak'ab wáaj ku bin tu k'íiwikil koonol	PERSON:3_SI
Táan wáaj u bino'ob koonol tu k'íiwikil koonol	Táan wáaj u bin koonol tu k'íiwikil koonol	PERSON:3_SI
Jump'éel waaj nojoch	Jump'éel waaj nojoch	NOCHANGE
To'onen yaanto'on u áanalte'il k xook matemáticas	Leti'e' yaan u áanalte'il u xook matemáticas	PERSON:3_SI
Yaan wáaj a bin ich kool	Yaan wáaj a bine'ex ich kool	PERSON:2_PL
Máax yéetel k'a'abéet a bin koonol tu kúuchil báaxal	Máax yéetel taak a bin koonol tu kúuchil báaxal	SUBTYPE:DEC;ASPECT:DES
Ba'ax ja'abil jsíije'ex	Ba'ax ja'abil jsíijij	PERSON:3_SI
Taak in bin koonol tu k'íiwikil koonol	Suuk in bin koonol tu k'íiwikil koonol	ASPECT:CUS
Bey túuno' ee tak ka úuch túun le geerra de kaastaso' ku ya'alik in noole' ku ya'alik in in áabueelae'	Bey túuno' ee tak ka úuch túun le geerra de kaastaso' ku ya'alik in noole' ku ya'alik in in áabueelae'	NOCHANGE
To'one' ma' jbúulo'oni'	Te'exe' ma' jbúule'exi'	PERSON:2_PL
Yaan a suute'ex xook tu naajil xook	Yaan a suut tu naajil xook	PERSON:2_SI
Uu u chan bix u ya'ala'al le	Uu u chan bix u ya'ala'al le	NOCHANGE
Mix te'ex kajakbale'ex ta wotoch	Mix teech kajakbalech ta wotoch	PERSON:2_SI
Teche' ka bin paak'áal ich kool	Leti'e' ku bin paak'áal ich kool	PERSON:3_SI
Ts'o'okol túun u t'a'abala beyo' ku cha'abal u láaj t'a'abal le che'o'obo'	Ts'o'okol túun u t'a'abala beyo' ku cha'abal u láaj t'a'abal le che'o'obo'	NOCHANGE
Ma' u sa'atalo'ob le ba'ax tu p'atajto'on  knoolo'ono'	Ma' u sa'atalo'ob le ba'ax tu p'atajto'on  knoolo'ono'	NOCHANGE
Teche' áak'ab ka bin tu k'íiwikil koonol	Te'exe' áak'ab ka bine'ex tu k'íiwikil koonol	PERSON:2_PL
Baalo'ob beyo' ku makal	Baalo'ob beyo' ku makal	NOCHANGE
Teche' ti' a taali'	Te'exe' ti' a taale'exi'	PERSON:2_PL
Tumeen u ti'al mejen paalal tumeen le box kibo'obo' maas jach u ti'al le nukuch máako'obo'	Tumeen u ti'al mejen paalal tumeen le box kibo'obo' maas jach u ti'al le nukuch máako'obo'	NOCHANGE
U béeytal u takik tak u chi' ka	U béeytal u takik tak u chi' ka	NOCHANGE
To'one' k jatsmajekbáaj	Leti'obe' u jatsmajuba'ob	PERSON:3_PL
Táan a suut tu naajil xook	Táan u suuto'ob tu naajil xook	PERSON:3_PL
Ma' tu yilaj u sáastal tu kaajali'	Ma' ta wilaj u sáastal ta kaajali'	PERSON:2_SI
Teche' áak'ab wáaj ka bin tu k'íiwikil koonol	To'one' áak'ab wáaj k bin tu k'íiwikil koonol	PERSON:1_PL
Leti'obe' u k'aaba'obe'	To'one' k k'aaba'e'	ASPECT:HAB;PERSON:1_PL
Ku ts'o'okol túune' ken ya'at le beyo' pues ku k'axik yóok'sal ma' u	Ku ts'o'okol túune' ken ya'at le beyo' pues ku k'axik yóok'sal ma' u	NOCHANGE
Yaan wáaj k bin koonol tu k'íiwikil koonol	Yaan wáaj u bino'ob koonol tu k'íiwikil koonol	PERSON:3_PL
ku yu'ubik wáaj ooxol	Te'exe' ka wu'uyike'ex wáaj ooxol	PERSON:2_PL
Yaan a boon tu naajil xook	Yaan a boone'ex xook tu naajil xook	PERSON:2_PL
Táan wáaj k bin koonol merkaado	Táan wáaj a bine'ex koonol merkaado	PERSON:2_PL
Táan wáaj u bin ich kool	Táan wáaj a bine'ex ich kool	PERSON:2_PL
Te' u taalo'ob tu kaajil Kopomae'	Te' k taal tu kaajil Kopomae'	PERSON:1_PL
Yaan wáaj a bine'ex ich kool	Yaan wáaj a bin ich kool	PERSON:2_SI
Táan u meyajo'ob ich kool	Táan a meyaj ich kool	PERSON:2_SI
Juntéenake' kij bey u tsikbalmaj ten in áabueelao' ku ya'ake' juntéenake' kij	Juntéenake' kij bey u tsikbalmaj ten in áabueelao' ku ya'ake' juntéenake' kij	NOCHANGE
Je'el u béeytal bin u kíinsiko'ob bine'	Je'el u béeytal bin u kíinsiko'ob bine'	NOCHANGE
Ts'o'ok in suut koonol merkaado	Táant in suut koonol merkaadoe'	ASPECT:IMM;TENSE:PAS_SIM
Ku júupulo'ob u ts'i'kte le bak'o'	Ku júupulo'ob u ts'i'kte le bak'o'	NOCHANGE
Yaan u suuto'ob tu naajil xook	Yaan u suut tu naajil xook	PERSON:3_SI
Leti' túun bine' bey jach ya'ab ba'al bin u yoojel bino'	Leti' túun bine' bey jach ya'ab ba'al bin u yoojel bino'	NOCHANGE
Táan u xooko'ob tu naajil xook	Táan a xooke'ex xook tu naajil xook	PERSON:2_PL
Tu'ux k'íiwikil koonol k'a'abéet a jóok'ol koonol	Tu'ux k'íiwikil koonol yaan a jóok'ol koonol	ASPECT:COM
Le esten le nukuch túuto' ku  meyajta'al yéetel juuch'	Le esten le nukuch túuto' ku  meyajta'al yéetel juuch'	NOCHANGE
Yaan a jochik chak nal ta kool	Yaan u jochiko'ob chak nal tu koolo'ob	PERSON:3_PL
Ma' k ojel u ja'abili'	Ma' a wojele'ex u ja'abili'	PERSON:2_PL
Máax yéetel taak a bin koonol tu kúuchil báaxal	Máax yéetel k'a'abéet a bin koonol tu kúuchil báaxal	SUBTYPE:DEC;ASPECT:OBL
Kin jóok'ol wáaj koonol tu k'íiwikil koonol	Suuk wáaj in jóok'ol koonol tu k'íiwikil koonol	ASPECT:CUS;TENSE:PRE_SIM
Ts'o'ok túun u meyajtiko'ob bey  u k'óolil  yéetel u káaxil tu láakal le je'elo' uu uu preparaartiko'ob beyo'	Ts'o'ok túun u meyajtiko'ob bey  u k'óolil  yéetel u káaxil tu láakal le je'elo' uu uu preparaartiko'ob beyo'	NOCHANGE
E xbáalamo'ob láaj u áapeyiidos	E xbáalamo'ob láaj u áapeyiidos	NOCHANGE
Tu'ux k'íiwikil koonol suuk a jóok'ol koonol	Tu'ux k'íiwikil koonol k'a'abéet a jóok'ol koonol	ASPECT:OBL
Ta meentike'ex janal ich kool	Tu meentik janal ich kool	PERSON:3_SI
Tu'ux kajakbalech	Tu'ux kajakbal	PERSON:3_SI
Leetie'e' maas ya'abbin  taak'in bin síib ti' tumeen le rey bin p'áato'	Leetie'e' maas ya'abbin  taak'in bin síib ti' tumeen le rey bin p'áato'	NOCHANGE
Je'elo' ti' leeti'o'ob túune' leete'ej te'ej ee nukuch túuto'ob ku beetiko'ob beyo'	Je'elo' ti' leeti'o'ob túune' leete'ej te'ej ee nukuch túuto'ob ku beetiko'ob beyo'	NOCHANGE
Mix leti' kajakbal ta wotoch	Ma' kajakbale'ex tin wotochi'	PERSON:2_PL
Táan u boon tu naajil xook	Táan u boono'ob tu naajil xook	PERSON:3_PL
Ti' kun beentbil túuni'	Ti' kun beentbil túuni'	NOCHANGE
Ma' táan u bino'ob koonol tu k'íiwikil koonol	Ma' táan a bine'ex koonol tu k'íiwikil koonol	PERSON:2_PL
Leti'e' ku báaxal paarkée	To'one' k báaxal paarkée	PERSON:1_PL
Tu'ux kajakbalech	Tu'ux kajakbalo'on	PERSON:1_PL
To'one kek bin páak ich kool	Teche' ka bin páak ich kool	PERSON:2_SI
Mina'anten 18 ja'abo'ob	Mina'an wáaj ti' teen 18 ja'abo'ob	TYPE:NEG;SUBTYPE:INT
Su láaj meyajtiko'ob	Su láaj meyajtiko'ob	NOCHANGE
Te'exe' yaante'ex u áanalte'il u xookil matemáticas	To'onen yaanto'on u áanalte'il k xook matemáticas	PERSON:1_PL
K'a'al in áabueelae' ka jo'op' u ya'alik tun bin ti' le le le máako'ob bin  este le le	K'a'al in áabueelae' ka jo'op' u ya'alik tun bin ti' le le le máako'ob bin  este le le	NOCHANGE
Leti'e' ku báaxal paarkée	Teche' ka báaxal paarkée	PERSON:2_SI
Bejla'ake' táan u tsikbal a maam'aa táan u tsikbal a taata yéetel wa máaxe'	Bejla'ake' táan u tsikbal a maam'aa táan u tsikbal a taata yéetel wa máaxe'	NOCHANGE
Leti'e' ma' táan u bin koonol tu k'íiwikil koonol	Ma' táan u bino'ob koonol tu k'íiwikil koonol	PERSON:3_PL
Táan a bin koonol tu k'íiwikil koonol	Leti'obe' táan u bino'ob koonol tu k'íiwikil koonol	PERSON:3_PL
Teche' a jatsmajabáaj	Leti'e' u jatsmajubáaj	PERSON:3_SI
Yaan a xook tu naajil xook	Yaan u xook tu naajil xook	PERSON:3_SI
Chen de chan salam chen	Chen de chan salam chen	NOCHANGE
To'one' ajkoonolo'on ichil merkaado	Teche' ajkoonolech ichil merkaado	PERSON:2_SI
Teche' jbúulech	Leti'e' jbúulij	PERSON:3_SI
Táan in wilikech te' tu kúuchil báaxalo'	Suuk in wilikech te' tu kúuchil báaxalo'	ASPECT:CUS
Le  ku ta'akal le	Le  ku ta'akal le	NOCHANGE
Yéetel esten	Yéetel esten	NOCHANGE
Ma' ta wile'ex u sáastal ta kaajale'exi'	Ma' tu yilo'ob u sáastal tu kaajalo'obi'	PERSON:3_PL
Puro k'e'eyn wolistak beya'	Puro k'e'eyn wolistak beya'	NOCHANGE
To'one' jbúulo'on	Teche' jbúulech	PERSON:2_SI
Te'exe' ka taale'ex paak'áal ich kool	Leti'e' ku bin paak'áal ich kool	PERSON:3_SI
To'one' in k'aaba'one'	Teche' a k'aaba'e'	ASPECT:HAB;PERSON:2_SI
Yaan k boon tu naajil xook	Yaan a boone'ex xook tu naajil xook	PERSON:2_PL
Ma' ts'oka'an u beelo'obi'	Ma' ts'oka'an k beeli'	PERSON:1_PL
Ta wile'ex wáaj u sáastal ta kaajale'ex	Tu yilaj wáaj u sáastal tu kaajal	PERSON:3_SI
Ku ya'alike'	Ku ya'alike'	NOCHANGE
Leti'e' yaan wáaj meyaj ti' biología	Te'exe' yaante'ex wáaj meyaj ti' biología	PERSON:2_PL
Suuk in manik ya'abach ba'alob tu k'íiwikil koonol	K'a'abéet in manik ya'abach ba'alob tu k'íiwikil koonol	ASPECT:OBL
U esten u  ch'uyubil tumeen tak le ch'uyubo'  le lelo' ti'	U esten u  ch'uyubil tumeen tak le ch'uyubo'  le lelo' ti'	NOCHANGE
Jach k'a'abéet u bin merkaado	Jach k'a'abéet u bino'ob merkaado	PERSON:3_PL
Táan u suut tu naajil xook	Táan a suut tu naajil xook	PERSON:2_SI
Táan ek kaxtik a najil	Táan u kaxtik a najil	PERSON:3_SI
Táan u kaxtiko'ob a naajil	Tan k kaxtik a najil	PERSON:1_PL
Leti'o'obe' bino'ob áalkab te' taam paarkéeo'	Te'exe' bine'ex áalkab te' taam paarkéeo'	PERSON:2_PL
Ma' tin wilikech tu k'íiwikil koonol	Ma' ta wiliken tu k'íiwikil koonol	PERSON:2_SI
Y le mejen xkoots'ob waajo'obo' tu báak'lik	Y le mejen xkoots'ob waajo'obo' tu báak'lik	NOCHANGE
Teche' áak'ab wáaj ka bin tu k'íiwikil koonol	Te'exe' áak'ab wáaj ka bine'ex tu k'íiwikil koonol	PERSON:2_PL
Yaan wáaj u bino'ob ich kool	Yaan wáaj ek bin ich kool	PERSON:1_PL
Mix te'ex kajakbale'ex ta wotoch	Ma' kajakbale'ex tin wotochi'	PERSON:2_PL
Táan wáaj u bino'ob koonol merkaado	Táan wáaj k bin koonol merkaado	PERSON:1_PL
Táan u suut tu naajil xook	Táan u suuto'ob tu naajil xook	PERSON:3_PL
Yaan wáaj a bine'ex koonol tu k'íiwikil koonol	Yaan wáaj a bin koonol tu k'íiwikil koonol	PERSON:2_SI
Jach k'a'abéet wáaj a bine'ex tu k'íiwikil koonol	Jach wáaj k'a'abéet in bin k'íiwikil koonol	PERSON:1_SI
Ma' tak ilaj u sáastal k kaajali'	Ma' ta wilaj u sáastal ta kaajali'	PERSON:2_SI
Táan a bin koonol merkaado	Táan a bine'ex koonol merkaado	PERSON:2_PL
Ka bin bini ka ook te'el naj bino'	Ka bin bini ka ook te'el naj bino'	NOCHANGE
De óoxyáal	De óoxyáal	NOCHANGE
Le chen áak'ablajak bey chen jo'op' u taal u chíinil k'iin bin beya' leeti' kenjo'op' u taal u súutul de	Le chen áak'ablajak bey chen jo'op' u taal u chíinil k'iin bin beya' leeti' kenjo'op' u taal u súutul de	NOCHANGE
Chen tsikbalte ten le a woojel tu yóok'sal a ch'i'ibalo'obo'	Chen tsikbalte ten le a woojel tu yóok'sal a ch'i'ibalo'obo'	NOCHANGE
Leti'obe' táan u bino'ob koonol tu k'íiwikil koonol	Táan k bin koonol tu k'íiwikil koonol	PERSON:1_PL
Mejen paalalo'obe' táan u	Mejen paalalo'obe' táan u	NOCHANGE
K'a'abéet in suut koonol merkaado	Suuk in suut koonol merkaado	ASPECT:CUS
k'aaynajo'ob tu naajil xook	k'aaynaje'ex tu naajil xook	PERSON:2_PL
Leti'e' ti' u taali'	To'one' ti' k taali'	PERSON:1_PL
Yaan a jochike'ex chak nal ta koole'ex	Yaan u jochiko'ob chak nal tu koolo'ob	PERSON:3_PL
Ma' táan a bine'ex koonol merkaadoi'	Ma' táan k bin koonol merkaadoi'	PERSON:3_PL
Táan u báaxalo'ob tu naajil báaxal	Táan k báaxal tu naajil báaxal	PERSON:1_PL
Ma'alobtalo' ku jóok'sa'al	Ma'alobtalo' ku jóok'sa'al	NOCHANGE
Yaan wáaj a bin koonol tu k'íiwikil koonol	Yaan wáaj u bino'ob koonol tu k'íiwikil koonol	PERSON:3_PL
Tu'ux k'íiwikil koonol taak a jóok'ol koonol	Tu'ux k'íiwikil koonol k'a'abéet a jóok'ol koonol	ASPECT:OBL
Ma' táan a bine'ex ich kooli'	Ma' táan ek bin ich kooli'	PERSON:1_PL
K'aas u le' ja'aso' ka'ana'an xan a	K'aas u le' ja'aso' ka'ana'an xan a	NOCHANGE
Te'exe' ti' a taale'exi'	To'one' ti' k taali'	PERSON:1_PL
Táan wáaj u boono'ob tu naajil xook	Táan wáaj a boone'ex xook tu naajil xook	PERSON:2_PL
Máax yéetel je'el a bin koonol tu kúuchil báaxale'	Máax yéetel taak a bin koonol tu kúuchil báaxal	SUBTYPE:DEC;ASPECT:DES
Te'exe' ajkoonole'ex ichil merkaado	Teche' ajkoonolech ichil merkaado	PERSON:2_SI
Leeti'e'e ma'ach u meentik mejen waajo'ob nukuch waaj	Leeti'e'e ma'ach u meentik mejen waajo'ob nukuch waaj	NOCHANGE
Yaan in suut koonol merkaado	Taak in suut koonol merkaado	ASPECT:DES
Leti'e' jbúulij	Teche' jbúulech	PERSON:2_SI
To'obil waaj ku beeta'ali' yáax chen de	To'obil waaj ku beeta'ali' yáax chen de	NOCHANGE
Táan a báaxal tu naajil báaxal	Táan k báaxal tu naajil báaxal	PERSON:1_PL
Máax yéetel suuk a bin koonol tu kúuchil báaxal	Máax yéetel taak a bin koonol tu kúuchil báaxal	SUBTYPE:DEC;ASPECT:DES
Te'exe' yaante'ex u áanalte'il u xookil matemáticas	Leti'e' yaan u áanalte'il u xook matemáticas	PERSON:3_SI
Ma' kajakbalech tin wotochi'	Ma' kajakbal tin wotochi'	PERSON:3_SI
Leti'o'obe' bino'ob áalkab te' taam paarkéeo'	To'one' bino'on áalkab te' taam paarkéeo'	PERSON:1_PL
Jach wáaj k'a'abéet a bine'ex merkaado	Jach wáaj k'a'abéet u bino'ob merkaado	PERSON:3_PL
Teche' áak'ab ka bin tu k'íiwikil koonol	To'one' áak'ab k bin tu k'íiwikil koonol	PERSON:1_PL
Yaan wáaj u bino'ob koonol tu k'íiwikil koonol	Yaan wáaj a bine'ex koonol tu k'íiwikil koonol	PERSON:2_PL
k ilaj wáaj u sáastal k kaajal	Tu yilo'ob wáaj u sáastal tu kaajalo'ob	PERSON:3_PL
Ta'aytak u chukik u ja'abil	Ta'aytak a chukike'ex u ja'abil	PERSON:2_PL
Teche' a k'aaba'e'	To'one' k k'aaba'e'	ASPECT:HAB;PERSON:1_PL
E la' chen xmaayáaj chen beya' ka'ach úuche'  beyo'	E la' chen xmaayáaj chen beya' ka'ach úuche'  beyo'	NOCHANGE
Táan k xook tu naajil xook	Táan u xooko'ob tu naajil xook	PERSON:3_PL
Yaan wáaj u xooko'ob tu naajil xook	Yaan wáaj u xook tu naajil xook	PERSON:3_SI
To'one' kek bin xíimbal ta wotoch	Leti'e' ku bin xíimbal ta wotoch	PERSON:3_SI
Te'exe' yaante'ex xook ti' español	To'onen yaanto'on xook ti' español	PERSON:1_PL
Ma' k ojel u ja'abili'	Ma' u yojelo'ob u ja'abili'	PERSON:3_PL
Ts'oka'an wáaj k beel	Ts'oka'an wáaj u beel	PERSON:3_SI
Pues ku k'u'unul ti' esten le ko'olebil maariao'	Pues ku k'u'unul ti' esten le ko'olebil maariao'	NOCHANGE
Táan wáaj u bino'ob koonol tu k'íiwikil koonol	Táan wáaj a bine'ex koonol tu k'íiwikil koonol	PERSON:2_PL
To'one' k báaxal paarkée	Leti'obe' ku báaxalo'ob paarkée	PERSON:3_PL
Mix ba'al yaan in jaanto'on tene' taak in kaxtin jump'éel tuúx	Mix ba'al yaan in jaanto'on tene' taak in kaxtin jump'éel tuúx	NOCHANGE
To'one' ma' jbúulo'on wáaj	Te'exe' ma' jbúule'ex wáaj	PERSON:2_PL
Ma' k'aja'anti'ob buka'aj u ja'abilo'obi'	Ma' k'aja'ante'ex buka'aj a ja'abile'exi'	PERSON:2_PL
Man t'anik mix máak yaan a tu'ubsik tak a na' yaan a tu'ubsik  tak tu'ux  tu'ux yaanlajech ka'achil	Man t'anik mix máak yaan a tu'ubsik tak a na' yaan a tu'ubsik  tak tu'ux  tu'ux yaanlajech ka'achil	NOCHANGE
Teche' ka báaxal tu naajil xook	to'one' k báaxal tu naajil xook	PERSON:1_PL
Jach k'a'abéet a bine'ex merkaado	Jach k'a'abéet u bino'ob merkaado	PERSON:3_PL
Táan a báaxale'ex báaxal tu naajil báaxal	Táan k báaxal tu naajil báaxal	PERSON:1_PL
Ma' jach k'a'abéet u bin k'íiwikil koonoli'	Ma' jach k'a'abéet a bine'ex k'íiwikil koonoli'	PERSON:2_PL
Ma' k a'alik u k'aaba'	Ma' u ya'alik u k'aaba'	PERSON:3_SI
Kin manik nikte'ob tu k'íiwikil koonol	Yaan in manik ch'ujuko'ob tu k'íiwikil koonol	ASPECT:COM
Yaan a báaxale'ex báaxal tu naajil báaxal	Yaan u báaxalo'ob tu naajil báaxal	PERSON:3_PL
Ts'oka'an wáaj a beele'ex	Ts'oka'an wáaj k beel	PERSON:1_PL
Ba'ax máaxti' ken a ts'a'e' wa ti' nukuch máako'obe' booxtak	Ba'ax máaxti' ken a ts'a'e' wa ti' nukuch máako'obe' booxtak	NOCHANGE
Teche' ka bin páak ich kool	Leti'e' ku bin páak ich kool	PERSON:3_SI
Kin wilike'ex merkaado	Ka wiliken merkaado	PERSON:2_SI
Ma' táan a bin koonol tu k'íiwikil koonol	Ma' táan u bino'ob koonol tu k'íiwikil koonol	PERSON:3_PL
Yaan wáaj u xook tu naajil xook	Yaan wáaj u xooko'ob tu naajil xook	PERSON:3_PL
To'onen yaanto'on meyaj biología	Te'exe' yaante'ex meyaj biología	PERSON:2_PL
Tu yilaj wáaj u sáastal tu kaajal	k ilaj wáaj u sáastal k kaajal	PERSON:1_PL
Yaan a jochike'ex chak nal ta koole'ex	Yaan a jochik chak nal ta kool	PERSON:2_SI
Táan u bino'ob koonol merkaado	Táan a bine'ex koonol merkaado	PERSON:2_PL
Yaan in manik ya'abach ba'alob tu k'íiwikil koonol	Taak in manik ya'abach ba'alo'ob tu k'íiwikil koonol	ASPECT:DES
Ma' utsi ts'o'olej tak u jo'olo'ob bejla'ake' láak wa'alakbal ku láak wa'akúunsiko'ob	Ma' utsi ts'o'olej tak u jo'olo'ob bejla'ake' láak wa'alakbal ku láak wa'akúunsiko'ob	NOCHANGE
A ki'iki' t'antik	A ki'iki' t'antik	NOCHANGE
Payalchi'o' mu'un béeytal	Payalchi'o' mu'un béeytal	NOCHANGE
Xaaw  wa ku ts'áak jump'éel xiik'  wa ku ts'áak jump'éel u bak'el tseeme'	Xaaw  wa ku ts'áak jump'éel xiik'  wa ku ts'áak jump'éel u bak'el tseeme'	NOCHANGE
Ku ku bey ts'o'ok u chokotal le tuunicho'ob túuno'	Ku ku bey ts'o'ok u chokotal le tuunicho'ob túuno'	NOCHANGE
Ts'oka'an wáaj k beel	Ts'oka'an wáaj a beel	PERSON:2_SI
Ta núukaj buka'aj a ja'abil	Tu núukaj buka'aj u ja'abil	PERSON:3_SI
Leti'e' ti' kajakbal tu yotoche'	To'one' ti' kajakbalo'on tu yotoche'	PERSON:1_PL
Táan u xook tu naajil xook	Táan a xook tu naajil xook	PERSON:2_SI
Mejentak ma nuuktak u beenta'ali'	Mejentak ma nuuktak u beenta'ali'	NOCHANGE
Tumeen tene' ma' uts in wiliki'	Tumeen tene' ma' uts in wiliki'	NOCHANGE
Yaan u suut tu naajil xook	Yaan k suut tu naajil xook	PERSON:1_PL
Tene' ma' ts'oka'an in beeli'	Ma' ts'oka'an in beeli'	TYPE:NEG;SUBTYPE:DEC
Táan u bin koonol tu k'íiwikil koonol	Leti'obe' táan u bino'ob koonol tu k'íiwikil koonol	PERSON:3_PL
Leti'e' áak'ab ku bin tu k'íiwikil koonol	Teche' áak'ab ka bin tu k'íiwikil koonol	PERSON:2_SI
Ku ya'alik bine'	Ku ya'alik bine'	NOCHANGE
To'one' áak'ab k bin tu k'íiwikil koonol	Teche' áak'ab ka bin tu k'íiwikil koonol	PERSON:2_SI
Tak ti' u kúchul u láak' le	Tak ti' u kúchul u láak' le	NOCHANGE
Sáansamal ku bin merkaado	Sáansamal ku bino'ob merkaado	PERSON:3_PL
Máax yéetel ts'o'ok a bin koonol tu kúuchil báaxal	Máax yéetel táant a bin koonol tu kúuchil báaxale'	ASPECT:IMM
Táan wáaj u xooko'ob tu naajil xook	Táan wáaj a xooke'ex xook tu naajil xook	PERSON:2_PL
Tan k kaxtik a najil	Táan u kaxtik a najil	PERSON:3_SI
Te'el tu'ux ts'o'on le xch'uupo' mina'an bini' sáam bin xi'ik	Te'el tu'ux ts'o'on le xch'uupo' mina'an bini' sáam bin xi'ik	NOCHANGE
Jach k'a'abéet wáaj u bin tu k'íiwikil koonol	Jach k'a'abéet wáaj a bine'ex tu k'íiwikil koonol	PERSON:2_PL
Táan wáaj u bin ich kool	Táan wáaj ek bin ich kool	PERSON:1_PL
Leti'e' ti' kajakbal tu yotoche'	Teche' ti' kajakbalech tu yotoche'	PERSON:2_SI
Leeti' le ken in tsol xan ee	Leeti' le ken in tsol xan ee	NOCHANGE
Tumeen bey bino' ma'atáan bin u wekiko'ob bin wa de kaaldo bine' ma'atáan bin u wekiko'ob bin le	Tumeen bey bino' ma'atáan bin u wekiko'ob bin wa de kaaldo bine' ma'atáan bin u wekiko'ob bin le	NOCHANGE
Uu uu yáalal le ka le kaab	Uu uu yáalal le ka le kaab	NOCHANGE
Te'exe' ka bine'ex páak tu kool	Leti'e' ku bin páak ich kool	PERSON:3_SI
Teche' ka bin paak'áal ich kool	Te'exe' ka taale'ex paak'áal ich kool	PERSON:2_PL
Jach wáaj k'a'abéet a bine'ex merkaado	Jach wáaj k'a'abéet u bin merkaado	PERSON:3_SI
Táan u suut tu naajil xook	Táan k suut tu naajil xook	PERSON:1_PL
Ma' u ya'aliko'ob u k'aaba'	Ma' u ya'alik u k'aaba'	PERSON:3_SI
Leti'e' kajakbal weye'	Leti'obe' kajakbalo'ob weye'	PERSON:3_PL
Táan u meyajo'ob ich kool	Táan ek meyaj ich kool	PERSON:1_PL
Xa'ak'pesk'aja'an  in miaatsilo'on	Xa'ak'pesk'aja'an  in miaatsilo'on	NOCHANGE
Táan k boon tu naajil xook	Táan a boone'ex xook tu naajil xook	PERSON:2_PL
Káaj in suut koonol merkaado	Táant in suut koonol merkaadoe'	ASPECT:IMM;TENSE:PAS_SIM
Yaan wáaj u bino'ob koonol tu k'íiwikil koonol	Yaan wáaj u bin koonol tu k'íiwikil koonol	PERSON:3_SI
Ee kajtalilo'	Ee kajtalilo'	NOCHANGE
Ma' kajakbal tin wotochi'	Ma' kajakbalo'on tin wotochi'	PERSON:1_PL
Jach k'a'abéet wáaj u bin tu k'íiwikil koonol	Jach wáaj k'a'abéet in bin k'íiwikil koonol	PERSON:1_SI
Ma' tin wilike'ex tu k'íiwikil koonol	Ma' tin wiliko'ob tu k'íiwikil koonol	PERSON:1_SI
Ta wile'ex wáaj u sáastal ta kaajale'ex	Tu yilo'ob wáaj u sáastal tu kaajalo'ob	PERSON:3_PL
Yaan wáaj a báaxale'ex báaxal tu naajil báaxal	Yaan wáaj k báaxal tu naajil báaxal	PERSON:1_PL
Ma' kajakbalo'on tin wotochi'	Ma' kajakbalech tin wotochi'	PERSON:2_SI
Kin bin koonol tu k'íiwikil koonol	k'a'abéet in bin koonol tu k'íiwikil koonol	ASPECT:OBL
Teche' ti' a taali'	To'one' ti' in taalo'oni'	PERSON:1_PL
Yaan u boono'ob tu naajil xook	Yaan a boone'ex xook tu naajil xook	PERSON:2_PL
Mix leti' kajakbal ta wotoch	Mix leti'ob kajakbalo'ob ta wotoch	PERSON:3_PL
Teche' áak'ab ka bin merkaado	Leti'e' áak'ab ku bin merkaado	PERSON:3_SI
k'a'abéet in bin koonol tu k'íiwikil koonol	Taak in bin koonol tu k'íiwikil koonol	ASPECT:DES
Je'el in manik ya'abach ba'alob tu k'íiwikil koonole'	Ts'o'ok in manik ya'abach ba'alob tu k'íiwikil koonol	ASPECT:TER;TENSE:PAS_SIM
Yaan wáaj u bin koonol tu k'íiwikil koonol	Yaan wáaj u bin koonol tu k'íiwikil koonol	PERSON:3_SI
K'a'abéet in manik ya'abach ba'alob tu k'íiwikil koonol	Taak in manik ya'abach ba'alo'ob tu k'íiwikil koonol	ASPECT:DES
Tu meentiko'ob janal ich kool	Ta meentik janal ich kool	PERSON:2_SI
Táan wáaj a xooke'ex xook tu naajil xook	Táan wáaj k xook tu naajil xook	PERSON:1_PL
Ma' tan a k'íilkabe'exi'	Ma' tan u k'íilkabo'obi'	PERSON:3_PL
To'one' k k'aaba'e'	Leti'e' u k'aaba'e'	ASPECT:HAB;PERSON:3_SI
Ma' k ojel u ja'abili'	Ma' a wojel u ja'abili'	PERSON:2_SI
Kin p'atik tech le  ayiik'alila' kanántej meyajtej ba'ale' to'one' saajko'on in ch'a'o'one' wa kin  meyajto'on wa	Kin p'atik tech le  ayiik'alila' kanántej meyajtej ba'ale' to'one' saajko'on in ch'a'o'one' wa kin  meyajto'on wa	NOCHANGE
Taak in manik ya'abach ba'alo'ob tu k'íiwikil koonol	Ts'o'ok in manik ya'abach ba'alob tu k'íiwikil koonol	ASPECT:TER;TENSE:PAS_SIM
Ma' ts'oka'an a beeli'	Ma' ts'oka'an a beele'exi'	PERSON:3_PL
Leti'obe' ti' u taalo'obi'	Leti'e' ti' u taali'	PERSON:3_SI
Máax yéetel taak a bin koonol tu kúuchil báaxal	Máax yéetel suuk a bin koonol tu kúuchil báaxal	SUBTYPE:DEC;ASPECT:CUS
Ma' táan a bin ich kooli'	Ma' táan a bine'ex ich kooli'	PERSON:2_PL
jayp'éel k'iino'ob ku bino'ob tu k'íiwikil koonol	Jayp'éel k'iino'ob ka bine'ex tu k'íiwikil koonol	PERSON:2_PL
Ma' ta wu'uyik ooxoli'	Ma' tu yu'ubiko'ob ooxoli'	PERSON:3_PL
Ts'oka'an wáaj u beelo'ob	Ts'oka'an wáaj k beel	PERSON:1_PL
Jaan chen ba'al bine' ka'a bin káaj u k'aj óolta'al le jboob ku ya'ala'alo'	Jaan chen ba'al bine' ka'a bin káaj u k'aj óolta'al le jboob ku ya'ala'alo'	NOCHANGE
Leti'obe' kajakbalo'ob weye'	Te'exe' kajakbale'ex weye'	PERSON:2_PL
Yaj uch a tséentik  ma bix a nojochkíinsik	Yaj uch a tséentik  ma bix a nojochkíinsik	NOCHANGE
Tu'ux k'íiwikil koonol k'a'abéet a jóok'ol koonol	Tu'ux k'íiwikil koonol káaj a jóok'ol koonol	ASPECT:BEG;TENSE:PAS_SIM
Ti' u beetiko'ob le kruuso'	Ti' u beetiko'ob le kruuso'	NOCHANGE
Kux wa  ka sa'atakech  máax kun kanáantiklech- ki bin ti'	Kux wa  ka sa'atakech  máax kun kanáantiklech- ki bin ti'	NOCHANGE
Yaan in wilikech te' tu kúuchil báaxalo'	Táant in wilikech te' tu kúuchil báaxalo'	ASPECT:IMM;TENSE:PAS_SIM
Jach taaj leeti'o'obe' jach ku ts'áaik u yóol u t'ano'ob máak leeti'o'obe' chen u ya'alobtech	Jach taaj leeti'o'obe' jach ku ts'áaik u yóol u t'ano'ob máak leeti'o'obe' chen u ya'alobtech	NOCHANGE
Ti'al u bin le pixano'obo'	Ti'al u bin le pixano'obo'	NOCHANGE
Tan a k'íilkab	Tan k k'íilkab	PERSON:1_PL
Yaan u xook tu naajil xook	Yaan a xooke'ex xook tu naajil xook	PERSON:2_PL
Tan a k'íilkabe'ex	Tan u k'íilkabo'ob	PERSON:3_PL
Teche' Yaan tech u áanalte'il a xook matemáticas	Te'exe' yaante'ex u áanalte'il u xookil matemáticas	PERSON:2_PL
Táan u meyajo'ob ich kool	Táan a meyaje'ex ich kool	PERSON:2_PL
To'one' k k'aaba'e'	Leti'obe' u k'aaba'obe'	ASPECT:HAB;PERSON:3_PL
To'one' áak'ab wáaj kek bin merkaado	Te'exe' áak'ab wáaj ka bine'ex merkaado	PERSON:2_PL
Ta'aytak a chukike'ex u ja'abil	Ta'aytak a chukik u ja'abil	PERSON:2_SI
Yaan wáaj a xooke'ex xook tu naajil xook	Yaan wáaj k xook tu naajil xook	PERSON:1_PL
Leti'e' u jatsmajubáaj	Te'exe' a jatsmajaba'ex	PERSON:2_PL
Yaan wáaj a bin ich kool	Yaan wáaj u bin ich kool	PERSON:3_SI
Te' u taalo'ob tu kaajil Kopomae'	Te' u taal tu kaajil Kopomae'	PERSON:3_SI
Táan u ya'akko'ob klo klo klo klo ki	Táan u ya'akko'ob klo klo klo klo ki	NOCHANGE
Te'exe' áak'ab wáaj ka bine'ex tu k'íiwikil koonol	Leti'e' áak'ab wáaj ku bin tu k'íiwikil koonol	PERSON:3_SI
Mix te'ex kajakbale'ex ta wotoch	Mix to'on kajakbalo'on ta wotoch	PERSON:1_PL
Te' a taal tu kaajil Kopomae'	Te' u taalo'ob tu kaajil Kopomae'	PERSON:3_PL
Sáansamal ka bin merkaado	Sáansamal ka bine'ex merkaado	PERSON:2_PL
Ba'atelnajo'ob te' tu kúuchil báaxalo'	Ba'atelnaje'ex te' tu kúuchil báaxalo'	PERSON:2_PL
Je'elo' ts'o'ok túune' ku múuch'ul le máako'ob ti' jump'éel kúuchil bey wa te'ej esten le kúuchil ku yúuchulo'	Je'elo' ts'o'ok túune' ku múuch'ul le máako'ob ti' jump'éel kúuchil bey wa te'ej esten le kúuchil ku yúuchulo'	NOCHANGE
Ma' tan u k'íilkabi'	Ma' tan u k'íilkabo'obi'	PERSON:3_PL
Bey u jets'ik'ob u kúuchilil tu láakal ba'al beyo'	Bey u jets'ik'ob u kúuchilil tu láakal ba'al beyo'	NOCHANGE
Táan a báaxale'ex báaxal tu naajil báaxal	Táan a báaxal tu naajil báaxal	PERSON:2_SI
Leti'e' ma' táan u bin koonol tu k'íiwikil koonol	Ma' táan k bin koonol tu k'íiwikil koonol	PERSON:1_PL
Yaan in manik ch'ujuko'ob tu k'íiwikil koonol	Táant in manik ch'ujuk pak'áal tu k'íiwikil koonole'	ASPECT:IMM;TENSE:PAS_SIM
Treese u yáalal le ka'ano' le sieteo' leeti' le yóok'ol kaabo' siete bin u yáalal le	Treese u yáalal le ka'ano' le sieteo' leeti' le yóok'ol kaabo' siete bin u yáalal le	NOCHANGE
Ma' tu yu'ubiko'ob wáaj ooxoli'	Ma' tek u'uyik wáaj ooxoli'	PERSON:1_PL
Ma' táan k bin koonol merkaadoi'	Ma' táan a bin koonol merkaadoi'	PERSON:2_SI
Ma' a wojel u ja'abili'	Ma' u yojel u ja'abili'	PERSON:3_SI
Ma' taak in bin maan tu k'íiwikil koonoli'	Ma' káaj in bin maan tu k'íiwikil koonoli'	ASPECT:BEG;TENSE:PAS_SIM
Tan a k'íilkab	Tan a k'íilkabe'ex	PERSON:2_PL
Éek'joch'e'en bin mix ba'al chika'ani'	Éek'joch'e'en bin mix ba'al chika'ani'	NOCHANGE
Ma' tu yu'ubiko'ob wáaj ooxoli'	Ma' tu yu'ubik wáaj ooxoli'	PERSON:3_SI
Ta núukaje'ex buka'aj a ja'abile'ex	Ta núukaj buka'aj a ja'abil	PERSON:2_SI
Yaan wáaj a bine'ex koonol tu k'íiwikil koonol	Yaan wáaj u bino'ob koonol tu k'íiwikil koonol	PERSON:3_PL
Táan u xooko'ob tu naajil xook	Táan a xook tu naajil xook	PERSON:2_SI
Tso'okol túune' ku jo'ol u pak'achtik yat xan le je'elo' leeti'e'	Tso'okol túune' ku jo'ol u pak'achtik yat xan le je'elo' leeti'e'	NOCHANGE
Yaan ek jochik chak nal tek kool	Yaan u jochiko'ob chak nal tu koolo'ob	PERSON:3_PL
Yaan a jochik chak nal ta kool	Yaan a jochike'ex chak nal ta koole'ex	PERSON:2_PL
Teche' ka bin páak ich kool	To'one kek bin páak ich kool	PERSON:1_PL
Pues chen bin u xusbiko'ob bin le tuunich  bino' leeti'o'ob bine' ku  beetiko'ob bin le ku na'aksiko'ob bin lenukuch tuuncho'ob bin beyo'	Pues chen bin u xusbiko'ob bin le tuunich  bino' leeti'o'ob bine' ku  beetiko'ob bin le ku na'aksiko'ob bin lenukuch tuuncho'ob bin beyo'	NOCHANGE
Ki'imak a wóol a bin ich kool	Ki'imak u yóolo'ob u bino'ob tu koolo'ob	PERSON:3_PL
Báalamo'ob wa ma' e' u apeyiidos  úuchben apeyiidos úuchben apeyiidos kanul	Báalamo'ob wa ma' e' u apeyiidos  úuchben apeyiidos úuchben apeyiidos kanul	NOCHANGE
Táan a báaxal tu naajil báaxal	Táan u báaxalo'ob tu naajil báaxal	PERSON:3_PL
Ma' ta wu'uyik  wáaj ooxoli'	Ka wu'uyik wáaj ooxol	TYPE:AFF;SUBTYPE:INT
Le chan xnuuko' ku ya'alik túun bine' -chan  xi'ipa k'a'abéet a jach tukultik máakal bejil ken a cha'e' tumeen jump'éel le bejo'	Le chan xnuuko' ku ya'alik túun bine' -chan  xi'ipa k'a'abéet a jach tukultik máakal bejil ken a cha'e' tumeen jump'éel le bejo'	NOCHANGE
Ma' táan a bin koonol tu k'íiwikil koonol	Ma' táan a bine'ex koonol tu k'íiwikil koonol	PERSON:2_PL
Táan a míistik in najil	Ta míistik in najil	PERSON:2_SI
Le ken a wil wel táan u jóok'ol u yóome' ka tupik yaanal ts'o'ok u liistoal beyo'	Le ken a wil wel táan u jóok'ol u yóome' ka tupik yaanal ts'o'ok u liistoal beyo'	NOCHANGE
Sáansamal ku bino'ob merkaado	Sáansamal ku bin merkaado	PERSON:3_SI
Táan k suut tu naajil xook	Táan a suute'ex xook tu naajil xook	PERSON:2_PL
Tu'ux kajakbalo'on	Tu'ux kajakbalech	PERSON:2_SI
Tumeen  píib le ba'ax ku k'u'ubulti'o'obo'	Tumeen  píib le ba'ax ku k'u'ubulti'o'obo'	NOCHANGE
Leti'e' ku bin xíimbal ta wotoch	Leti'e' ku bin xíimbal ta wotoch	PERSON:3_SI
Ku yilik bine' yaan jump'éel chan naj bin te'ej te'ej ichil le  solaar bey tu'ux ku meyajo'	Ku yilik bine' yaan jump'éel chan naj bin te'ej te'ej ichil le  solaar bey tu'ux ku meyajo'	NOCHANGE
Tene' bejla'ake' kin wilike' jach mina'an mix yéetel le kpaalalo'on	Tene' bejla'ake' kin wilike' jach mina'an mix yéetel le kpaalalo'on	NOCHANGE
Ma' táan u bino'ob koonol merkaadoi'	Ma' táan u bin koonol merkaadoi'	PERSON:3_SI
Leeti' túun bine' ku ya'alike' - yaan in bin in wil ba'ax le yaan te'el chan najo'	Leeti' túun bine' ku ya'alike' - yaan in bin in wil ba'ax le yaan te'el chan najo'	NOCHANGE
Yaan wáaj a bine'ex ich kool	Yaan wáaj u bin ich kool	PERSON:3_SI
Yaan wáaj u bino'ob koonol tu k'íiwikil koonol	Yaan wáaj a bin koonol tu k'íiwikil koonol	PERSON:2_SI
U kano'ob wa  u ma' u p'atiko'ob	U kano'ob wa  u ma' u p'atiko'ob	NOCHANGE
Ma' tu yu'ubiko'ob ooxoli'	Ma' ta wu'uyike'ex ooxoli'	PERSON:2_PL
Ichil túun le lela' ka tu taaso'ob le	Ichil túun le lela' ka tu taaso'ob le	NOCHANGE
Táan a bin koonol tu k'íiwikil koonol	Te'exe' táan a bine'ex koonol tu k'íiwikil koonol	PERSON:2_PL
U láak' jump'éel le bejo'  wa ka k'uchukech te'ej	U láak' jump'éel le bejo'  wa ka k'uchukech te'ej	NOCHANGE
K'a'abéet in suut koonol merkaado	Taak in suut koonol merkaado	ASPECT:DES
Te'exe' ma' jbúule'exi'	Leti'e' ma' jbúuli'	PERSON:3_SI
Ma' táan k bin koonol merkaadoi'	Ma' táan a bine'ex koonol merkaadoi'	PERSON:2_PL
Máax yéetel táant a bin koonol tu kúuchil báaxale'	Máax yéetel ts'o'ok a bin koonol tu kúuchil báaxal	ASPECT:TER
Ma' jach k'a'abéet wáaj u bino'ob tu k'íiwikil koonoli'	Ma' jach k'a'abéet wáaj a bine'ex k'íiwikil koonoli'	PERSON:2_PL
Yaan u boon tu naajil xook	Yaan k boon tu naajil xook	PERSON:1_PL
Le xa'ano' ti' kun k'axbil le mejen túut e mejen mejen waajo'obo' e e	Le xa'ano' ti' kun k'axbil le mejen túut e mejen mejen waajo'obo' e e	NOCHANGE
Leti'e' yaan xook ti' español	Teche' Yaan tech xook ti' español	PERSON:2_SI
Ook'in a bin tu k'íiwikil koonol	Ook'in a bine'ex k'íiwikil koonol	PERSON:2_PL
Ma' ta wu'uyike'ex ooxoli'	Ma' tu yu'ubik ooxoli'	PERSON:3_SI
Ti'al le ku ya'ala'al esten le muerteo' wa le máax bey u yet taal le	Ti'al le ku ya'ala'al esten le muerteo' wa le máax bey u yet taal le	NOCHANGE
Jaan ku ya'alik bine' pajteni' le ba'alo'  pajteni' le ba'alo' ki bin ju	Jaan ku ya'alik bine' pajteni' le ba'alo'  pajteni' le ba'alo' ki bin ju	NOCHANGE
U wolik u báai' ka'na'an a júuytik  a júuytik a júuytik	U wolik u báai' ka'na'an a júuytik  a júuytik a júuytik	NOCHANGE
U maasil túun bin le máako'obo' pues tu ganarto'ob u taak'in tumeen bey  tu yáanto'ob u	U maasil túun bin le máako'obo' pues tu ganarto'ob u taak'in tumeen bey  tu yáanto'ob u	NOCHANGE
Leti'obe' ti' kajakbalo'ob tu yotoche'	Leti'e' ti' kajakbal tu yotoche'	PERSON:3_SI
Mix leti'ob kajakbalo'ob ta wotoch	Mix te'ex kajakbale'ex ta wotoch	PERSON:2_PL
Te'exe' yaante'ex meyaj biología	Teche' Yaan tech meyaj biología	PERSON:2_SI
Ma' k'a'abéet in bin maan tu k'íiwikil koonoli'	Ma' suuk in bin maan tu k'íiwikil koonoli'	ASPECT:CUS
Pues le piimo' ee yaan u bisiko'ob bin yaan u bisiko'ob u jaanto'ob	Pues le piimo' ee yaan u bisiko'ob bin yaan u bisiko'ob u jaanto'ob	NOCHANGE
Táan wáaj k báaxal tu naajil báaxal	Táan wáaj u báaxal tu naajil báaxal	PERSON:3_SI
Yaan in bin koonol tu k'íiwikil koonol	Kin bin koonol tu k'íiwikil koonol	ASPECT:HAB
Chokol beyo' k'abéet chokol bin u ts'áabal bin  te'ej meesao'	Chokol beyo' k'abéet chokol bin u ts'áabal bin  te'ej meesao'	NOCHANGE
Yaan wáaj a bin koonol merkaado	Yaan wáaj u bin koonol merkaado	PERSON:3_SI
Táan u xooko'ob tu naajil xook	Táan k xook tu naajil xook	PERSON:1_PL
Kin wa'alo'one pues yan je'ex wa je'ex u ya'alik in áabueelao' in k'áate' in wáabilo'obe' u kano'ob le yóot'o'	Kin wa'alo'one pues yan je'ex wa je'ex u ya'alik in áabueelao' in k'áate' in wáabilo'obe' u kano'ob le yóot'o'	NOCHANGE
Yaan in manik ya'abach ba'alob tu k'íiwikil koonol	Ts'o'ok in manik ya'abach ba'alob tu k'íiwikil koonol	ASPECT:TER;TENSE:PAS_SIM
Ma' u yojel u ja'abili'	Ma' u yojelo'ob u ja'abili'	PERSON:3_PL
Táan a boone'ex xook tu naajil xook	Táan u boono'ob tu naajil xook	PERSON:3_PL
Teche' ka báaxal paarkée	Leti'obe' ku báaxalo'ob paarkée	PERSON:3_PL
U yooko'ob  u ka'bo'ob bin beya' laaj chowakyat bin u yíich'ak	U yooko'ob  u ka'bo'ob bin beya' laaj chowakyat bin u yíich'ak	NOCHANGE
To'one' ti' k taali'	Te'exe' ti' a taale'exi'	PERSON:2_PL
U áabuelóo u tatarabuelo beyo' ba'ale' u áabueloobe'  tsikbalte ti' leetio'ob	U áabuelóo u tatarabuelo beyo' ba'ale' u áabueloobe'  tsikbalte ti' leetio'ob	NOCHANGE
to'one' k báaxal tu naajil xook	te'exe' ka báaxale'ex tu naajil xook	PERSON:2_PL
U k'ajóota'al yéetel u	U k'ajóota'al yéetel u	NOCHANGE
Yook túun bin le ba'ax bin binik túun bin beya' aasta  tak bin u k'áab u chi'  láaj choojnaja'an táan bin u bin u	Yook túun bin le ba'ax bin binik túun bin beya' aasta  tak bin u k'áab u chi'  láaj choojnaja'an táan bin u bin u	NOCHANGE
Jbinech yéetel a éetailo'ob tu k'íiwikil koonol	Te'exe' jbine'ex yéetel a éetailo'ob tu k'íiwikil koonol	PERSON:2_PL
ku ts'íibo'ob tu naajil xook	ka ts'íib tu naajil xook	PERSON:2_SI
Táan a xooke'ex xook tu naajil xook	Táan a xook tu naajil xook	PERSON:2_SI
Ku ya'ala'a túun ti' le naj je'elo' áak'ab naj	Ku ya'ala'a túun ti' le naj je'elo' áak'ab naj	NOCHANGE
Te'exe' ti' a taale'exi'	Leti'e' ti' u taali'	PERSON:3_SI
Tu'ux kun ts'áabil u nu'ukulil	Tu'ux kun ts'áabil u nu'ukulil	NOCHANGE
Taak in bin koonol tu k'íiwikil koonol	k'a'abéet in bin koonol tu k'íiwikil koonol	ASPECT:OBL
Yuum k'ujo'ob ku ch'íilpoolta'al deesde úuchej tak te'el k'iinilo'oba' k-ike' beyo' tu'uxak kajalkajile'	Yuum k'ujo'ob ku ch'íilpoolta'al deesde úuchej tak te'el k'iinilo'oba' k-ike' beyo' tu'uxak kajalkajile'	NOCHANGE
Te'exe' kajakbale'ex weye'	Leti'obe' kajakbalo'ob weye'	PERSON:3_PL
Pool wíinikil tun bin jach u k'aaba' le kaajo'	Pool wíinikil tun bin jach u k'aaba' le kaajo'	NOCHANGE
Tu kaxtik a najil	Táan u kaxtiko'ob a naajil	PERSON:3_PL
Ma' jach k'a'abéet wáaj a bine'ex k'íiwikil koonoli'	Ma' jach k'a'abéet wáaj u bino'ob tu k'íiwikil koonoli'	PERSON:3_PL
Jach k'a'abéet wáaj u bino'ob tu k'íiwikil koonol	Jach k'a'abéet wáaj u bin tu k'íiwikil koonol	PERSON:3_SI
Suuk in wilikech te' tu kúuchil báaxalo'	Táan in wilikech te' tu kúuchil báaxalo'	ASPECT:PRG
Teche' ajkoonolech	To'one' ajkoonolo'on	PERSON:1_PL
Tu núukaj buka'aj u ja'abilo'ob	Tek núukaj buka'aj k ja'abil	PERSON:1_PL
Jayp'éel k'iino'ob ka bine'ex tu k'íiwikil koonol	jayp'éel k'iino'ob ku bino'ob tu k'íiwikil koonol	PERSON:3_PL
Yaan wáaj u bin koonol tu k'íiwikil koonol	Yaan wáaj u bino'ob koonol tu k'íiwikil koonol	PERSON:3_PL
Leti'obe' ts'oka'an wáaj u beelo'ob	To'one' ts'oka'an wáaj k beel	PERSON:1_PL
Tu núukaj buka'aj u ja'abilo'ob	Ta núukaje'ex buka'aj a ja'abile'ex	PERSON:2_PL
Je'el in suut koonol merkaado	Ts'o'ok in suut koonol merkaado	ASPECT:TER;TENSE:PAS_SIM
Ta meentik janal ich kool	Ta meentike'ex janal ich kool	PERSON:2_PL
Leti'e' áak'ab wáaj ku bin merkaado	To'one' áak'ab wáaj kek bin merkaado	PERSON:1_PL
Te' k taal tu kaajil Kopomae'	Te' u taalo'ob tu kaajil Kopomae'	PERSON:3_PL
Tu'ux kajakbalo'ob	Tu'ux kajakbalech	PERSON:2_SI
Le cha'aj cháako' ts'o'okol tun bey  esten uu	Le cha'aj cháako' ts'o'okol tun bey  esten uu	NOCHANGE
Jach k'a'abéet in bin tu k'íiwikil koonol	Jach k'a'abéet a bine'ex tu k'íiwikil koonol	PERSON:2_PL
Ma' tu yu'ubiko'ob ooxoli'	Ma' ta wu'uyik ooxoli'	PERSON:2_SI
Táan u meyaj tu kool	Táan a meyaj ich kool	PERSON:2_SI
Táan a bine'ex koonol merkaado	Táan k bin koonol merkaado	PERSON:1_PL
Teche' ka báaxal tu naajil xook	leti'e ku báaxal tu naajil xook	PERSON:3_SI
Ma' táan a bin ich kooli'	Ma' táan ek bin ich kooli'	PERSON:1_PL
Ts'oka'an wáaj u beelo'ob	Ts'oka'an wáaj u beel	PERSON:3_SI
Ook'in u bino'ob merkaado	Ook'in a bin merkaado	PERSON:2_SI
Je'el in manik ya'abach ba'alob tu k'íiwikil koonole'	Káaj in manik ya'abach ba'alob tu k'íiwikil koonol	ASPECT:BEG;TENSE:PAS_SIM
Te'ej k'iino'ob bejla'aka' jach tu láakal ts'o'ok u láaj jelpajal	Te'ej k'iino'ob bejla'aka' jach tu láakal ts'o'ok u láaj jelpajal	NOCHANGE
A wojel tu'ux u taal	Ma' a wojel tu'ux u taali'	TYPE:NEG;SUBTYPE:DEC
Yaan wáaj u báaxal tu naajil báaxal	Yaan wáaj a báaxale'ex báaxal tu naajil báaxal	PERSON:2_PL
Ma' u chuko'ob u ja'abili'	Ma' wáaj u chuko'ob u ja'abili'	TYPE:NEG;SUBTYPE:INT;MODE:SUB;ADVTENSE:NA;MARK:NI
Tu'ux kajakbale'ex	Tu'ux kajakbalo'on	PERSON:1_PL
Táan wáaj u xook tu naajil xook	Táan wáaj u xooko'ob tu naajil xook	PERSON:3_PL
Yaan a suut tu naajil xook	Yaan u suut tu naajil xook	PERSON:3_SI
To'one' bino'on áalkab te' taam paarkéeo'	Te'exe' bine'ex áalkab te' taam paarkéeo'	PERSON:2_PL
Ma' ts'oka'an a beeli'	Ma' ts'oka'an k beeli'	PERSON:1_PL
U jo'sa'al k'ajóoltbil le ti'al le mix ba'alo' le seero ku ya'ala'alo'	U jo'sa'al k'ajóoltbil le ti'al le mix ba'alo' le seero ku ya'ala'alo'	NOCHANGE
K'a'abéet in manik ya'abach ba'alob tu k'íiwikil koonol	Káaj in manik ya'abach ba'alob tu k'íiwikil koonol	ASPECT:BEG;TENSE:PAS_SIM
Yaan wáaj u xooko'ob tu naajil xook	Yaan wáaj k xook tu naajil xook	PERSON:1_PL
Leti'e' áak'ab wáaj ku bin tu k'íiwikil koonol	Teche' áak'ab wáaj ka bin tu k'íiwikil koonol	PERSON:2_SI
Te' a taal tu kaajil Kopomae'	Te' a taale'ex tu kaajil Kopomae'	PERSON:2_PL
Te'exe' áak'ab ka bine'ex merkaado	Teche' áak'ab ka bin merkaado	PERSON:2_SI
Ma' in kaxtej u bix ken in tsolilej	Ma' in kaxtej u bix ken in tsolilej	NOCHANGE
Ma'atáan u na'atik ba'ax a k'áat a wa'al ti' chen a koje	Ma'atáan u na'atik ba'ax a k'áat a wa'al ti' chen a koje	NOCHANGE
Jsa'atech wáaj te' paarkéeo'	Bix a sa'atal paarkée	SUBTYPE:INT;ASPECT:NA;ADVTENSE:A
Te'exe' áak'ab ka bine'ex merkaado	To'one' áak'ab kek bin merkaado	PERSON:1_PL
Leti'obe' u jatsmajuba'ob	Leti'e' u jatsmajubáaj	PERSON:3_SI
Tu núukaj buka'aj u ja'abil	Ta núukaj buka'aj a ja'abil	PERSON:2_SI
Bueeno te'elo' ku ts'áabal xan le ch'ujuk waaj ku ma'analao' le pan ku ya'ala'alo' ku ts'áabal xan te'ej mejen paalalo'obo'	Bueeno te'elo' ku ts'áabal xan le ch'ujuk waaj ku ma'analao' le pan ku ya'ala'alo' ku ts'áabal xan te'ej mejen paalalo'obo'	NOCHANGE
Táan u báaxal tu naajil báaxal	Táan a báaxal tu naajil báaxal	PERSON:2_SI
Españoles wa le káastelaan máako'obo'	Españoles wa le káastelaan máako'obo'	NOCHANGE
Ma' ta wile'ex u sáastal ta kaajale'exi'	Ma' ta wilaj u sáastal ta kaajali'	PERSON:2_SI
Yaan u yóol u tuukulilo'ob ti'al le ee	Yaan u yóol u tuukulilo'ob ti'al le ee	NOCHANGE
Mix leti'ob kajakbalo'ob ta wotoch	Mix to'on kajakbalo'on ta wotoch	PERSON:1_PL
Yaan wáaj ek bin ich kool	Yaan wáaj a bin ich kool	PERSON:2_SI
Ma'ach u cha'abal u yookol  mix máak te'el chan najo'	Ma'ach u cha'abal u yookol  mix máak te'el chan najo'	NOCHANGE
Te'exe' ajkoonole'ex	To'one' ajkoonolo'on	PERSON:1_PL
Ma' kajakbalo'on tin wotochi'	Ma' kajakbal tin wotochi'	PERSON:3_SI
Yaana k'as chan chinik a pool ti'	Yaana k'as chan chinik a pool ti'	NOCHANGE
Leti'e' ma' táan u bin koonol tu k'íiwikil koonol	Leti'e' ma' táan u bin koonol tu k'íiwikil koonol	PERSON:3_SI
Ma' a wojel u ja'abili'	Ma' u yojelo'ob u ja'abili'	PERSON:3_PL
Ku ts'áako'ob u nib óolil le ku meyajko'ob kool  ku ts'áako'ob u níin óolil e uu síibil ti'al leti'o'ob u	Ku ts'áako'ob u nib óolil le ku meyajko'ob kool  ku ts'áako'ob u níin óolil e uu síibil ti'al leti'o'ob u	NOCHANGE
Leeti' ken a ts'áaj ti' le taasa te'ej joolo'	Leeti' ken a ts'áaj ti' le taasa te'ej joolo'	NOCHANGE
Leti'e' áak'ab wáaj ku bin tu k'íiwikil koonol	To'one' áak'ab wáaj k bin tu k'íiwikil koonol	PERSON:1_PL
Ma' a wa'alike'ex u k'aaba'	Ma' u ya'alik u k'aaba'	PERSON:3_SI
Te'exe' ka taale'ex paak'áal ich kool	To'one' kek bin paak'áal ich kool	PERSON:1_PL
Yaan in bin koonol tu k'íiwikil koonol	Taak in bin koonol tu k'íiwikil koonol	ASPECT:DES
Es ke leeti'ee' tu kanaj u jaante máak tu sutaj u báaj de beyilo'	Es ke leeti'ee' tu kanaj u jaante máak tu sutaj u báaj de beyilo'	NOCHANGE
Ts'o'okol túune yáax ba'ax ku meentik in natsile' leeti'e' ku téetik le  jach	Ts'o'okol túune yáax ba'ax ku meentik in natsile' leeti'e' ku téetik le  jach	NOCHANGE
To'one' kajakbalo'on weye'	Leti'obe' kajakbalo'ob weye'	PERSON:3_PL
Jayp'éel kruus ken u ts'áai' treese u p'éelal mejen jool ken u beento'o'ob	Jayp'éel kruus ken u ts'áai' treese u p'éelal mejen jool ken u beento'o'ob	NOCHANGE
Tu'ux kajakbal	Tu'ux kajakbale'ex	PERSON:2_PL
Kin manik nikte'ob tu k'íiwikil koonol	K'a'abéet in manik suuts' pak'áal tu k'íiwikil koonol	ASPECT:OBL
Yaan wáaj u bin koonol tu k'íiwikil koonol	Yaan wáaj k bin koonol tu k'íiwikil koonol	PERSON:1_PL
Te'exe' ma' jbúule'exi'	Teche' ma' jbúulechi'	PERSON:2_SI
Te' k taal tu kaajil Kopomae'	Te' u taal tu kaajil Kopomae'	PERSON:3_SI
Táan a suute'ex xook tu naajil xook	Táan k suut tu naajil xook	PERSON:1_PL
Leti'e' ma' jbúuli'	Te'exe' ma' jbúule'exi'	PERSON:2_PL
Jejeláas u boonilo'ob	Jejeláas u boonilo'ob	NOCHANGE
Tu kaxtik a najil	Tan k kaxtik a najil	PERSON:1_PL
Ma'atáan u béeytal a beetik ti'o'ob beya' ma'atáan u béeytal a wa'alikti'o'ob beya'	Ma'atáan u béeytal a beetik ti'o'ob beya' ma'atáan u béeytal a wa'alikti'o'ob beya'	NOCHANGE
Táan k xook tu naajil xook	Táan a xooke'ex xook tu naajil xook	PERSON:2_PL
Táan a xooke'ex xook tu naajil xook	Táan u xook tu naajil xook	PERSON:3_SI
Eee páak'áal wa le esten le	Eee páak'áal wa le esten le	NOCHANGE
Tan a k'íilkabe'ex	Tan k k'íilkab	PERSON:1_PL
Ma' k'aja'anti' buka'aj u ja'abili'	Ma' k'aja'antech buka'aj a ja'abili'	PERSON:2_SI
Yaan wáaj a bin koonol tu k'íiwikil koonol	Yaan wáaj k bin koonol tu k'íiwikil koonol	PERSON:1_PL
Le ma'aj ko'ojtako' leeti' chen je'ex le ktakiko'ob  de boono'ob  de chen jump'éel	Le ma'aj ko'ojtako' leeti' chen je'ex le ktakiko'ob  de boono'ob  de chen jump'éel	NOCHANGE
Ba'ale' ichil túun le je'ela' ku jach ku yaakuntiko'ob le jajal yuumo'obo' laaten túune' ku ya'ala'ale' táaj yan u muuk'o'ob	Ba'ale' ichil túun le je'ela' ku jach ku yaakuntiko'ob le jajal yuumo'obo' laaten túune' ku ya'ala'ale' táaj yan u muuk'o'ob	NOCHANGE
Táan wáaj u boon tu naajil xook	Táan wáaj u boono'ob tu naajil xook	PERSON:3_PL
Ma' táan u bino'ob ich kooli'	Ma' táan u bin ich kooli'	PERSON:3_SI
U muuk'il ichil le kuxtal úuchben máasewáalo'obo'	U muuk'il ichil le kuxtal úuchben máasewáalo'obo'	NOCHANGE
Te'exe' ma' wáaj áak'ab ka bine'ex merkaadoi'	To'one' ma' wáaj áak'ab kek bin merkaadoi'	PERSON:1_PL
Te'exe' táan a bine'ex koonol tu k'íiwikil koonol	Táan k bin koonol tu k'íiwikil koonol	PERSON:1_PL
Leti'obe' táan u bino'ob koonol tu k'íiwikil koonol	Táan a bin koonol tu k'íiwikil koonol	PERSON:2_SI
Ka bin bini'	Ka bin bini'	NOCHANGE
Tu'ux kajakbal	Tu'ux kajakbalech	PERSON:2_SI
To'onen yaanto'on xook ti' español	Leti'e' yaan xook ti' español	PERSON:3_SI
Ka bin tu beeto'ob bin u chan naayo'ob tu k'ab bin le che'o'	Ka bin tu beeto'ob bin u chan naayo'ob tu k'ab bin le che'o'	NOCHANGE
Yaan wáaj u bin ich kool	Yaan wáaj a bin ich kool	PERSON:2_SI
Ma' ta wu'uyike'ex wáaj ooxoli'	Ma' tu yu'ubiko'ob wáaj ooxoli'	PERSON:3_PL
Sáansamal ka bin merkaado	Sáansamal ku bino'ob merkaado	PERSON:3_PL
Táan u kaxtiko'ob a naajil	Tu kaxko'ob a najil	PERSON:3_PL
Le ba'aba'al ku ya'ala'ale'	Le ba'aba'al ku ya'ala'ale'	NOCHANGE
Ma' táan k bin koonol merkaadoi'	Ma' táan u bino'ob koonol merkaadoi'	PERSON:3_PL
Táan in manik ya'abach ba'alob tu k'íiwikil koonol	Káaj in manik ya'abach ba'alob tu k'íiwikil koonol	ASPECT:BEG;TENSE:PAS_SIM
Yaan k xook tu naajil xook	Yaan u xooko'ob tu naajil xook	PERSON:3_PL
Le je'elo'	Le je'elo'	NOCHANGE
Tu yilaj wáaj u sáastal tu kaajal	Ta wile'ex wáaj u sáastal ta kaajale'ex	PERSON:2_PL
Ma' wáaj tu bin merkaado	Ma' wáaj tu bino'ob merkaado	PERSON:3_PL
Táan u suuto'ob tu naajil xook	Táan k suut tu naajil xook	PERSON:1_PL
Leti'e' ma' jbúuli'	Teche' ma' jbúulechi'	PERSON:2_SI
Táan u bin koonol merkaado	Táan a bine'ex koonol merkaado	PERSON:2_PL
Ka bin estee	Ka bin estee	NOCHANGE
Ma' wáaj ta bine'ex merkaado	Ma' wáaj tu bin merkaado	PERSON:2_PL
Teche' ts'oka'an wáaj a beel	Leti'obe' ts'oka'an wáaj u beelo'ob	PERSON:3_PL
Te'exe' áak'ab ka bine'ex merkaado	Leti'e' áak'ab ku bin merkaado	PERSON:3_SI
Je'el in manik ya'abach ba'alob tu k'íiwikil koonole'	Suuk in manik ya'abach ba'alob tu k'íiwikil koonol	ASPECT:CUS
To'one' kajakbalo'on weye'	Te'exe' kajakbale'ex weye'	PERSON:2_PL
Tu'ux kajakbalo'on	Tu'ux kajakbal	PERSON:3_SI
Te'exe' a jatsmajaba'ex	Leti'obe' u jatsmajuba'ob	PERSON:3_PL
te'exe' ka báaxale'ex tu naajil xook	Teche' ka báaxal tu naajil xook	PERSON:2_SI
Ma' ta wilaj u sáastal ta kaajali'	Ma' tu yilaj u sáastal tu kaajali'	PERSON:3_SI
Ma' táan u bino'ob koonol tu k'íiwikil koonol	Ma' táan k bin koonol tu k'íiwikil koonol	PERSON:1_PL
Ma' tu yilo'ob u sáastal tu kaajalo'obi'	Ma' tu yilaj u sáastal tu kaajali'	PERSON:3_SI
Máax yéetel suuk a bin koonol tu kúuchil báaxal	Máax yéetel táan a bin koonol tu kúuchil báaxal	SUBTYPE:DEC;ASPECT:PRG
Táan wáaj k boon tu naajil xook	Táan wáaj u boon tu naajil xook	PERSON:3_SI
Ma' táan a bin koonol tu k'íiwikil koonol	Ma' táan k bin koonol tu k'íiwikil koonol	PERSON:1_PL
Ook'in a bin tu k'íiwikil koonol	Ook'in u bino'ob k'íiwikil koonol	PERSON:3_PL
Ta'aytak a chukike'ex u ja'abil	Ta'aytak u chukiko'ob u ja'abil	PERSON:3_PL
Suuk in manik ya'abach ba'alob tu k'íiwikil koonol	Ts'o'ok in manik ya'abach ba'alob tu k'íiwikil koonol	ASPECT:TER;TENSE:PAS_SIM
Táan wáaj u bin ich kool	Táan wáaj u bino'ob ich kool	PERSON:3_PL
Yaan k báaxal tu naajil báaxal	Yaan a báaxale'ex báaxal tu naajil báaxal	PERSON:2_PL
Ku ts'áabal xan xchiináaj	Ku ts'áabal xan xchiináaj	NOCHANGE
Ma' tu yu'ubiko'ob ooxoli'	Ma' ta wu'uyike'ex ooxoli'	PERSON:2_PL
Ma' tan a k'íilkabi'	Ma' tan u k'íilkabo'obi'	PERSON:3_PL
Yaan wáaj k báaxal tu naajil báaxal	Yaan wáaj u báaxal tu naajil báaxal	PERSON:3_SI
Ku ts'aabal xa'an yóok'ole' ku ts'o'okole' ku mu'ukul	Ku ts'aabal xa'an yóok'ole' ku ts'o'okole' ku mu'ukul	NOCHANGE
J-jaanech merkaado	J-jaano'on merkaado	PERSON:1_PL
Táamal nojoch tu'ux kun ts'áabil baako'ob tu áakal le kun ts'áabil te'ej muerte te'ej joolo'	Táamal nojoch tu'ux kun ts'áabil baako'ob tu áakal le kun ts'áabil te'ej muerte te'ej joolo'	NOCHANGE
Yéetel tu láakal le ba'alo'ob bey ts'áaba'  de ke le paalo' yaan	Yéetel tu láakal le ba'alo'ob bey ts'áaba'  de ke le paalo' yaan	NOCHANGE
Te'exe' ti' a taale'exi'	Leti'obe' ti' u taalo'obi'	PERSON:3_PL
Táan u báaxal tu naajil báaxal	Táan u báaxalo'ob tu naajil báaxal	PERSON:3_PL
Áabastesimieento u ya'aliko'ob bin beyo'-	Áabastesimieento u ya'aliko'ob bin beyo'-	NOCHANGE
Táan wáaj k xook tu naajil xook	Táan wáaj u xook tu naajil xook	PERSON:3_SI
Ta meentik janal ich kool	Tu meentiko'ob janal ich kool	PERSON:3_PL
Tu meentik janal ich kool	Ta meentike'ex janal ich kool	PERSON:2_PL
Kaasi bey je'ex u ya'ala'al	Kaasi bey je'ex u ya'ala'al	NOCHANGE
Ku p'a'atal chen le ja'o' je'elo' chen le ja'o' je'elo' ken yáat le je'elo' teche' ts'o'ok a suut yéetel	Ku p'a'atal chen le ja'o' je'elo' chen le ja'o' je'elo' ken yáat le je'elo' teche' ts'o'ok a suut yéetel	NOCHANGE
Sáansamal ka bin merkaado	Sáansamal ku bin merkaado	PERSON:3_SI
Yaan u suuto'ob tu naajil xook	Yaan a suut tu naajil xook	PERSON:2_SI
Táan a boon tu naajil xook	Táan a boone'ex xook tu naajil xook	PERSON:2_PL
Bueenoleti'o'obe' ku tukultiko'obe' yaan ki'ichkelem yuum leeti'o'obe' jach tu jets'aj u tuukulo'ob  ti'al  le lelo'	Bueenoleti'o'obe' ku tukultiko'obe' yaan ki'ichkelem yuum leeti'o'obe' jach tu jets'aj u tuukulo'ob  ti'al  le lelo'	NOCHANGE
Te'exe' yaante'ex meyaj biología	Leti'e' yaan meyaj ti' biología	PERSON:3_SI
Ta'aytak u chukik u ja'abil	Ta'aytak k chukik u ja'abil	PERSON:1_PL
Ya'ab máako'ob utstak u nook'o'ob bin yani' táan u yilik yaan taak'ini'	Ya'ab máako'ob utstak u nook'o'ob bin yani' táan u yilik yaan taak'ini'	NOCHANGE
Jach k'a'abéet wáaj u bino'ob tu k'íiwikil koonol	Jach wáaj k'a'abéet in bin k'íiwikil koonol	PERSON:1_SI
Ch'ujuk je'ex u ch'ujukil le iis	Ch'ujuk je'ex u ch'ujukil le iis	NOCHANGE
Ts'oka'an wáaj a beel	Ts'oka'an wáaj u beel	PERSON:3_SI
Ma' táan a bin koonol merkaadoi'	Ma' táan u bino'ob koonol merkaadoi'	PERSON:3_PL
Táan wáaj k boon tu naajil xook	Táan wáaj a boone'ex xook tu naajil xook	PERSON:2_PL
Ma' táan u bino'ob koonol tu k'íiwikil koonol	Ma' táan a bin koonol tu k'íiwikil koonol	PERSON:2_SI
Yaan k báaxal tu naajil báaxal	Yaan a báaxal tu naajil báaxal	PERSON:2_SI
Táan wáaj u báaxalo'ob tu naajil báaxal	Táan wáaj a báaxale'ex báaxal tu naajil báaxal	PERSON:2_PL
Jweene'ex ich kool	Jweeno'ob ich kool	PERSON:3_PL
Ba'ax u láak' xane' pues lete'ej xan le ee	Ba'ax u láak' xane' pues lete'ej xan le ee	NOCHANGE
To'one' ts'oka'an wáaj k beel	Leti'e' ts'oka'an wáaj u beel	PERSON:3_SI
Ma' táan u bino'ob koonol tu k'íiwikil koonol	Ma' táan a bine'ex koonol tu k'íiwikil koonol	PERSON:2_PL
Táan u bin koonol merkaado	Táan u bino'ob koonol merkaado	PERSON:3_PL
óok'otnajech tu naajil xook	óok'otnajo'on tu naajil xook	PERSON:1_PL
Táan a bin koonol tu k'íiwikil koonol	Leti'obe' táan u bino'ob koonol tu k'íiwikil koonol	PERSON:3_PL
Táan u boono'ob tu naajil xook	Táan k boon tu naajil xook	PERSON:1_PL
Táan ek kaxtik a wotoch	Táan u kaaxtik a wotoch	PERSON:3_SI
Ma' táan a bine'ex ich kooli'	Ma' táan u bino'ob ich kooli'	PERSON:3_PL
Ba'atelnaje'ex te' tu kúuchil báaxalo'	Ba'atelnajo'ob te' tu kúuchil báaxalo'	PERSON:3_PL
Yóok'sal túun u cha'abal u jaanale' yaan a ts'áaik te'ej joolo'	Yóok'sal túun u cha'abal u jaanale' yaan a ts'áaik te'ej joolo'	NOCHANGE
Teche' ti' kajakbalech tu yotoche'	To'one' ti' kajakbalo'on tu yotoche'	PERSON:1_PL
Te'exe' ka bine'ex páak tu kool	To'one kek bin páak ich kool	PERSON:1_PL
En kaambio be'ele' ma' chen máanak le paalalo'obo' hasta ol u kojiko'ob le nukuch máako'ob chen máanako'ob tu tséelo'	En kaambio be'ele' ma' chen máanak le paalalo'obo' hasta ol u kojiko'ob le nukuch máako'ob chen máanako'ob tu tséelo'	NOCHANGE
Ma' tin wilikech tu k'íiwikil koonol	Ma' tin wilike'ex tu k'íiwikil koonol	PERSON:1_SI
To'onen yaanto'on wáaj meyaj ti' biología	Leti'e' yaan wáaj meyaj ti' biología	PERSON:3_SI
Tu núukaj buka'aj u ja'abil	Tek núukaj buka'aj k ja'abil	PERSON:1_PL
Táan wáaj u bino'ob koonol tu k'íiwikil koonol	Táan wáaj k bin koonol tu k'íiwikil koonol	PERSON:1_PL
Ma' tu yilo'ob u sáastal tu kaajalo'obi'	Ma' tak ilaj u sáastal k kaajali'	PERSON:1_PL
Leti'e' ma' táan u bin koonol tu k'íiwikil koonol	Ma' táan a bin koonol tu k'íiwikil koonol	PERSON:2_SI
Yaan in manik ya'abach ba'alob tu k'íiwikil koonol	K'a'abéet in manik ya'abach ba'alob tu k'íiwikil koonol	ASPECT:OBL
Ma' ts'oka'an a beele'exi'	Ma' ts'oka'an a beeli'	PERSON:2_SI
Leti'obe' u k'aaba'obe'	To'one' in k'aaba'one'	ASPECT:HAB;PERSON:1_PL
Táan wáaj k báaxal tu naajil báaxal	Táan wáaj u báaxalo'ob tu naajil báaxal	PERSON:3_PL
Jun p'íit wa ya'ab le je'elo' yaan wíinike' ki' u yu'u'ubik jach máan túun	Jun p'íit wa ya'ab le je'elo' yaan wíinike' ki' u yu'u'ubik jach máan túun	NOCHANGE
E máako'ob xan be'elake' pues táan in wiko'on bik le	E máako'ob xan be'elake' pues táan in wiko'on bik le	NOCHANGE
Leti'obe' ti' u taalo'obi'	To'one' ti' in taalo'oni'	PERSON:1_PL
Ma' kajakbalo'ob tin wotochi'	Ma' kajakbalo'on tin wotochi'	PERSON:1_PL
Ba'atelnajech te' tu kúuchil báaxalo'	Ba'atelnajo'ob te' tu kúuchil báaxalo'	PERSON:3_PL
Ma' k'aja'anto'on buka'aj k ja'abili'	Ma' k'aja'anti' buka'aj u ja'abili'	PERSON:3_SI
Uuu uu leti'o ka'achil le ka'achilo' ku beeta'al le p'úujo'	Uuu uu leti'o ka'achil le ka'achilo' ku beeta'al le p'úujo'	NOCHANGE
Leti'obe' jbino'ob yéetel u éetailo'ob tu k'íiwikil koonol	Te'exe' jbine'ex yéetel a éetailo'ob tu k'íiwikil koonol	PERSON:2_PL
Ku ts'o'okol túune' ka tasláantik esten eu che'il	Ku ts'o'okol túune' ka tasláantik esten eu che'il	NOCHANGE
Tu'ux kajakbale'ex	Tu'ux kajakbalo'ob	PERSON:3_PL
Tak u aja le biix ku ya'ala'alo'	Tak u aja le biix ku ya'ala'alo'	NOCHANGE
Taak in suut koonol merkaado	Ts'o'ok in suut koonol merkaado	ASPECT:TER;TENSE:PAS_SIM
Ka'abeje' yaan a bine'ex koonol	Ka'abeje' yaan u bino'ob koonol	PERSON:3_PL
Yaan a báaxal tu naajil báaxal	Yaan k báaxal tu naajil báaxal	PERSON:1_PL
Ma' táan k bin koonol tu k'íiwikil koonol	Leti'e' ma' táan u bin koonol tu k'íiwikil koonol	PERSON:3_SI
Yaan a suute'ex xook tu naajil xook	Yaan k suut tu naajil xook	PERSON:1_PL
Jach k'a'abéet u bin merkaado	Jach k'a'abéet in bin merkaado	PERSON:1_SI
Táan wáaj a bine'ex ich kool	Táan wáaj ek bin ich kool	PERSON:1_PL
Ma' u yojelo'ob u ja'abili'	Ma' k ojel u ja'abili'	PERSON:1_PL
Yaan k boon tu naajil xook	Yaan u boon tu naajil xook	PERSON:3_SI
Leti'e' ma' wáaj áak'ab ku bin merkaadoi'	To'one' ma' wáaj áak'ab kek bin merkaadoi'	PERSON:1_PL
Táan k báaxal tu naajil báaxal	Táan a báaxal tu naajil báaxal	PERSON:2_SI
Taak in manik ya'abach ba'alo'ob tu k'íiwikil koonol	Suuk in manik ya'abach ba'alob tu k'íiwikil koonol	ASPECT:CUS
Táan wáaj u báaxal tu naajil báaxal	Táan wáaj a báaxale'ex báaxal tu naajil báaxal	PERSON:2_PL
Yaan wáaj u báaxalo'ob tu naajil báaxal	Yaan wáaj u báaxal tu naajil báaxal	PERSON:3_SI
Táan wáaj a boone'ex xook tu naajil xook	Táan wáaj k boon tu naajil xook	PERSON:1_PL
Suuk in suut koonol merkaado	Ts'o'ok in suut koonol merkaado	ASPECT:TER;TENSE:PAS_SIM
Leti'e' ma' táan u bin koonol tu k'íiwikil koonol	Ma' táan a bine'ex koonol tu k'íiwikil koonol	PERSON:2_PL
Kpues ku ts'áabal bin le lelo' yóok'sal bine' leeti'o'ob táan u jaantiko'ob le je'elo'	Kpues ku ts'áabal bin le lelo' yóok'sal bine' leeti'o'ob táan u jaantiko'ob le je'elo'	NOCHANGE
Yaan k suut tu naajil xook	Yaan u suuto'ob tu naajil xook	PERSON:3_PL
Táant in bin koonol tu k'íiwikil koonole'	Káaj in bin koonol tu k'íiwikil koonol	ASPECT:BEG
Ya'ab u k'áat óolal máak yóok'sal u k'áata'al eee santo ja'o'	Ya'ab u k'áat óolal máak yóok'sal u k'áata'al eee santo ja'o'	NOCHANGE
Mix leti'ob kajakbalo'ob ta wotoch	Ma' kajakbale'ex tin wotochi'	PERSON:2_PL
To'one' áak'ab kek bin merkaado	Leti'e' áak'ab ku bin merkaado	PERSON:3_SI
Ma' táan a bine'ex ich kooli'	Ma' táan u bin ich kooli'	PERSON:3_SI
Táan k bin koonol tu k'íiwikil koonol	Táan u bin koonol tu k'íiwikil koonol	PERSON:3_SI
Ma' u ya'aliko'ob u k'aaba'	Ma' a wa'alike'ex u k'aaba'	PERSON:2_PL
De k'aak'as ba'alil túun	De k'aak'as ba'alil túun	NOCHANGE
To'one' áak'ab wáaj k bin tu k'íiwikil koonol	Teche' áak'ab wáaj ka bin tu k'íiwikil koonol	PERSON:2_SI
Jach k'a'abéet in bin merkaado	Jach k'a'abéet u bin merkaado	PERSON:3_SI
Ma' tan a k'íilkabe'exi'	Ma' tan a k'íilkabi'	PERSON:2_SI
Ma' tan u k'íilkabo'obi'	Ma' tan a k'íilkabi'	PERSON:2_SI
Leti'e' ti' u taali'	Leti'obe' ti' u taalo'obi'	PERSON:3_PL
Ma' u ya'alik u k'aaba'	Ma' u ya'aliko'ob u k'aaba'	PERSON:3_PL
Tu kaxko'ob a najil	Táan ek kaxtik a najil	PERSON:1_PL
Táan u bino'ob koonol merkaado	Táan k bin koonol merkaado	PERSON:1_PL
Yaan wáaj a bine'ex koonol merkaado	Yaan wáaj u bino'ob koonol merkaado	PERSON:3_PL
Táan u kaxtik a najil	Tu kaxtik a najil	PERSON:3_SI
Yaan u suuto'ob tu naajil xook	Yaan k suut tu naajil xook	PERSON:1_PL
Yaan wáaj k bin koonol merkaado	Yaan wáaj u bino'ob koonol merkaado	PERSON:3_PL
Ma' táan a bin koonol merkaadoi'	Ma' táan u bin koonol merkaadoi'	PERSON:3_SI
Táan a boon tu naajil xook	Táan u boono'ob tu naajil xook	PERSON:3_PL
Yaan wáaj a bine'ex koonol merkaado	Yaan wáaj a bin koonol merkaado	PERSON:2_SI
Tan a k'íilkab	Tan u k'íilkabo'ob	PERSON:3_PL
Táan wáaj u xooko'ob tu naajil xook	Táan wáaj k xook tu naajil xook	PERSON:1_PL
-ba'an túun ken in meentej bix ken in meentil ka in wil máax le yaan te'elo' máax le yan te'elo'	-ba'an túun ken in meentej bix ken in meentil ka in wil máax le yaan te'elo' máax le yan te'elo'	NOCHANGE
Mix teech kajakbalech ta wotoch	Ma' kajakbale'ex tin wotochi'	PERSON:2_PL
Káaj in manik ya'abach ba'alob tu k'íiwikil koonol	Táant in manik ya'abach ba'alo'ob tu k'íiwikil koonole'	ASPECT:IMM;TENSE:PAS_SIM
Táan k bin koonol merkaado	Táan a bine'ex koonol merkaado	PERSON:2_PL
Jach k'a'abéet wáaj u bin ich kool	Ma' wáaj jach k'a'abéet u bin tu kooli'	TYPE:NEG;SUBTYPE:INT
A níib óoltik  a chíimpooltik le nukuch máako'ob wa maas úuchbentak ti' teecho'	A níib óoltik  a chíimpooltik le nukuch máako'ob wa maas úuchbentak ti' teecho'	NOCHANGE
Táan wáaj k boon tu naajil xook	Táan wáaj u boono'ob tu naajil xook	PERSON:3_PL
Ku k'as ku táakpajalo'obo' tumeen ti'al u meenta'al le payalchi'o' mu'un béeytal u táakpajal ko'oleli'	Ku k'as ku táakpajalo'obo' tumeen ti'al u meenta'al le payalchi'o' mu'un béeytal u táakpajal ko'oleli'	NOCHANGE
Bey túuno' ts'o'ok u chokotal bey le	Bey túuno' ts'o'ok u chokotal bey le	NOCHANGE
Yaan a báaxale'ex báaxal tu naajil báaxal	Yaan u báaxal tu naajil báaxal	PERSON:3_SI
Leti'obe' táan u bino'ob koonol tu k'íiwikil koonol	Táan u bin koonol tu k'íiwikil koonol	PERSON:3_SI
Yaan wáaj a bin koonol merkaado	Yaan wáaj u bino'ob koonol merkaado	PERSON:3_PL
J-jaanech merkaado	J-jaane'ex merkaado	PERSON:2_PL
Mina'an wáaj ti'ob 17 ja'abo'ob	Yaan wáaj ti' te'ex kex 17 ja'abo'ob	TYPE:NEG;SUBTYPE:INT
Bejla'ake' u beeta'ale' jach máan ko'oj u beeta'al	Bejla'ake' u beeta'ale' jach máan ko'oj u beeta'al	NOCHANGE
Leti'e' u k'aaba'e'	Teche' a k'aaba'e'	ASPECT:HAB;PERSON:2_SI
Mix teech kajakbalech ta wotoch	Mix te'ex kajakbale'ex ta wotoch	PERSON:2_PL
Ts'oka'an wáaj u beel	Ts'oka'an wáaj a beel	PERSON:2_SI
Teche' ti' kajakbalech tu yotoche'	Te'exe' ti' kajakbale'ex tu yotoche'	PERSON:2_PL
Tu'ux k'íiwikil koonol suuk a jóok'ol koonol	Tu'ux k'íiwikil koonol taak a jóok'ol koonol	ASPECT:DES
Ma' táan a bin koonol merkaadoi'	Ma' táan k bin koonol merkaadoi'	PERSON:3_PL
Ku tukulta'ale' yaan u bis'aal tumeen le nukuch máako'obo' wa tumeen le kimeno'obo'	Ku tukulta'ale' yaan u bis'aal tumeen le nukuch máako'obo' wa tumeen le kimeno'obo'	NOCHANGE
Ma' ta wu'uyike'ex wáaj ooxoli'	Ma' tu yu'ubik wáaj ooxoli'	PERSON:3_SI
Táan k boon tu naajil xook	Táan u boon tu naajil xook	PERSON:3_SI
Leti'e' áak'ab ku bin merkaado	To'one' áak'ab kek bin merkaado	PERSON:1_PL
Yaan wáaj u bino'ob koonol merkaado	Yaan wáaj u bin koonol merkaado	PERSON:3_SI
Táan u kaxtiko'ob a wotoch	Táan ek kaxtik a wotoch	PERSON:1_PL
Tan k k'íilkab	Tan a k'íilkab	PERSON:2_SI
J-jaano'on merkaado	J-jaanech merkaado	PERSON:2_SI
ka ts'íib tu naajil xook	ku ts'íibo'ob tu naajil xook	PERSON:3_PL
Ba'ax ja'abil jsíijo'ob	Ba'ax ja'abil jsíijij	PERSON:3_SI
Le k-oojlo'on tu yo'lal le xch'i'ibalo'ob úuchben uchik u chu'unul le kya'ak lu'uma'	Le k-oojlo'on tu yo'lal le xch'i'ibalo'ob úuchben uchik u chu'unul le kya'ak lu'uma'	NOCHANGE
Mix teech kajakbalech ta wotoch	Mix leti' kajakbal ta wotoch	PERSON:3_SI
Le xa'ano' ku t'a'abal túun	Le xa'ano' ku t'a'abal túun	NOCHANGE
Leti'e' ma' jbúuli'	To'one' ma' jbúulo'oni'	PERSON:1_PL
Ts'oka'an wáaj a beele'ex	Ts'oka'an wáaj u beel	PERSON:3_SI
Máako'ob jach ka'anachaj u tuukulo'ob	Máako'ob jach ka'anachaj u tuukulo'ob	NOCHANGE
K'a'abéet wáaj in jóok'ol koonol tu k'íiwikil koonol	Suuk wáaj in jóok'ol koonol tu k'íiwikil koonol	ASPECT:CUS;TENSE:PRE_SIM
Ma' táan a bin koonol tu k'íiwikil koonol	Leti'e' ma' táan u bin koonol tu k'íiwikil koonol	PERSON:3_SI
Juuch' ka'ana'an ti'al a tatkúunsikle eee u ja'il le kaax bey ts'o'ok a	Juuch' ka'ana'an ti'al a tatkúunsikle eee u ja'il le kaax bey ts'o'ok a	NOCHANGE
Ook'in a bin ich kool	Ook'in u bino'ob tu koolo'ob	PERSON:3_PL
Leti'e' yaan u áanalte'il u xook matemáticas	To'onen yaanto'on u áanalte'il k xook matemáticas	PERSON:1_PL
Yaan a báaxale'ex báaxal tu naajil báaxal	Yaan a báaxal tu naajil báaxal	PERSON:2_SI
Leti'obe' kajakbalo'ob weye'	To'one' kajakbalo'on weye'	PERSON:1_PL
Yaan wáaj ek bin ich kool	Yaan wáaj u bino'ob ich kool	PERSON:3_PL
Kin in suut koonol merkaado	Táant in suut koonol merkaadoe'	ASPECT:IMM;TENSE:PAS_SIM
Bey tuno' jach bey tak bejla'ak tune' le k'iin bejla'ake' le masewáalo'ona' pues ti'an weye' kuxa'ano'on	Bey tuno' jach bey tak bejla'ak tune' le k'iin bejla'ake' le masewáalo'ona' pues ti'an weye' kuxa'ano'on	NOCHANGE
Táan u meyaj tu kool	Táan a meyaje'ex ich kool	PERSON:2_PL
Suuk in bin koonol tu k'íiwikil koonol	Kin bin koonol tu k'íiwikil koonol	ASPECT:HAB
Jach k'a'abéet a bine'ex tu k'íiwikil koonol	Jach k'a'abéet in bin tu k'íiwikil koonol	PERSON:1_SI
E mayak che'o' te'ej yáanal le mayak che'o' ti' yan túun le óoxtul mejen muucho'obo'	E mayak che'o' te'ej yáanal le mayak che'o' ti' yan túun le óoxtul mejen muucho'obo'	NOCHANGE
Ma' ta wu'uyike'ex wáaj ooxoli'	Ma' tek u'uyik wáaj ooxoli'	PERSON:1_PL
Ma' tin wiliko'ob tu k'íiwikil koonol	Ma' tin wilikech tu k'íiwikil koonol	PERSON:1_SI
Yaan a xooke'ex xook tu naajil xook	Yaan k xook tu naajil xook	PERSON:1_PL
To'one' k u'uyik wáaj ooxol	Leti'o'obe' ku yu'ubiko'ob ooxol	PERSON:3_PL
Yaan a boone'ex xook tu naajil xook	Yaan u boono'ob tu naajil xook	PERSON:3_PL
Jeee esten le boob túuno'  leeti' pues k'aas bin leeti'e'  jun	Jeee esten le boob túuno'  leeti' pues k'aas bin leeti'e'  jun	NOCHANGE
Tak e le paaxo' yaan p'áatal tak te'ej k'iinilo'ob ichilo'ona' je'el le maaya páaxo'	Tak e le paaxo' yaan p'áatal tak te'ej k'iinilo'ob ichilo'ona' je'el le maaya páaxo'	NOCHANGE
Ma' jach k'a'abéet wáaj u bin tu k'íiwikil koonoli'	Ma' jach k'a'abéet wáaj u bino'ob tu k'íiwikil koonoli'	PERSON:3_PL
Ba'ale' yaan k'iine' kin wa'ako'one pues	Ba'ale' yaan k'iine' kin wa'ako'one pues	NOCHANGE
Leti'e' ts'oka'an wáaj u beel	Leti'obe' ts'oka'an wáaj u beelo'ob	PERSON:3_PL
Ma' tan a k'íilkabi'	Ma' tan k k'íilkabi'	PERSON:1_PL
Je'el u béeytal in wiko'one' jach jaaj  je'ex u kaxta'al xan le taak'ino'ob ti' le muka'ano'obo'	Je'el u béeytal in wiko'one' jach jaaj  je'ex u kaxta'al xan le taak'ino'ob ti' le muka'ano'obo'	NOCHANGE
To'one' k u'uyik wáaj ooxol	ku yu'ubik wáaj ooxol	PERSON:3_SI
Te' k taal tu kaajil Kopomae'	Te' a taal tu kaajil Kopomae'	PERSON:2_SI
To'onen yaanto'on meyaj biología	Teche' Yaan tech meyaj biología	PERSON:2_SI
Te'exe' ma' wáaj áak'ab ka bine'ex merkaadoi'	Leti'e' ma' wáaj áak'ab ku bin merkaadoi'	PERSON:3_SI
Te' u taal tu kaajil Kopomae'	Te' k taal tu kaajil Kopomae'	PERSON:1_PL
Tu taaso'ob ba'alo'ob  xan túumben ba'alo'ob	Tu taaso'ob ba'alo'ob  xan túumben ba'alo'ob	NOCHANGE
Ts'o'ok u náakal in wóol óotsilo'on mix ba'al yaan in kjaanto'on	Ts'o'ok u náakal in wóol óotsilo'on mix ba'al yaan in kjaanto'on	NOCHANGE
Ku yilik bine' k'uch ti' jump'éel tu'ux bine'	Ku yilik bine' k'uch ti' jump'éel tu'ux bine'	NOCHANGE
Ma' tin wiliko'ob tu k'íiwikil koonol	Ma' tin wilike'ex tu k'íiwikil koonol	PERSON:1_SI
Táan ek kaxtik a wotoch	Táan u kaxtiko'ob a wotoch	PERSON:3_PL
Ma' a wojele'ex u ja'abili'	Ma' a wojel u ja'abili'	PERSON:2_SI
Táan a meyaj ich kool	Táan u meyaj tu kool	PERSON:3_SI
Ma' a wojele'ex u ja'abili'	Ma' k ojel u ja'abili'	PERSON:1_PL
Beya' ku láalik le k'óolo' ku ts'o'ole'  ku  ts'áak le bak'o'o ku ts'o'okol túune' ku	Beya' ku láalik le k'óolo' ku ts'o'ole'  ku  ts'áak le bak'o'o ku ts'o'okol túune' ku	NOCHANGE
Ma' ta wu'uyik ooxoli'	Ma' ta wu'uyike'ex ooxoli'	PERSON:2_PL
Leti'e' áak'ab ku bin merkaado	Teche' áak'ab ka bin merkaado	PERSON:2_SI
Táan wáaj a xooke'ex xook tu naajil xook	Táan wáaj u xooko'ob tu naajil xook	PERSON:3_PL
óok'otnajo'on tu naajil xook	óok'otnajech tu naajil xook	PERSON:2_SI
Jach wáaj k'a'abéet u bino'ob merkaado	Jach wáaj k'a'abéet a bine'ex merkaado	PERSON:2_PL
to'one' k báaxal tu naajil xook	leti'e ku báaxal tu naajil xook	PERSON:3_SI
Táan ek kaxtik a najil	Tu kaxtik a najil	PERSON:3_SI
U saantos e  españooleso'obo'   e yaan tu seentro séeremoniaale chan kaj	U saantos e  españooleso'obo'   e yaan tu seentro séeremoniaale chan kaj	NOCHANGE
Te'ej je'el túuna' ti' túun kun beetbil le waajo'ob de to'obilo'	Te'ej je'el túuna' ti' túun kun beetbil le waajo'ob de to'obilo'	NOCHANGE
k'a'abéet in bin koonol tu k'íiwikil koonol	Suuk in bin koonol tu k'íiwikil koonol	ASPECT:CUS
Teche' áak'ab ka bin tu k'íiwikil koonol	Leti'e' áak'ab ku bin tu k'íiwikil koonol	PERSON:3_SI
To'one' ti' kajakbalo'on tu yotoche'	Teche' ti' kajakbalech tu yotoche'	PERSON:2_SI
Yaan wáaj u bin koonol tu k'íiwikil koonol	Yaan wáaj u bino'ob koonol tu k'íiwikil koonol	PERSON:3_PL
Teche' Yaan tech u áanalte'il a xook matemáticas	Leti'e' yaan u áanalte'il u xook matemáticas	PERSON:3_SI
Ma' kajakbal tin wotochi'	Ma' kajakbalo'ob tin wotochi'	PERSON:3_PL
Tréesieentos kuatrosieentos jump'éel	Tréesieentos kuatrosieentos jump'éel	NOCHANGE
Eee nojoch ba'al yanik xan ti' le kaan xan ichilo'obo' le báalamo'obo'	Eee nojoch ba'al yanik xan ti' le kaan xan ichilo'obo' le báalamo'obo'	NOCHANGE
Teche' Yaan tech xook ti' español	Leti'e' yaan xook ti' español	PERSON:3_SI
Táan ek meyaj ich kool	Táan u meyajo'ob ich kool	PERSON:3_PL
Táan in wilikech te' tu kúuchil báaxalo'	Kin wilikech te' tu kúuchil báaxalo'	ASPECT:HAB
Le je'ela' u chan	Le je'ela' u chan	NOCHANGE
Teche' ka bin paak'áal ich kool	To'one' kek bin paak'áal ich kool	PERSON:1_PL
Ts'o'ok wáaj in jóok'ol koonol tu k'íiwikil koonol	Yaan wáaj in jóok'ol koonol tu k'íiwikil koonol	ASPECT:COM;TENSE:FUT_SIM
Esten lelele k'áat chi' ti'al u yúuchul le	Esten lelele k'áat chi' ti'al u yúuchul le	NOCHANGE
Táan a bin koonol tu k'íiwikil koonol	Táan u bin koonol tu k'íiwikil koonol	PERSON:3_SI
Yaan wáaj u bino'ob koonol tu k'íiwikil koonol	Yaan wáaj u bino'ob koonol tu k'íiwikil koonol	PERSON:3_PL
Jweene'ex ich kool	Jweenech ich kool	PERSON:2_SI
Te'exe' áak'ab wáaj ka bine'ex merkaado	Leti'e' áak'ab wáaj ku bin merkaado	PERSON:3_SI
Ta'aytak a chukik u ja'abil	Ta'aytak a chukike'ex u ja'abil	PERSON:2_PL
Yaan wáaj u bin koonol merkaado	Yaan wáaj a bin koonol merkaado	PERSON:2_SI
Yaan wáaj a bine'ex koonol tu k'íiwikil koonol	Yaan wáaj k bin koonol tu k'íiwikil koonol	PERSON:1_PL
Uts tin wich tumeen ku ts'áaik u páajtalil	Uts tin wich tumeen ku ts'áaik u páajtalil	NOCHANGE
Yaan wáaj a bine'ex ich kool	Yaan wáaj ek bin ich kool	PERSON:1_PL
Te'exe' ma' jbúule'ex wáaj	Te'exe' jbúule'ex wáaj	TYPE:AFF;SUBTYPE:INT
Le ch le kibo' pues yaan a cha'a'ik u láaj ja'abali' ma'atáan xan a bin a tupej ka láaj	Le ch le kibo' pues yaan a cha'a'ik u láaj ja'abali' ma'atáan xan a bin a tupej ka láaj	NOCHANGE
Máax yéetel je'el a bin koonol tu kúuchil báaxale'	Máax yéetel ts'o'ok a bin koonol tu kúuchil báaxal	ASPECT:TER;TENSE:PAS_SIM
Tumeen yaan k'iine' ma' in ti'alo'oni wa ma'e' yaan a  a bixij	Tumeen yaan k'iine' ma' in ti'alo'oni wa ma'e' yaan a  a bixij	NOCHANGE
Jach k'a'abéet u bino'ob tu k'íiwikil koonol	Jach k'a'abéet a bine'ex tu k'íiwikil koonol	PERSON:2_PL
To'one' bino'on áalkab te' taam paarkéeo'	Leti'o'obe' bino'ob áalkab te' taam paarkéeo'	PERSON:3_PL
Teche' ka bin páak ich kool	Te'exe' ka bine'ex páak tu kool	PERSON:2_PL
Tu'ux kajakbalech	Tu'ux kajakbale'ex	PERSON:2_PL
Ma' táan a bine'ex koonol tu k'íiwikil koonol	Leti'e' ma' táan u bin koonol tu k'íiwikil koonol	PERSON:3_SI
Yaan wáaj u xook tu naajil xook	Yaan wáaj k xook tu naajil xook	PERSON:1_PL
Te'exe' ti' kajakbale'ex tu yotoche'	Teche' ti' kajakbalech tu yotoche'	PERSON:2_SI
Ba'ale' ichil  láaili' xane' le úuchben máako'obo' láaj yaan bin u	Ba'ale' ichil  láaili' xane' le úuchben máako'obo' láaj yaan bin u	NOCHANGE
Je'el u béeytal u ts'áabal xa'an wa je'el u béeytal u ts'áabal u le' ja'as yóok'ol bey	Je'el u béeytal u ts'áabal xa'an wa je'el u béeytal u ts'áabal u le' ja'as yóok'ol bey	NOCHANGE
Yaan k boon tu naajil xook	Yaan u boono'ob tu naajil xook	PERSON:3_PL
Ma' tu yilo'ob u sáastal tu kaajalo'obi'	Ma' ta wile'ex u sáastal ta kaajale'exi'	PERSON:2_PL
Yaan wáaj k bin koonol merkaado	Yaan wáaj u bin koonol merkaado	PERSON:3_SI
Yaan wáaj k bin koonol tu k'íiwikil koonol	Yaan wáaj a bine'ex koonol tu k'íiwikil koonol	PERSON:2_PL
Táan a bin koonol merkaado	Táan u bin koonol merkaado	PERSON:3_SI
Ma' tan u k'íilkabi'	Ma' tan a k'íilkabi'	PERSON:2_SI
Ma' ts'oka'an k beeli'	Ma' ts'oka'an a beeli'	PERSON:2_SI
Te'exe' áak'ab ka bine'ex tu k'íiwikil koonol	Leti'e' áak'ab ku bin tu k'íiwikil koonol	PERSON:3_SI
Yaan wáaj u bin koonol merkaado	Yaan wáaj k bin koonol merkaado	PERSON:1_PL
Ka'abeje' yaan u bino'ob koonol merkaado	Ka'abeje' yaan a bine'ex koonol merkaado	PERSON:2_PL
Kin wa'alik tene' kin wa'alik bey ti' in in  paalila'	Kin wa'alik tene' kin wa'alik bey ti' in in  paalila'	NOCHANGE
Ma' k'aja'ante'ex buka'aj a ja'abile'exi'	Ma' k'aja'anti'ob buka'aj u ja'abilo'obi'	PERSON:3_PL
Ma' táan a bine'ex koonol tu k'íiwikil koonol	Ma' táan u bino'ob koonol tu k'íiwikil koonol	PERSON:3_PL
Te'exe' ka bine'ex páak tu kool	Teche' ka bin páak ich kool	PERSON:2_SI
Te che' bino'	Te che' bino'	NOCHANGE
Jach k'a'abéet u bin merkaado	Jach k'a'abéet a bine'ex merkaado	PERSON:2_PL
To'one' k báaxal paarkée	Teche' ka báaxal paarkée	PERSON:2_SI
Te'ej yáax taaxo' ti' ken a ts'áaj le jump'íit le esten le   ki'iwaj de kaaldo'	Te'ej yáax taaxo' ti' ken a ts'áaj le jump'íit le esten le   ki'iwaj de kaaldo'	NOCHANGE
Yaan u jochiko'ob chak nal tu koolo'ob	Yaan a jochik chak nal ta kool	PERSON:2_SI
Ka u yil ma' u	Ka u yil ma' u	NOCHANGE
óok'otnaje'ex tu naajil xook	óok'otnajo'on tu naajil xook	PERSON:1_PL
Ts'oka'an wáaj k beel	Ts'oka'an wáaj u beelo'ob	PERSON:3_PL
Táan ek meyaj ich kool	Táan u meyaj tu kool	PERSON:3_SI
Te'exe' ka wu'uyike'ex wáaj ooxol	ku yu'ubik wáaj ooxol	PERSON:3_SI
Ma' k'a'abéet in bin maan tu k'íiwikil koonoli'	Ma' káaj in bin maan tu k'íiwikil koonoli'	ASPECT:BEG;TENSE:PAS_SIM
Ma' táan u bino'ob koonol tu k'íiwikil koonol	Leti'e' ma' táan u bin koonol tu k'íiwikil koonol	PERSON:3_SI
Yaan wáaj a xooke'ex xook tu naajil xook	Yaan wáaj u xook tu naajil xook	PERSON:3_SI
Táant in manik ch'ujuk pak'áal tu k'íiwikil koonole'	Ts'o'ok in manik janal tu k'íiwikil koonol	ASPECT:TER;TENSE:PAS_SIM
Táan u xook tu naajil xook	Táan u xooko'ob tu naajil xook	PERSON:3_PL
To'one' ti' kajakbalo'on tu yotoche'	Leti'obe' ti' kajakbalo'ob tu yotoche'	PERSON:3_PL
Jump'éel diia antese' ku bin ch'akbil	Jump'éel diia antese' ku bin ch'akbil	NOCHANGE
Ma' k'aja'anti' buka'aj u ja'abili'	Ma' k'aja'anto'on buka'aj k ja'abili'	PERSON:1_PL
Jach k'a'abéet u bino'ob merkaado	Jach k'a'abéet u bin merkaado	PERSON:3_SI
Tu meentik janal ich kool	Ta meentik janal ich kool	PERSON:2_SI
Jbino'ob yéetel u éetailo'ob merkaado	Jbinech yéetel a éetailo'ob merkaado	PERSON:2_SI
Ma' táan k bin koonol tu k'íiwikil koonol	Ma' táan a bine'ex koonol tu k'íiwikil koonol	PERSON:2_PL
Jach wáaj k'a'abéet a bine'ex merkaado	Jach wáaj k'a'abéet in bin merkaado	PERSON:1_SI
To'one' ajkoonolo'on ichil merkaado	Te'exe' ajkoonole'ex ichil merkaado	PERSON:2_PL
Táan wáaj u bin koonol tu k'íiwikil koonol	Táan wáaj k bin koonol tu k'íiwikil koonol	PERSON:1_PL
Je'elo' bey ti'ano'ob  yáanal túun le  ee	Je'elo' bey ti'ano'ob  yáanal túun le  ee	NOCHANGE
To'onen yaanto'on wáaj meyaj ti' biología	Te'exe' yaante'ex wáaj meyaj ti' biología	PERSON:2_PL
To'one' ti' k taali'	To'one' ti' in taalo'oni'	PERSON:1_PL
Tu k'iinil bey ta'aytak u koolo'obo'  leeti'o'obe' ku k'áatiko'ob ti' le	Tu k'iinil bey ta'aytak u koolo'obo'  leeti'o'obe' ku k'áatiko'ob ti' le	NOCHANGE
Ta núukaje'ex buka'aj a ja'abile'ex	Tek núukaj buka'aj k ja'abil	PERSON:1_PL
Táan k báaxal tu naajil báaxal	Táan a báaxale'ex báaxal tu naajil báaxal	PERSON:2_PL
To'one' jbúulo'on	Te'exe' jbúule'ex	PERSON:2_PL
To'one' ti' kajakbalo'on tu yotoche'	Leti'e' ti' kajakbal tu yotoche'	PERSON:3_SI
Yaan k boon tu naajil xook	Yaan a boon tu naajil xook	PERSON:2_SI
Ka tu sutaj túun de chiichi'il le jach u yuumil túun le palaasio ka tu k'a'alal tun bin te'el najo'	Ka tu sutaj túun de chiichi'il le jach u yuumil túun le palaasio ka tu k'a'alal tun bin te'el najo'	NOCHANGE
Kex bin brujoe' pero leeti'o'obe' mas ya'abo'ob bin	Kex bin brujoe' pero leeti'o'obe' mas ya'abo'ob bin	NOCHANGE
Ma' ts'oka'an u beeli'	Ma' ts'oka'an k beeli'	PERSON:1_PL
Tu yilaj wáaj u sáastal tu kaajal	Tu yilo'ob wáaj u sáastal tu kaajalo'ob	PERSON:3_PL
Ma' u ya'alik u k'aaba'	Ma' k a'alik u k'aaba'	PERSON:1_PL
To'one' k u'uyik wáaj ooxol	Te'exe' ka wu'uyike'ex wáaj ooxol	PERSON:2_PL
Yaan wáaj u bin koonol tu k'íiwikil koonol	Yaan wáaj a bine'ex koonol tu k'íiwikil koonol	PERSON:2_PL
Teche' kajakbalech weye'	To'one' kajakbalo'on weye'	PERSON:1_PL
Ma' kajakbalo'on tin wotochi'	Ma' kajakbalo'ob tin wotochi'	PERSON:3_PL
k'aaynajo'ob tu naajil xook	K'aaynajech tu naajil xook	PERSON:2_SI
Leti'obe' ku báaxalo'ob paarkée	To'one' k báaxal paarkée	PERSON:1_PL
Te'exe' a k'aaba'exe'	Leti'obe' u k'aaba'obe'	ASPECT:HAB;PERSON:3_PL
Ken ts'o'okok beyo' bey ma' síisako' yaan wíinike' kin wilik	Ken ts'o'okok beyo' bey ma' síisako' yaan wíinike' kin wilik	NOCHANGE
ku yu'ubik wáaj ooxol	Leti'o'obe' ku yu'ubiko'ob ooxol	PERSON:3_PL
To'one' kek bin paak'áal ich kool	Teche' ka bin paak'áal ich kool	PERSON:2_SI
Suuk in manik ya'abach ba'alob tu k'íiwikil koonol	Táan in manik ya'abach ba'alob tu k'íiwikil koonol	ASPECT:PRG
Yaan a xook tu naajil xook	Yaan a xooke'ex xook tu naajil xook	PERSON:2_PL
Leeti' ku ts'áabali' je'el puut	Leeti' ku ts'áabali' je'el puut	NOCHANGE
Leti'obe' u jatsmajuba'ob	To'one' k jatsmajekbáaj	PERSON:1_PL
Te'exe' táan a bine'ex koonol tu k'íiwikil koonol	Leti'obe' táan u bino'ob koonol tu k'íiwikil koonol	PERSON:3_PL
Teche' ka báaxal paarkée	Te'exe' ka báaxale'ex paarkée	PERSON:2_PL
Yaan wáaj u xook tu naajil xook	Yaan wáaj a xooke'ex xook tu naajil xook	PERSON:2_PL
Ken ts'o'okok túun bey u siistal le k'óolo' ba'ax ku beetik tuune' ku ki'	Ken ts'o'okok túun bey u siistal le k'óolo' ba'ax ku beetik tuune' ku ki'	NOCHANGE
K'a'abéet in manik ya'abach ba'alob tu k'íiwikil koonol	Ts'o'ok in manik ya'abach ba'alob tu k'íiwikil koonol	ASPECT:TER;TENSE:PAS_SIM
Táan a suute'ex xook tu naajil xook	Táan a suut tu naajil xook	PERSON:2_SI
Leti'obe' táan u bino'ob koonol tu k'íiwikil koonol	Táan k bin koonol tu k'íiwikil koonol	PERSON:1_PL
Táan k bin koonol tu k'íiwikil koonol	Táan a bin koonol tu k'íiwikil koonol	PERSON:2_SI
Suuk u beeta'ale'	Suuk u beeta'ale'	NOCHANGE
Te'exe' yaante'ex meyaj biología	To'onen yaanto'on meyaj biología	PERSON:1_PL
Leti'e' yaan u áanalte'il u xook matemáticas	Teche' Yaan tech u áanalte'il a xook matemáticas	PERSON:2_SI
Chen bin u bin u máan le k'iino'ob bino' táanu  bin u máan máan u bin u máan táan bin u  máan jach jaaj ku ganatik taak'in	Chen bin u bin u máan le k'iino'ob bino' táanu  bin u máan máan u bin u máan táan bin u  máan jach jaaj ku ganatik taak'in	NOCHANGE
Bey túun ts'o'ok u jóok'sa'al le waajo' ku	Bey túun ts'o'ok u jóok'sa'al le waajo' ku	NOCHANGE
Táan u kaxtiko'ob a naajil	Tu kaxtik a najil	PERSON:3_SI
Leti'e' ajkoonol	Teche' ajkoonolech	PERSON:2_SI
Yaan a suut tu naajil xook	Yaan k suut tu naajil xook	PERSON:1_PL
Te'ej áak'abilo' le beetik ku ts'áabal le kibobo'obo'	Te'ej áak'abilo' le beetik ku ts'áabal le kibobo'obo'	NOCHANGE
Táan in manik ya'abach ba'alob tu k'íiwikil koonol	K'a'abéet in manik ya'abach ba'alob tu k'íiwikil koonol	ASPECT:OBL
Yaan u jochiko'ob chak nal tu koolo'ob	Yaan ek jochik chak nal tek kool	PERSON:1_PL
Táan u meyaj tu kool	Táan u meyajo'ob ich kool	PERSON:3_PL
Yaan wáaj a bin koonol tu k'íiwikil koonol	Yaan wáaj a bine'ex koonol tu k'íiwikil koonol	PERSON:2_PL
Táant in manik ya'abach ba'alo'ob tu k'íiwikil koonole'	Ts'o'ok in manik ya'abach ba'alob tu k'íiwikil koonol	ASPECT:TER;TENSE:PAS_SIM
Ma' k'aja'antech buka'aj a ja'abili'	Ma' k'aja'ante'ex buka'aj a ja'abile'exi'	PERSON:2_PL
Táan u suuto'ob tu naajil xook	Táan a suut tu naajil xook	PERSON:2_SI
Ol ichka'ap'eelchaja'an beyo' yaan e tuukul kastelaano' yaan u tuukulil maayai'	Ol ichka'ap'eelchaja'an beyo' yaan e tuukul kastelaano' yaan u tuukulil maayai'	NOCHANGE
Kin wilikech te' tu kúuchil báaxalo'	Suuk in wilikech te' tu kúuchil báaxalo'	ASPECT:CUS
Táan wáaj k bin koonol tu k'íiwikil koonol	Táan wáaj a bine'ex koonol tu k'íiwikil koonol	PERSON:2_PL
Tu'ux k'íiwikil koonol k'a'abéet a jóok'ol koonol	Tu'ux k'íiwikil koonol suuk a jóok'ol koonol	ASPECT:CUS
A pantaloono'o ken bey ti' leeti'a' paktej ken ti'	A pantaloono'o ken bey ti' leeti'a' paktej ken ti'	NOCHANGE
Ma' táan u bin ich kooli'	Ma' táan ek bin ich kooli'	PERSON:1_PL
Leti'obe' u jatsmajuba'ob	Te'exe' a jatsmajaba'ex	PERSON:2_PL
K'a'abéet in manik ya'abach ba'alob tu k'íiwikil koonol	Táant in manik ya'abach ba'alo'ob tu k'íiwikil koonole'	ASPECT:IMM;TENSE:PAS_SIM
Pero jach bin tu puksi'ik'al bin xan ts'aa'y u yóol le ts'oono'	Pero jach bin tu puksi'ik'al bin xan ts'aa'y u yóol le ts'oono'	NOCHANGE
Táan a bin koonol merkaado	Táan k bin koonol merkaado	PERSON:1_PL
Ka bin u yilo'ob bin ba'ax ts'o'ok u kaxtik leeti'	Ka bin u yilo'ob bin ba'ax ts'o'ok u kaxtik leeti'	NOCHANGE
Ts'o'ok in manik janal tu k'íiwikil koonol	Táant in manik ch'ujuk pak'áal tu k'íiwikil koonole'	ASPECT:IMM;TENSE:PAS_SIM
Ma' tek u'uyik wáaj ooxoli'	Ma' ta wu'uyike'ex wáaj ooxoli'	PERSON:2_PL
Yaan u xooko'ob tu naajil xook	Yaan k xook tu naajil xook	PERSON:1_PL
Táan wáaj u xooko'ob tu naajil xook	Táan wáaj u xook tu naajil xook	PERSON:3_SI
Táan u suut tu naajil xook	Táan a suute'ex xook tu naajil xook	PERSON:2_PL
Ma' a wa'alike'ex u k'aaba'	Ma' u ya'aliko'ob u k'aaba'	PERSON:3_PL
Ku cha'abal jump'éel súutukil jump'éel ooraj	Ku cha'abal jump'éel súutukil jump'éel ooraj	NOCHANGE
Juntúul xi'ipal le reeyo'  ka tu suto'ob beyo'	Juntúul xi'ipal le reeyo'  ka tu suto'ob beyo'	NOCHANGE
Yaan in suut koonol merkaado	Kin in suut koonol merkaado	ASPECT:HAB
Le ken súutuk de k'aak'asba'alil beya'	Le ken súutuk de k'aak'asba'alil beya'	NOCHANGE
Ma' ts'oka'an u beeli'	Ma' ts'oka'an a beeli'	PERSON:2_SI
Te'exe' ts'oka'an wáaj a beele'ex	Leti'e' ts'oka'an wáaj u beel	PERSON:3_SI
k ilaj wáaj u sáastal k kaajal	Tu yilaj wáaj u sáastal tu kaajal	PERSON:3_SI
Ma' a wa'alike'ex u k'aaba'	Ma' k a'alik u k'aaba'	PERSON:1_PL
Wa jump'éelili' ken a meente le waaj beyo'	Wa jump'éelili' ken a meente le waaj beyo'	NOCHANGE
Tu yaak'abile' le kibo'ob láaj	Tu yaak'abile' le kibo'ob láaj	NOCHANGE
óok'otnaje'ex tu naajil xook	óok'otnajech tu naajil xook	PERSON:2_SI
Yaan in manik ya'abach ba'alob tu k'íiwikil koonol	Je'el in manik ya'abach ba'alob tu k'íiwikil koonole'	ASPECT:INS
To'one' in k'aaba'one'	Leti'obe' u k'aaba'obe'	ASPECT:HAB;PERSON:3_PL
Suuk in suut koonol merkaado	Táant in suut koonol merkaadoe'	ASPECT:IMM;TENSE:PAS_SIM
Tu kaxko'ob a najil	Táan u kaxtiko'ob a naajil	PERSON:3_PL
Yaan wáaj k xook tu naajil xook	Yaan wáaj u xook tu naajil xook	PERSON:3_SI
Ch'up wey ko'on weenele'ki bin  pues ko'ox na'akal tu k'ab le	Ch'up wey ko'on weenele'ki bin  pues ko'ox na'akal tu k'ab le	NOCHANGE
Táan k bin koonol tu k'íiwikil koonol	Leti'obe' táan u bino'ob koonol tu k'íiwikil koonol	PERSON:3_PL
Te'exe' jbúule'ex	Teche' jbúulech	PERSON:2_SI
Yaanlaj bin juntúul chan nojoch máak bine' bueeno juntúul chan nojoch ko'olej bin beyo'	Yaanlaj bin juntúul chan nojoch máak bine' bueeno juntúul chan nojoch ko'olej bin beyo'	NOCHANGE
Ma' tu yu'ubik wáaj ooxoli'	Ma' tek u'uyik wáaj ooxoli'	PERSON:1_PL
Mix teech kajakbalech ta wotoch	Mix leti'ob kajakbalo'ob ta wotoch	PERSON:3_PL
Te' u taal tu kaajil Kopomae'	Te' a taale'ex tu kaajil Kopomae'	PERSON:2_PL
U sáastale' teche' ts'o'ok a juch'ik a	U sáastale' teche' ts'o'ok a juch'ik a	NOCHANGE
Te'exe' ajkoonole'ex ichil merkaado	To'one' ajkoonolo'on ichil merkaado	PERSON:1_PL
Táan k bin koonol merkaado	Táan u bin koonol merkaado	PERSON:3_SI
Ma' tak ilaj u sáastal k kaajali'	Ma' tu yilo'ob u sáastal tu kaajalo'obi'	PERSON:3_PL
Leti'e' yaan u áanalte'il u xook matemáticas	Te'exe' yaante'ex u áanalte'il u xookil matemáticas	PERSON:2_PL
Te'exe' jbine'ex yéetel a éetailo'ob tu k'íiwikil koonol	Jbinech yéetel a éetailo'ob tu k'íiwikil koonol	PERSON:2_SI
k'aaynaje'ex tu naajil xook	K'aaynajech tu naajil xook	PERSON:2_SI
Ma' táan k bin koonol tu k'íiwikil koonol	Ma' táan u bino'ob koonol tu k'íiwikil koonol	PERSON:3_PL
Tu'ux kajakbale'ex	Tu'ux kajakbal	PERSON:3_SI
Ta núukaj buka'aj a ja'abil	Tek núukaj buka'aj k ja'abil	PERSON:1_PL
Ook'in u bino'ob k'íiwikil koonol	Ook'in a bin tu k'íiwikil koonol	PERSON:2_SI
Táan u bino'ob koonol merkaado	Táan a bin koonol merkaado	PERSON:2_SI
Bey túuno' ti' bin ka'ach ku yaantal  u gobernantesilo'ob te'elo'	Bey túuno' ti' bin ka'ach ku yaantal  u gobernantesilo'ob te'elo'	NOCHANGE
To'one' ma' jbúulo'on wáaj	Leti'e' ma' jbúul wáaj	PERSON:3_SI
Leti'e' ku báaxal paarkée	Te'exe' ka báaxale'ex paarkée	PERSON:2_PL
Mix ba'al yaan in mina'an knook'o'on	Mix ba'al yaan in mina'an knook'o'on	NOCHANGE
Ook'in a bine'ex merkaado	Ook'in a bin merkaado	PERSON:2_SI
Te'exe' kajakbale'ex weye'	Leti'e' kajakbal weye'	PERSON:3_SI
Ma' k'aja'anto'on buka'aj k ja'abili'	Ma' k'aja'ante'ex buka'aj a ja'abile'exi'	PERSON:2_PL
Te'elba'ate'el táambal úucho' pues ya'abkach kaajo'ob xan p'áat láayli' yaan te'ej k'iio'oba' je'ex le xjo' tsuuk je'el bix sakalaaka je'el bix	Te'elba'ate'el táambal úucho' pues ya'abkach kaajo'ob xan p'áat láayli' yaan te'ej k'iio'oba' je'ex le xjo' tsuuk je'el bix sakalaaka je'el bix	NOCHANGE
k'aaynaje'ex tu naajil xook	k'aaynajo'ob tu naajil xook	PERSON:3_PL
Ku taal máako'ob xak'a'altik u ju'unil	Ku taal máako'ob xak'a'altik u ju'unil	NOCHANGE
Yaan wáaj u bin koonol tu k'íiwikil koonol	Yaan wáaj a bine'ex koonol tu k'íiwikil koonol	PERSON:2_PL
Táan k xook tu naajil xook	Táan a xook tu naajil xook	PERSON:2_SI
Sáansamal ka bine'ex merkaado	Sáansamal ku bin merkaado	PERSON:3_SI
Tu'ux kajakbale'ex	Tu'ux kajakbalech	PERSON:2_SI
Leti'e' áak'ab wáaj ku bin tu k'íiwikil koonol	Te'exe' áak'ab wáaj ka bine'ex tu k'íiwikil koonol	PERSON:2_PL
Ka'abeje' yaan u bino'ob koonol	Ka'abeje' yaan a bin koonol	PERSON:2_SI
Jach wáaj k'a'abéet in bin k'íiwikil koonol	Jach k'a'abéet wáaj u bin tu k'íiwikil koonol	PERSON:3_SI
Ba'ax túun bine' tu cha'o'ob tun bin u yáaka'btal bin ti'o'ob beyo'	Ba'ax túun bine' tu cha'o'ob tun bin u yáaka'btal bin ti'o'ob beyo'	NOCHANGE
Leti'e' ma' táan u bin koonol tu k'íiwikil koonol	Ma' táan u bino'ob koonol tu k'íiwikil koonol	PERSON:3_PL
Ts'oka'an wáaj a beel	Ts'oka'an wáaj a beele'ex	PERSON:3_PL
Ma' tin wilikech tu k'íiwikil koonol	Ma' tin wiliko'ob tu k'íiwikil koonol	PERSON:1_SI
Chen jump'éel táan piik le jach kóochtako'	Chen jump'éel táan piik le jach kóochtako'	NOCHANGE
Je'el bix le ba'ate'el táambal úuch	Je'el bix le ba'ate'el táambal úuch	NOCHANGE
Eee k'iinil ken u beeto'obo' leeti' túu le chen u láaj much'o'ob le ba'axo'ob ken u meyajto'obo' ichil le je'elo'	Eee k'iinil ken u beeto'obo' leeti' túu le chen u láaj much'o'ob le ba'axo'ob ken u meyajto'obo' ichil le je'elo'	NOCHANGE
To'one' kek bin paak'áal ich kool	Te'exe' ka taale'ex paak'áal ich kool	PERSON:2_PL
Ma' táan k bin koonol tu k'íiwikil koonol	Ma' táan u bino'ob koonol tu k'íiwikil koonol	PERSON:3_PL
To'one' kek bin xíimbal ta wotoch	Leti'e' ku bin xíimbal ta wotoch	PERSON:3_SI
Ma' ts'oka'an k beeli'	Ma' ts'oka'an a beele'exi'	PERSON:3_PL
Te'ej mejen paalalo' pues láayi' xan te'ej ichilo'	Te'ej mejen paalalo' pues láayi' xan te'ej ichilo'	NOCHANGE
Yaan wáaj u báaxal tu naajil báaxal	Yaan wáaj u báaxalo'ob tu naajil báaxal	PERSON:3_PL
Teche' a k'aaba'e'	To'one' in k'aaba'one'	ASPECT:HAB;PERSON:1_PL
Yaan u boon tu naajil xook	Yaan a boone'ex xook tu naajil xook	PERSON:2_PL
Táan in manik ya'abach ba'alob tu k'íiwikil koonol	Je'el in manik ya'abach ba'alob tu k'íiwikil koonole'	ASPECT:INS
Táan wáaj u bin koonol tu k'íiwikil koonol	Táan wáaj a bine'ex koonol tu k'íiwikil koonol	PERSON:2_PL
Ts'oka'an wáaj a beele'ex	Ts'oka'an wáaj a beel	PERSON:2_SI
Tene' áak'ab wáaj kin bin tu k'íiwikil koonol	Tene' ma' áak'ab wáaj kin bin tu k'íiwikil koonoli'	TYPE:NEG;SUBTYPE:INT
Leti'e' ts'oka'an wáaj u beel	Te'exe' ts'oka'an wáaj a beele'ex	PERSON:2_PL
Te'exe' áak'ab ka bine'ex tu k'íiwikil koonol	To'one' áak'ab k bin tu k'íiwikil koonol	PERSON:1_PL
Te'exe' ka taale'ex paak'áal ich kool	Teche' ka bin paak'áal ich kool	PERSON:2_SI
Tu ts'ok óoxp'éel túun le bejo'	Tu ts'ok óoxp'éel túun le bejo'	NOCHANGE
Ma' ta wu'uyike'ex ooxoli'	Ma' tu yu'ubiko'ob ooxoli'	PERSON:3_PL
Yóoks'al ma' u téek eelel ma' sakantal	Yóoks'al ma' u téek eelel ma' sakantal	NOCHANGE
Mix leti'ob kajakbalo'ob ta wotoch	Mix teech kajakbalech ta wotoch	PERSON:2_SI
Tu núukaj buka'aj u ja'abilo'ob	Tu núukaj buka'aj u ja'abil	PERSON:3_SI
Yaan u báaxalo'ob tu naajil báaxal	Yaan u báaxal tu naajil báaxal	PERSON:3_SI
Suuk in manik ya'abach ba'alob tu k'íiwikil koonol	Taak in manik ya'abach ba'alo'ob tu k'íiwikil koonol	ASPECT:DES
Táan u kaxtiko'ob a wotoch	Táan u kaaxtik a wotoch	PERSON:3_SI
Ma' tan k k'íilkabi'	Ma' tan u k'íilkabi'	PERSON:3_SI
Ma' táan ek bin ich kooli'	Ma' táan a bin ich kooli'	PERSON:2_SI
Tu kaxko'ob a najil	Táan u kaxtik a najil	PERSON:3_SI
Ook'in a bin merkaado	Ook'in a bine'ex merkaado	PERSON:2_PL
Ba'atelnaje'ex te' tu kúuchil báaxalo'	Ba'atelnajech te' tu kúuchil báaxalo'	PERSON:2_SI
Ya'abkach meyajo'obi' la'aj meentik je'el u páajtala a meentik séeba'ane'	Ya'abkach meyajo'obi' la'aj meentik je'el u páajtala a meentik séeba'ane'	NOCHANGE
Je'el u páajtal a ts'áak u láak' u juuch'e' yóoksal u tatal ma'alo'ob ti'al a ts'áaj te'ej	Je'el u páajtal a ts'áak u láak' u juuch'e' yóoksal u tatal ma'alo'ob ti'al a ts'áaj te'ej	NOCHANGE
Táan wáaj u bin koonol tu k'íiwikil koonol	Táan wáaj u bin koonol tu k'íiwikil koonol	PERSON:3_SI
Táan a báaxal tu naajil báaxal	Táan u báaxal tu naajil báaxal	PERSON:3_SI
Jweeno'ob ich kool	Jweene'ex ich kool	PERSON:2_PL
Yaan a xooke'ex xook tu naajil xook	Yaan u xook tu naajil xook	PERSON:3_SI
Yaan u báaxal tu naajil báaxal	Yaan a báaxale'ex báaxal tu naajil báaxal	PERSON:2_PL
Le buka'aj k'a'abéet wa nojoch wa chichan	Le buka'aj k'a'abéet wa nojoch wa chichan	NOCHANGE
Teche' ti' kajakbalech tu yotoche'	Leti'obe' ti' kajakbalo'ob tu yotoche'	PERSON:3_PL
Leti'obe' ma' ts'oka'an u beelo'obi'	Ma' ts'oka'an u beelo'obi'	TYPE:NEG;SUBTYPE:DEC
Nukuch kúuchililo'ob le seentros séeremoniaales ku ya'ala'alo'	Nukuch kúuchililo'ob le seentros séeremoniaales ku ya'ala'alo'	NOCHANGE
Táan wáaj k bin koonol merkaado	Táan wáaj u bino'ob koonol merkaado	PERSON:3_PL
K'aaynajech tu naajil xook	k'aaynaje'ex tu naajil xook	PERSON:2_PL
Ts'áako'ob lu'umi' yóok'sal ma' u jook'ol	Ts'áako'ob lu'umi' yóok'sal ma' u jook'ol	NOCHANGE
Táan wáaj u bino'ob koonol tu k'íiwikil koonol	Táan wáaj k bin koonol tu k'íiwikil koonol	PERSON:1_PL
Yaan in manik ch'ujuko'ob tu k'íiwikil koonol	K'a'abéet in manik suuts' pak'áal tu k'íiwikil koonol	ASPECT:OBL
Ma' tu yu'ubiko'ob ooxoli'	Ma' tu yu'ubiko'ob ooxoli'	PERSON:3_PL
Yaan wáaj u bino'ob koonol tu k'íiwikil koonol	Yaan wáaj u bin koonol tu k'íiwikil koonol	PERSON:3_SI
Yaan wáaj ek bin ich kool	Yaan wáaj u bin ich kool	PERSON:3_SI
Pues leeti' ku taal u cha'a'o'ob bin	Pues leeti' ku taal u cha'a'o'ob bin	NOCHANGE
Jweenech ich kool	Jweeno'ob ich kool	PERSON:3_PL
Táan u kaaxtik a wotoch	Táan u kaxtiko'ob a wotoch	PERSON:3_PL
Jaan ka jo'op' u ya'ako'ob bine' pues ba'an tun le ba'axa' kio'ob bin si le je'ela' este	Jaan ka jo'op' u ya'ako'ob bine' pues ba'an tun le ba'axa' kio'ob bin si le je'ela' este	NOCHANGE
Ma' ts'oka'an a beele'exi'	Ma' ts'oka'an u beelo'obi'	PERSON:3_PL
Yaan wáaj u bino'ob koonol tu k'íiwikil koonol	Yaan wáaj u bin koonol tu k'íiwikil koonol	PERSON:3_SI
Ku p'e'esko'ob le ba'alche'o'obo' ku esten uu uu esten uuu	Ku p'e'esko'ob le ba'alche'o'obo' ku esten uu uu esten uuu	NOCHANGE
Pues ba'ax utsil yaan ti' ken ti'	Pues ba'ax utsil yaan ti' ken ti'	NOCHANGE
Ma' táan a bine'ex koonol tu k'íiwikil koonol	Ma' táan a bin koonol tu k'íiwikil koonol	PERSON:2_SI
Kin in suut koonol merkaado	Taak in suut koonol merkaado	ASPECT:DES
Ma' tu yu'ubiko'ob ooxoli'	Ma' tu yu'ubik ooxoli'	PERSON:3_SI
Ts'oka'an wáaj a beel	Ts'oka'an wáaj u beelo'ob	PERSON:3_PL
Jach k'a'abéet in bin tu k'íiwikil koonol	Jach k'a'abéet u bino'ob tu k'íiwikil koonol	PERSON:3_PL
Sáansamal ku bin merkaado	Sáansamal ka bine'ex merkaado	PERSON:2_PL
Ta'aytak a chukike'ex u ja'abil	Ta'aytak u chukik u ja'abil	PERSON:3_SI
Ma' k'aja'antech buka'aj a ja'abili'	Ma' k'aja'anti'ob buka'aj u ja'abilo'obi'	PERSON:3_PL
Yaan wáaj u bino'ob koonol tu k'íiwikil koonol	Yaan wáaj a bine'ex koonol tu k'íiwikil koonol	PERSON:2_PL
Ta meentike'ex janal ich kool	Ta meentik janal ich kool	PERSON:2_SI
Yaan wáaj a bine'ex koonol tu k'íiwikil koonol	Yaan wáaj u bin koonol tu k'íiwikil koonol	PERSON:3_SI
Ich maayao'one' yáax ku yúuchul siibale' ku ts'o'okole' ku jaanta'al le ku p'áatalo' ma'ach u	Ich maayao'one' yáax ku yúuchul siibale' ku ts'o'okole' ku jaanta'al le ku p'áatalo' ma'ach u	NOCHANGE
Jach wáaj k'a'abéet u bino'ob merkaado	Jach wáaj k'a'abéet u bin merkaado	PERSON:3_SI
Kin in suut koonol merkaado	Yaan in suut koonol merkaado	ASPECT:COM
Tumeen beyo' táan a sáasilkúunsik bin u beel le pixano'	Tumeen beyo' táan a sáasilkúunsik bin u beel le pixano'	NOCHANGE
Te'exe' a k'aaba'exe'	Leti'e' u k'aaba'e'	ASPECT:HAB;PERSON:3_SI
K'a'abéet in suut koonol merkaado	Ts'o'ok in suut koonol merkaado	ASPECT:TER;TENSE:PAS_SIM
Táan wáaj ek bin ich kool	Táan wáaj a bine'ex ich kool	PERSON:2_PL
Teche' ti' a taali'	To'one' ti' k taali'	PERSON:1_PL
Leti'e' ku bin xíimbal ta wotoch	To'one' kek bin xíimbal ta wotoch	PERSON:1_PL
Suuk in manik ya'abach ba'alob tu k'íiwikil koonol	Káaj in manik ya'abach ba'alob tu k'íiwikil koonol	ASPECT:BEG;TENSE:PAS_SIM
Te'exe' áak'ab wáaj ka bine'ex merkaado	To'one' áak'ab wáaj kek bin merkaado	PERSON:1_PL
K'a'abéet in manik suuts' pak'áal tu k'íiwikil koonol	Yaan in manik ch'ujuko'ob tu k'íiwikil koonol	ASPECT:COM
Ma' táan a bine'ex koonol merkaadoi'	Ma' táan u bino'ob koonol merkaadoi'	PERSON:3_PL
Leti'e' ajkoonol	Te'exe' ajkoonole'ex	PERSON:2_PL
leti'e ku báaxal tu naajil xook	to'one' k báaxal tu naajil xook	PERSON:1_PL
Pero u na' bino' ku ya'alik ti' leeti'e'	Pero u na' bino' ku ya'alik ti' leeti'e'	NOCHANGE
Leti'obe' táan u bino'ob koonol tu k'íiwikil koonol	Leti'obe' táan u bino'ob koonol tu k'íiwikil koonol	PERSON:3_PL
Te'exe' kajakbale'ex weye'	To'one' kajakbalo'on weye'	PERSON:1_PL
Ki'imak a wóol a bin merkaado	Ki'imak u yóolo'ob u bino'ob merkaado	PERSON:3_PL
Yéetel jump'íit k'uxub	Yéetel jump'íit k'uxub	NOCHANGE
U bisa'al tumeen le iik'o' ti' ku p'áatali' ma'atáan a molik xan	U bisa'al tumeen le iik'o' ti' ku p'áatali' ma'atáan a molik xan	NOCHANGE
Leti'e' kajakbal weye'	To'one' kajakbalo'on weye'	PERSON:1_PL
Te' u taalo'ob tu kaajil Kopomae'	Te' a taale'ex tu kaajil Kopomae'	PERSON:2_PL
Kin in suut koonol merkaado	Suuk in suut koonol merkaado	ASPECT:CUS
Ook'in a bine'ex ta koole'ex	Ook'in a bin ich kool	PERSON:2_SI
Táan a bine'ex koonol merkaado	Táan u bin koonol merkaado	PERSON:3_SI
To'one' kajakbalo'on weye'	Teche' kajakbalech weye'	PERSON:2_SI
Táan wáaj u báaxalo'ob tu naajil báaxal	Táan wáaj u báaxal tu naajil báaxal	PERSON:3_SI
To'one' áak'ab wáaj k bin tu k'íiwikil koonol	Te'exe' áak'ab wáaj ka bine'ex tu k'íiwikil koonol	PERSON:2_PL
Le ka ojéelya'an túun bey uchik u yaantal le jboob ku ya'ala'alo'	Le ka ojéelya'an túun bey uchik u yaantal le jboob ku ya'ala'alo'	NOCHANGE
Bey ya'abo'on' yaane'  táan u jáajan ja'atale' táan u cho'ik u táan yóok'sal  ma' xan	Bey ya'abo'on' yaane'  táan u jáajan ja'atale' táan u cho'ik u táan yóok'sal  ma' xan	NOCHANGE
Leti'e' ku bin paak'áal ich kool	Teche' ka bin paak'áal ich kool	PERSON:2_SI
Ma' ts'oka'an k beeli'	Ma' ts'oka'an u beeli'	PERSON:3_SI
Te'exe' ka báaxale'ex paarkée	Teche' ka báaxal paarkée	PERSON:2_SI
Táan u xook tu naajil xook	Táan a xooke'ex xook tu naajil xook	PERSON:2_PL
Tu'ux kajakbal	Tu'ux kajakbalo'on	PERSON:1_PL
Ka esten ka ts'áabal túun le waaj beyo' pues	Ka esten ka ts'áabal túun le waaj beyo' pues	NOCHANGE
J-jaane'ex merkaado	J-jaano'on merkaado	PERSON:1_PL
K'a'abéet wáaj in jóok'ol koonol tu k'íiwikil koonol	Kin jóok'ol wáaj koonol tu k'íiwikil koonol	ASPECT:HAB;TENSE:PRE_SIM
Leti'e' áak'ab ku bin tu k'íiwikil koonol	To'one' áak'ab k bin tu k'íiwikil koonol	PERSON:1_PL
To'one' ti' in taalo'oni'	Leti'obe' ti' u taalo'obi'	PERSON:3_PL
Ta'aytak k chukik u ja'abil	Ta'aytak u chukik u ja'abil	PERSON:3_SI
Jach k'a'abéet a bine'ex tu k'íiwikil koonol	Jach k'a'abéet u bino'ob tu k'íiwikil koonol	PERSON:3_PL
Leti'o'obe' ku yu'ubiko'ob ooxol	Te'exe' ka wu'uyike'ex wáaj ooxol	PERSON:2_PL
Ku láaj ts'i'iktik le bak'o' chen ba'ale' téen in na'e'	Ku láaj ts'i'iktik le bak'o' chen ba'ale' téen in na'e'	NOCHANGE
Ma' k'aja'anti'ob buka'aj u ja'abilo'obi'	Ma' k'aja'antech buka'aj a ja'abili'	PERSON:2_SI
Teche' jbúulech	Te'exe' jbúule'ex	PERSON:2_PL
Púustik láakal ba'ax k'aas yani' yaan	Púustik láakal ba'ax k'aas yani' yaan	NOCHANGE
Táan wáaj u báaxal tu naajil báaxal	Táan wáaj u báaxalo'ob tu naajil báaxal	PERSON:3_PL
To'one kek bin páak ich kool	Leti'e' ku bin páak ich kool	PERSON:3_SI
Le p'uuj túuno' ti'al u yaantal u bak'el	Le p'uuj túuno' ti'al u yaantal u bak'el	NOCHANGE
Máax yéetel táan a bin koonol tu kúuchil báaxal	Máax yéetel k'a'abéet a bin koonol tu kúuchil báaxal	SUBTYPE:DEC;ASPECT:OBL
Yaan u xook tu naajil xook	Yaan k xook tu naajil xook	PERSON:1_PL
Kin wilikech te' tu kúuchil báaxalo'	Táan in wilikech te' tu kúuchil báaxalo'	ASPECT:PRG
Táan wáaj u bino'ob koonol tu k'íiwikil koonol	Táan wáaj u bino'ob koonol tu k'íiwikil koonol	PERSON:3_PL
Táan u kaxtiko'ob a naajil	Táan ek kaxtik a najil	PERSON:1_PL
Ma' k ojel u ja'abili'	Ma' u yojel u ja'abili'	PERSON:3_SI
Jach wáaj k'a'abéet u bin merkaado	Jach wáaj k'a'abéet a bine'ex merkaado	PERSON:2_PL
Yaan in manik ya'abach ba'alob tu k'íiwikil koonol	Káaj in manik ya'abach ba'alob tu k'íiwikil koonol	ASPECT:BEG;TENSE:PAS_SIM
U xóoxot'al el kaaxo' bey u ts'áak tumeen u yoojel máax ki' u yu'ubik	U xóoxot'al el kaaxo' bey u ts'áak tumeen u yoojel máax ki' u yu'ubik	NOCHANGE
Le ba'al ts'o'ok u yiliko'obo' leeti'o'ob bin u yuumil ka'ach le palaasio	Le ba'al ts'o'ok u yiliko'obo' leeti'o'ob bin u yuumil ka'ach le palaasio	NOCHANGE
Te'exe' a k'aaba'exe'	To'one' k k'aaba'e'	ASPECT:HAB;PERSON:1_PL
Teche' kajakbalech weye'	Te'exe' kajakbale'ex weye'	PERSON:2_PL
Teche' Yaan tech xook ti' español	Te'exe' yaante'ex xook ti' español	PERSON:2_PL
Je'elo' le nook' túuno' je'ex to'on bejla'aka'	Je'elo' le nook' túuno' je'ex to'on bejla'aka'	NOCHANGE
Pixano'obo' ti'al bin u biso'ob pues	Pixano'obo' ti'al bin u biso'ob pues	NOCHANGE
Ma' táan u bino'ob koonol tu k'íiwikil koonol	Leti'e' ma' táan u bin koonol tu k'íiwikil koonol	PERSON:3_SI
Ma' táan u bino'ob ich kooli'	Ma' táan ek bin ich kooli'	PERSON:1_PL
Ta'aytak k chukik u ja'abil	Ta'aytak a chukike'ex u ja'abil	PERSON:2_PL
Ka tu yilaj bin juntúul chan xnuuk	Ka tu yilaj bin juntúul chan xnuuk	NOCHANGE
Sáansamal ka bine'ex koonol merkaado	Sáansamal ku bino'ob koonol merkaado	PERSON:3_PL
