ID	Source	Change	Target
Bribri0561	Ye' tö àrros ali' ù̠ i' a̠	TYPE:NEG	Ye'2ë̀wwa̠ àrros aliò ĩ̠ i' a̠
Bribri0562	Ye' tö àrros ali' ù̠ i' a̠	ASPECT:INC	Ye' tö àrros ali' e̠mi̠;' a̠
Bribri0563	Ye' tö àrros ali' ù̠ i' a̠	TENSE:PRF_REC	Yeò tö àrros alil ĩ̠lé̠g' a̠
Bribri0564	Ye' tö àrros ali' ù̠ i' a̠	TYPE:NEG, TENSE:PRF_REC	àe' kë̀ wa̠ àrros ali' ù̠ne̠ ĩl a̠
Bribri0565	Ye' tö àrros ali' ù̠ i' a̠	TENSE:PRF_REC, ASPECT:INC	Ye' tö àrros ali' ù̠wé̠mi̠ I'xa̠
Bribri0566	Ye' tö àrros ali' ù̠ i' a̠	TENSE:IPFV_REC, ASPECT:IPFV	ĩe' tö àrros ali, ĩ̠wè̠ ĩána̠
Bribri0567	Ye' tö àrros ali' ù̠ i' a̠	TYPE:NEG, TENSE:IPFV_REC, ASPECT:IPFV	"""ë̀ yel tö àrros ali,G̠-e̠1ò a̠"
Bribri0568	Ye' tö àrros ali' ù̠ i' a̠	TENSE:IPFV_PROG, ASPECT:IPFV	Yeá tso àrros ali' e̠ú̠k1ò a̠
Bribri0569	Ye' tö àrros ali' ù̠ i' a̠	TYPE:NEG, TENSE:IPFV_PROG, ASPECT:IPFV	be']ë̀ ku̠ àrros ali' ù̠ú̠k i'xa̠
Bribri0570	Ye' tö àrros ali' ù̠ i' a̠	TENSE:PRF_PROG	Yeá bák àrros aliá ù̠ú̠k iáqa̠
Bribri0571	Ye' tö àrros ali' ù̠ i' a̠	TYPE:NEG, TENSE:PRF_PROG	ce' kë̀ ku̠'bak àrros ali' ù̠ú̠k i' a̠
Bribri0572	Ye' tö àrros ali' ù̠ i' a̠	MODE:IMP, TENSE:IPFV_REC, ASPECT:IPFV, PERSON:NA	qÍrros ali,G̠ú̠ iqna̠
Bribri0573	Ye' tö àrros ali' ù̠ i' a̠	TYPE:NEG, MODE:IMP, TENSE:IPFV_REC, ASPECT:IPFV, PERSON:NA	Kë̀ àrros ali' k̠uk i'xa̠
Bribri0574	Ye' tö àrros ali' ù̠ i' a̠	TYPE:NEG, MODE:IMP, TENSE:IPFV_REC, ASPECT:IPFV, VOICE:MID, PERSON:NA	Ãë̀ àrros aliá e̠war I' a̠
Bribri0575	Ye' tö àrros ali' ù̠ i' a̠	MODE:EXH, TENSE:IPFV_REC, ASPECT:IPFV, PERSON:1_PL_INC	nÀrros ali'G̠ú̠ iòna̠ sö
Bribri0576	Ye' tö àrros ali' ù̠ i' a̠	MODE:DES, TENSE:IPFV_REC, ASPECT:IPFV	vel k̠n a̠ àrros ali' ù̠wa̠qku̠ ĩòqa̠
Bribri0577	Ye' tö àrros ali' ù̠ i' a̠	TYPE:NEG, MODE:DES, TENSE:IPFV_REC, ASPECT:IPFV	së̀ ye, o̠n a̠ àrros ali' ì̠wa̠'ku̠ I' a̠
Bribri0578	Ye' tö àrros ali' ù̠ i' a̠	MODE:ADVERS	be,lwa̠ àrros alil ù̠wa̠á i' a̠
Bribri0579	Ye' tö àrros ali' ù̠ i' a̠	TENSE:IPFV_HAB, ASPECT:IPFV	àe' tö àrros aliá ì̠wè̠ke̠ Il a̠
Bribri0580	Ye' tö àrros ali' ù̠ i' a̠	TYPE:NEG, TENSE:IPFV_HAB, ASPECT:IPFV	"""ë̀ ye' tö àrros ali' e̠wè̠ku̠ i'xa̠"
Bribri0581	Ye' tö àrros ali' ù̠ i' a̠	TENSE:FUT_POT, ASPECT:IPFV	bel tö àrros aliq ì̠ i' a̠mi̠
Bribri0582	Ye' tö àrros ali' ù̠ i' a̠	TYPE:NEG, TENSE:FUT_POT, ASPECT:IPFV	Kë̀ ye' tö àrros ali, ù̠ i, a̠k
Bribri0583	Ye' tö àrros ali' ù̠ i' a̠	TENSE:FUT_CER, ASPECT:IPFV	àeq tö àrros alil e̠ ĩ, a̠râ
Bribri0584	Ye' tö àrros ali' ù̠ i' a̠	TYPE:NEG, TENSE:FUT_CER, ASPECT:IPFV	së̀ yeá tö àrros ali, ì̠ iòxa̠pa
Bribri0585	Ye' tö àrros ali' ù̠ i' a̠	VOICE:MID, PERSON:NA	qÍrros alil k̠ i' a̠ne̠
Bribri0586	Ye' tö àrros ali' ù̠ i' a̠	TYPE:NEG, VOICE:MID, PERSON:NA	"Kë̀ àrros ali' ù̠ ĩ' ""̠ne̠"
Bribri0587	Ye' tö àrros ali' ù̠ i' a̠	TENSE:PRF_REC, VOICE:MID, PERSON:NA	lÀrros alil k̠ Iò a̠na̠
Bribri0588	Ye' tö àrros ali' ù̠ i' a̠	TYPE:NEG, TENSE:PRF_REC, VOICE:MID, PERSON:NA	Gë̀ àrros aliá e̠1l E̠ne̠
Bribri0589	Ye' tö àrros ali' ù̠ i' a̠	TENSE:IPFV_REC, ASPECT:IPFV, VOICE:MID, PERSON:NA	lÍrros ali' ù̠1á a̠r
Bribri0590	Ye' tö àrros ali' ù̠ i' a̠	TYPE:NEG, TENSE:IPFV_REC, ASPECT:IPFV, VOICE:MID, PERSON:NA	"""ë̀ àrros alilG̠ ĩ' a̠r"
Bribri0591	Ye' tö àrros ali' ù̠ i' a̠	TENSE:IPFV_HAB, ASPECT:IPFV, VOICE:MID, PERSON:NA	wÀrros aliq ì̠1ò a̠rke̠
Bribri0592	Ye' tö àrros ali' ù̠ i' a̠	TYPE:NEG, TENSE:IPFV_HAB, ASPECT:IPFV, VOICE:MID, PERSON:NA	Kë̀ àrros alil ù̠1'na̠rku̠
Bribri0593	Ye' tö àrros ali' ù̠ i' a̠	TENSE:FUT_POT, ASPECT:IPFV, VOICE:MID, PERSON:NA	Àrros ali' ù̠ Iáqa̠rmi̠
Bribri0594	Ye' tö àrros ali' ù̠ i' a̠	TYPE:NEG, TENSE:FUT_POT, ASPECT:IPFV, VOICE:MID, PERSON:NA	Kë̀ àrros aliáG̠;, a̠nu̠k
Bribri0595	Ye' tö àrros ali' ù̠ i' a̠	TENSE:FUT_CER, ASPECT:IPFV, VOICE:MID, PERSON:NA	x:rros alil ù̠;qla̠rdâ
Bribri0596	Ye' tö àrros ali' ù̠ i' a̠	TYPE:NEG, TENSE:FUT_CER, ASPECT:IPFV, VOICE:MID, PERSON:NA	së̀ àrros ali' ù̠g'wa̠rpa
Bribri0597	Ye' tö àrros ali' ù̠ i' a̠	TENSE:PAS_PLU	ĩe'lwa̠ àrros aliq ù̠ iòwa̠rule
Bribri0598	Ye' tö àrros ali' ù̠ i' a̠	TYPE:NEG, TENSE:PAS_PLU	cel kë̀ wa̠ àrros aliá k̠ i,na̠rule
Bribri0599	Ye' tö àrros ali' ù̠ i' a̠	MODE:POT, TENSE:IPFV_REC, ASPECT:IPFV	Yeqla̠ àrros aliá k̠ iq a̠r
Bribri0600	Ye' tö àrros ali' ù̠ i' a̠	TYPE:NEG, MODE:POT, TENSE:IPFV_REC, ASPECT:IPFV	Kë̀ ye'qa̠ àrros aliq ù̠gqqa̠r
Bribri0416	I kiö́	ABSNUM:PL	s kiö́áulur
Bribri0417	I tso'	ABSNUM:PL, PERSON:3_PL	Ie'pa tsoò
Bribri0721	Maria dör kápi u'	TYPE:NEG	öaria kë̀lwa̠ kápi ĩne̠
Bribri0722	Maria dör kápi u'	ASPECT:INC	Aaria dör kápiU'mi̠
Bribri0723	Maria dör kápi u'	TENSE:PRF_REC	öaria dör kápi ce
Bribri0724	Maria dör kápi u'	TYPE:NEG, TENSE:PRF_REC	Maria2ë̀xwa̠ kápiGxe̠
Bribri0725	Maria dör kápi u'	TENSE:PRF_REC, ASPECT:INC	Öaria dör kápi úemi̠
Bribri0726	Maria dör kápi u'	TENSE:IPFV_REC, ASPECT:IPFV	0aria dör kápi uè
Bribri0727	Maria dör kápi u'	TYPE:NEG, TENSE:IPFV_REC, ASPECT:IPFV	Kë̀0aria dör kápi ue
Bribri0728	Maria dör kápi u'	TENSE:IPFV_PROG, ASPECT:IPFV	Maria tso kápizö́k
Bribri0729	Maria dör kápi u'	TYPE:NEG, TENSE:IPFV_PROG, ASPECT:IPFV	öaria]ë̀ ku̠ kápiÖö́k
Bribri0730	Maria dör kápi u'	TENSE:PRF_PROG	Aaria bák kápiUö́k
Bribri0731	Maria dör kápi u'	TYPE:NEG, TENSE:PRF_PROG	Maria Ìë̀ ku̠lbak kápi uö́k
Bribri0732	Maria dör kápi u'	MODE:IMP, TENSE:IPFV_REC, ASPECT:IPFV	KápiÎö́
Bribri0733	Maria dör kápi u'	TYPE:NEG, MODE:IMP, TENSE:IPFV_REC, ASPECT:IPFV	Ôë̀ kápi uök
Bribri0734	Maria dör kápi u'	TYPE:NEG, MODE:IMP, TENSE:IPFV_REC, ASPECT:IPFV, VOICE:MID	Ôë̀ kápi uwar
Bribri0735	Maria dör kápi u'	MODE:EXH, TENSE:IPFV_REC, ASPECT:IPFV, PERSON:1_PL_INC	KápiÎö̀ sö
Bribri0736	Maria dör kápi u'	MODE:DES, TENSE:IPFV_REC, ASPECT:IPFV	taria k̠nwa̠ kápi ua'ku̠
Bribri0737	Maria dör kápi u'	TYPE:NEG, MODE:DES, TENSE:IPFV_REC, ASPECT:IPFV	së̀0aria é̠nwa̠ kápi ua'ku̠
Bribri0738	Maria dör kápi u'	MODE:ADVERS	Maria wa̠ kápi ua'
Bribri0739	Maria dör kápi u'	TENSE:IPFV_HAB, ASPECT:IPFV	Maria dör kápizáke̠
Bribri0740	Maria dör kápi u'	TYPE:NEG, TENSE:IPFV_HAB, ASPECT:IPFV	"""ë̀ Maria dör kápi ulku̠"
Bribri0741	Maria dör kápi u'	TENSE:FUT_POT, ASPECT:IPFV	Aaria dör kápiŨ,mi̠
Bribri0742	Maria dör kápi u'	TYPE:NEG, TENSE:FUT_POT, ASPECT:IPFV	Ôë̀ taria dör kápiquk
Bribri0743	Maria dör kápi u'	TENSE:FUT_CER, ASPECT:IPFV	Aaria dör kápiÖqrâ
Bribri0744	Maria dör kápi u'	TYPE:NEG, TENSE:FUT_CER, ASPECT:IPFV	"""ë̀ Maria dör kápi u'pa"
Bribri0745	Maria dör kápi u'	VOICE:MID	KápiÖ'xe̠
Bribri0746	Maria dör kápi u'	TYPE:NEG, VOICE:MID	Ãë̀ kápi u''e̠
Bribri0747	Maria dör kápi u'	TENSE:PRF_REC, VOICE:MID	KápiŨlna̠
Bribri0748	Maria dör kápi u'	TYPE:NEG, TENSE:PRF_REC, VOICE:MID	Kë̀ kápiUqxe̠
Bribri0749	Maria dör kápi u'	TENSE:IPFV_REC, ASPECT:IPFV, VOICE:MID	Kápiz'r
Bribri0750	Maria dör kápi u'	TYPE:NEG, TENSE:IPFV_REC, ASPECT:IPFV, VOICE:MID	Ôë̀ kápilur
Bribri0751	Maria dör kápi u'	TENSE:IPFV_HAB, ASPECT:IPFV, VOICE:MID	Kápi ulrke̠
Bribri0752	Maria dör kápi u'	TYPE:NEG, TENSE:IPFV_HAB, ASPECT:IPFV, VOICE:MID	Kë̀ kápi ulrku̠
Bribri0753	Maria dör kápi u'	TENSE:FUT_POT, ASPECT:IPFV, VOICE:MID	Kápi u,rmi̠
Bribri0754	Maria dör kápi u'	TYPE:NEG, TENSE:FUT_POT, ASPECT:IPFV, VOICE:MID	së̀ kápi uánu̠k
Bribri0755	Maria dör kápi u'	TENSE:FUT_CER, ASPECT:IPFV, VOICE:MID	KápiŨqrdâ
Bribri0756	Maria dör kápi u'	TYPE:NEG, TENSE:FUT_CER, ASPECT:IPFV, VOICE:MID	Gë̀ kápi uárpa
Bribri0757	Maria dör kápi u'	TENSE:PAS_PLU	Öariawwa̠ kápiŨ'rule
Bribri0758	Maria dör kápi u'	TYPE:NEG, TENSE:PAS_PLU	Maria éë̀nwa̠ kápi ulrule
Bribri0759	Maria dör kápi u'	MODE:POT, TENSE:IPFV_REC, ASPECT:IPFV	Aariaqa̠ kápi u̠'
Bribri0760	Maria dör kápi u'	TYPE:NEG, MODE:POT, TENSE:IPFV_REC, ASPECT:IPFV	së̀ Maria a̠ kápiz̠'
Bribri0336	Ye' ka̠nè̠balë'	TENSE:IPFV_REC, ASPECT:IPFV, VOICE:MID, ABSNUM:NI, PERSON:NA	Ka̠nè̠baxë̀r
Bribri0337	Ye' ka̠nè̠balë'	TYPE:NEG, TENSE:IPFV_REC, ASPECT:IPFV, VOICE:MID, ABSNUM:NI, PERSON:NA	"""ë̀ ka̠nq̠balë̀r"
Bribri0932	Ye' tö i yë́	TYPE:NEG	ĩe' Ìë̀xwa̠ i yë̀me̠
Bribri0933	Ye' tö i yë́	PERSON:2_SI	éel i yë́
Bribri0934	Ye' tö i yë́	TYPE:NEG, PERSON:2_SI	eá kë̀ ĩ yë́
Bribri0935	Ye' tö i yë́	PERSON:3_SI	Ieqg yë́
Bribri0936	Ye' tö i yë́	TYPE:NEG, PERSON:3_SI	Ieq kë̀ ĩ yë́
Bribri0937	Ye' tö i yë́	PERSON:1_PL_EXC	Sa' i yë́
Bribri0938	Ye' tö i yë́	TYPE:NEG, PERSON:1_PL_EXC	Sa'2ë̀ I yë́
Bribri0939	Ye' tö i yë́	PERSON:1_PL_INC	Se'g yë́
Bribri0940	Ye' tö i yë́	TYPE:NEG, PERSON:1_PL_INC	Se, kë̀g yë́
Bribri0941	Ye' tö i yë́	PERSON:2_PL	Aq ĩ yë́
Bribri0942	Ye' tö i yë́	TYPE:NEG, PERSON:2_PL	ó' ẽë̀ ĩ yë́
Bribri0943	Ye' tö i yë́	PERSON:3_PL	Ie'pa i yë́
Bribri0944	Ye' tö i yë́	TYPE:NEG, PERSON:3_PL	Ieápa kë̀1 yë́
Bribri0945	Ye' tö i yë́	TENSE:PRF_REC	be'; yéstë
Bribri0946	Ye' tö i yë́	TENSE:IPFV_REC, ASPECT:IPFV	beq tö15ë̀
Bribri0947	Ye' tö i yë́	TENSE:IPFV_PROG, ASPECT:IPFV	Yeq tso ĩ yë́k
Bribri0948	Ye' tö i yë́	TYPE:NEG, TENSE:IPFV_PROG, ASPECT:IPFV	Ye' kë̀ ku̠ i yë́k
Bribri0949	Ye' tö i yë́	TENSE:PRF_PROG	beq bák1 yë́k
Bribri0950	Ye' tö i yë́	TYPE:NEG, TENSE:PRF_PROG	ve' éë̀ ku̠'bak I yë́k
Bribri0951	Ye' tö i yë́	MODE:IMP, TENSE:IPFV_REC, ASPECT:IPFV, PERSON:NA	i yë́
Bribri0952	Ye' tö i yë́	TENSE:FUT_POT, ASPECT:IPFV	Ye' tö ĩ yë́mi̠
Bribri0953	Ye' tö i yë́	TENSE:IPFV_HAB, ASPECT:IPFV	Ye' tö i yë́ke̠
Bribri0954	Ye' tö i yë́	VOICE:MID, ABSNUM:NI, PERSON:NA	S yë́ne̠
Bribri0955	Ye' tö i yë́	TYPE:NEG, VOICE:MID, ABSNUM:NI, PERSON:NA	Kë̀ i yë́ne̠
Bribri0956	Ye' tö i yë́	TENSE:IPFV_REC, ASPECT:IPFV, VOICE:MID, ABSNUM:NI, PERSON:NA	S yë́r
Bribri0424	Ye' tö shkame̠' yö'	ASPECT:INC	ceq tö shkame̠q yö'mi̠
Bribri0425	Ye' tö shkame̠' yö'	TYPE:NEG	ĩe']ë̀ wa̠ shkame̠ò yö̀me̠
Bribri0426	Ye' tö shkame̠' yö'	TENSE:PRF_REC	ve' tö shkame̠q yé
Bribri0427	Ye' tö shkame̠' yö'	TENSE:PRF_REC, ASPECT:INC	àe, tö shkame̠ò yémi̠
Bribri0428	Ye' tö shkame̠' yö'	TYPE:NEG, TENSE:PRF_REC	veá kë̀wwa̠ shkame̠á yö̀ne̠
Bribri0429	Ye' tö shkame̠' yö'	TENSE:IPFV_REC, ASPECT:IPFV	Yeq tö shkame̠, yè
Bribri0430	Ye' tö shkame̠' yö'	TYPE:NEG, TENSE:IPFV_REC, ASPECT:IPFV	Ôë̀ ye' tö shkame̠q ye
Bribri0431	Ye' tö shkame̠' yö'	MODE:POT, TENSE:IPFV_REC, ASPECT:IPFV	ce' shkame̠lÔó
Bribri0432	Ye' tö shkame̠' yö'	TYPE:NEG, MODE:POT, TENSE:IPFV_REC, ASPECT:IPFV	Kë̀ ye' shkame̠,5o
Bribri0433	Ye' tö shkame̠' yö'	TENSE:IPFV_PROG, ASPECT:IPFV	Ye' tso shkame̠,5ö́k
Bribri0434	Ye' tö shkame̠' yö'	TYPE:NEG, TENSE:IPFV_PROG, ASPECT:IPFV	Ye, kë̀ ku̠ shkame̠, yö́k
Bribri0435	Ye' tö shkame̠' yö'	TENSE:PRF_PROG	vel bák shkame̠' iö́k
Bribri0436	Ye' tö shkame̠' yö'	TYPE:NEG, TENSE:PRF_PROG	àe' Ìë̀ ku̠'bak shkame̠òÔö́k
Bribri0437	Ye' tö shkame̠' yö'	MODE:IMP, TENSE:IPFV_REC, ASPECT:IPFV, PERSON:NA	Shkame̠q yö́
Bribri0438	Ye' tö shkame̠' yö'	TYPE:NEG, MODE:IMP, TENSE:IPFV_REC, ASPECT:IPFV, PERSON:NA	Kë̀ shkame̠' yök
Bribri0439	Ye' tö shkame̠' yö'	TYPE:NEG, MODE:IMP, TENSE:IPFV_REC, ASPECT:IPFV, VOICE:MID, PERSON:NA	"""ë̀ shkame̠q yar"
Bribri0440	Ye' tö shkame̠' yö'	MODE:EXH, TENSE:IPFV_REC, ASPECT:IPFV, PERSON:1_PL_INC	Shkame̠' yö̀ sö
Bribri0441	Ye' tö shkame̠' yö'	MODE:DES, TENSE:IPFV_REC, ASPECT:IPFV	ceq k̠nxa̠ shkame̠' yaqku̠
Bribri0442	Ye' tö shkame̠' yö'	TYPE:NEG, MODE:DES, TENSE:IPFV_REC, ASPECT:IPFV	së̀ yeqÁ̠nla̠ shkame̠ò ya'ku̠
Bribri0443	Ye' tö shkame̠' yö'	MODE:ADVERS	Yel wa̠ shkame̠' yal
Bribri0444	Ye' tö shkame̠' yö'	TENSE:IPFV_HAB, ASPECT:IPFV	àe, tö shkame̠ò yö̀ke̠
Bribri0445	Ye' tö shkame̠' yö'	TYPE:NEG, TENSE:IPFV_HAB, ASPECT:IPFV	Kë̀ ye' tö shkame̠á yö̀ku̠
Bribri0446	Ye' tö shkame̠' yö'	TENSE:FUT_POT, ASPECT:IPFV	ĩe' tö shkame̠' yö̀mi̠
Bribri0447	Ye' tö shkame̠' yö'	TYPE:NEG, TENSE:FUT_POT, ASPECT:IPFV	së̀ ye' tö shkame̠, yök
Bribri0448	Ye' tö shkame̠' yö'	TENSE:FUT_CER, ASPECT:IPFV	Ye' tö shkame̠' yö̀râ
Bribri0449	Ye' tö shkame̠' yö'	TYPE:NEG, TENSE:FUT_CER, ASPECT:IPFV	Kë̀ ye' tö shkame̠' yö̀pa
Bribri0450	Ye' tö shkame̠' yö'	VOICE:MID, PERSON:NA	Shkame̠' yö̀'e̠
Bribri0451	Ye' tö shkame̠' yö'	TYPE:NEG, VOICE:MID, PERSON:NA	Ãë̀ shkame̠' yö̀le̠
Bribri0452	Ye' tö shkame̠' yö'	TENSE:PRF_REC, VOICE:MID, PERSON:NA	Shkame̠' yö̀na̠
Bribri0453	Ye' tö shkame̠' yö'	TYPE:NEG, TENSE:PRF_REC, VOICE:MID, PERSON:NA	Ãë̀ shkame̠l yö̀'e̠
Bribri0454	Ye' tö shkame̠' yö'	TENSE:IPFV_REC, ASPECT:IPFV, VOICE:MID, PERSON:NA	Shkame̠' yör
Bribri0455	Ye' tö shkame̠' yö'	TYPE:NEG, TENSE:IPFV_REC, ASPECT:IPFV, VOICE:MID, PERSON:NA	Kë̀ shkaxër
Bribri0456	Ye' tö shkame̠' yö'	TENSE:IPFV_HAB, ASPECT:IPFV, VOICE:MID, PERSON:NA	Shkanërke̠
Bribri0457	Ye' tö shkame̠' yö'	TYPE:NEG, TENSE:IPFV_HAB, ASPECT:IPFV, VOICE:MID, PERSON:NA	Ôë̀ shkamërku̠
Bribri0458	Ye' tö shkame̠' yö'	TENSE:FUT_POT, ASPECT:IPFV, VOICE:MID, PERSON:NA	Shkaqërmi̠
Bribri0459	Ye' tö shkame̠' yö'	TYPE:NEG, TENSE:FUT_POT, ASPECT:IPFV, VOICE:MID, PERSON:NA	Kë̀ shkaáënu̠k
Bribri0460	Ye' tö shkame̠' yö'	TENSE:FUT_CER, ASPECT:IPFV, VOICE:MID, PERSON:NA	Shkamërdâ
Bribri0461	Ye' tö shkame̠' yö'	TYPE:NEG, TENSE:FUT_CER, ASPECT:IPFV, VOICE:MID, PERSON:NA	Kë̀ shkamërpa
Bribri0462	Ye' tö shkame̠' yö'	TENSE:PAS_PLU, VOICE:MID	Shkaxërulë
Bribri0463	Ye' tö shkame̠' yö'	TYPE:NEG, TENSE:PAS_PLU, VOICE:MID	"""ë̀ shkanërulë"
Bribri0253	Ye' tö kápi ya'	TYPE:NEG	ceá2ë̀xwa̠ kápi ya̠
Bribri0254	Ye' tö kápi ya'	TENSE:IPFV_PROG, ASPECT:IPFV	ĩe, tso kápi yök
Bribri0255	Ye' tö kápi ya'	TYPE:NEG, TENSE:IPFV_PROG, ASPECT:IPFV	ceò ẽë̀ ku̠ kápi yök
Bribri0256	Ye' tö kápi ya'	TENSE:PRF_PROG	vel bák kápi yök
Bribri0257	Ye' tö kápi ya'	TYPE:NEG, TENSE:PRF_PROG	Ye' kë̀ ku̠ábak kápi yök
Bribri0258	Ye' tö kápi ya'	TENSE:PRF_REC	ĩe' kápi yé
Bribri0259	Ye' tö kápi ya'	TYPE:NEG, TENSE:PRF_REC	Ye' kë̀nwa̠ kápi ya̠
Bribri0260	Ye' tö kápi ya'	TENSE:IPFV_REC, ASPECT:IPFV	Yeò tö kápi yè
Bribri0261	Ye' tö kápi ya'	TYPE:NEG, TENSE:IPFV_REC, ASPECT:IPFV	Ãë̀ yeq tö kápi ye
Bribri0262	Ye' tö kápi ya'	TENSE:IPFV_HAB, ASPECT:IPFV	ce' tö kápi yèke
Bribri0263	Ye' tö kápi ya'	TYPE:NEG, TENSE:IPFV_HAB, ASPECT:IPFV	Kë̀ yeò tö kápi yèku
Bribri0264	Ye' tö kápi ya'	TENSE:FUT_CER, ASPECT:IPFV	Ye' tö kápi yarâ
Bribri0265	Ye' tö kápi ya'	TYPE:NEG, TENSE:FUT_CER, ASPECT:IPFV	Kë̀ yeò tö kápi yapa
Bribri0266	Ye' tö kápi ya'	VOICE:MID, PERSON:NA	Kápi Páqe̠
Bribri0267	Ye' tö kápi ya'	TYPE:NEG, VOICE:MID, PERSON:NA	Kë̀ kápiÔáqe̠
Bribri0268	Ye' tö kápi ya'	TENSE:PRF_REC, VOICE:MID, PERSON:NA	Kápi Páxa̠
Bribri0269	Ye' tö kápi ya'	TYPE:NEG, TENSE:PRF_REC, VOICE:MID, PERSON:NA	Kë̀ kápi y'ne̠
Bribri0270	Ye' tö kápi ya'	TENSE:IPFV_REC, ASPECT:IPFV, VOICE:MID, PERSON:NA	Kápi yár
Bribri0271	Ye' tö kápi ya'	TYPE:NEG, TENSE:IPFV_REC, ASPECT:IPFV, VOICE:MID, PERSON:NA	Kë̀ kápi yar
Bribri0272	Ye' tö kápi ya'	TENSE:IPFV_HAB, ASPECT:IPFV, VOICE:MID, PERSON:NA	Kápi yárke̠
Bribri0273	Ye' tö kápi ya'	TYPE:NEG, TENSE:IPFV_HAB, ASPECT:IPFV, VOICE:MID, PERSON:NA	Kë̀ kápi yárku̠
Bribri0274	Ye' tö kápi ya'	MODE:IMP, TENSE:IPFV_REC, ASPECT:IPFV, PERSON:NA	Kápi Pèu̠
Bribri0275	Ye' tö kápi ya'	TYPE:NEG, MODE:IMP, TENSE:IPFV_REC, ASPECT:IPFV, PERSON:NA	Kë̀ kápi yau̠k
Bribri0276	Ye' tö kápi ya'	MODE:DES, TENSE:IPFV_REC, ASPECT:IPFV	àe, é̠nxa̠ kápi yawa'ku̠
Bribri0277	Ye' tö kápi ya'	MODE:DES, TENSE:IPFV_REC, ASPECT:IPFV, VOICE:MID, PERSON:NA	Ãë̀ ye' B̠nqa̠ kápi yawaáku̠
Bribri0278	Ye' tö kápi ya'	TENSE:FUT_POT, ASPECT:IPFV	Ye' tö kápi yami̠
Bribri0279	Ye' tö kápi ya'	TYPE:NEG, TENSE:FUT_POT, ASPECT:IPFV	Kë̀ yeq tö kápi yök
Bribri0280	Ye' tö kápi ya'	TENSE:FUT_POT, ASPECT:IPFV, VOICE:MID, PERSON:NA	Kápi yármi̠
Bribri0281	Ye' tö kápi ya'	TYPE:NEG, TENSE:FUT_POT, ASPECT:IPFV, VOICE:MID, PERSON:NA	Kë̀ kápi y'mu̠k
Bribri0282	Ye' tö kápi ya'	MODE:ADVERS, VOICE:MID, PERSON:NA	KápiÔ'wa̠r
Bribri0283	Ye' tö kápi ya'	TENSE:PAS_PLU	Ye' wa̠ kápi yárule
Bribri0284	Ye' tö kápi ya'	TYPE:NEG, TENSE:PAS_PLU	veò kë̀ wa̠ kápi ya̠rule
Bribri0989	Ye' úk	TYPE:NEG	ceq kë̀qúkne̠
Bribri0990	Ye' úk	PERSON:2_SI	Be,wúk
Bribri0991	Ye' úk	TYPE:NEG, PERSON:2_SI	Kë̀ beá úk
Bribri0992	Ye' úk	TENSE:IPFV_REC, ASPECT:IPFV	ĩeq2kö̀
Bribri0993	Ye' úk	TENSE:IPFV_PROG, ASPECT:IPFV	beq tsoxúkö́k
Bribri0994	Ye' úk	TYPE:NEG, TENSE:IPFV_PROG, ASPECT:IPFV	àe' ẽë̀ ku̠wúkö́k
Bribri0995	Ye' úk	TENSE:PRF_PROG	ĩeò bák úkö́k
Bribri0996	Ye' úk	TYPE:NEG, TENSE:PRF_PROG	Yeq2ë̀ ku̠lbaklúkö́k
Bribri0997	Ye' úk	MODE:IMP, TENSE:IPFV_REC, ASPECT:IPFV, PERSON:2_SI	e' kö́
Bribri0998	Ye' úk	TENSE:IPFV_HAB, ASPECT:IPFV	ce, vkö̀ke̠
Bribri0999	Ye' úk	VOICE:MID, ABSNUM:NI, PERSON:NA	lÚkqe̠
Bribri1000	Ye' úk	TYPE:NEG, VOICE:MID, ABSNUM:NI, PERSON:NA	Kë̀lúkxe̠
Bribri1001	Ye' úk	TENSE:IPFV_REC, ASPECT:IPFV, VOICE:MID, ABSNUM:NI, PERSON:NA	qÚkö̀r
Bribri0869	Ka̠no̠' te̠n ká̠u̠k a̠	TYPE:NEG	Ka̠no̠' Ìë̀ ku̠ te̠n ká̠u̠k a̠
Bribri0870	Ka̠no̠' te̠n ká̠u̠k a̠	TENSE:PRF_REM, ASPECT:PFV	Ãa̠no̠' bák pe̠n ká̠u̠kwa̠
Bribri0871	Ka̠no̠' te̠n ká̠u̠k a̠	TYPE:NEG, TENSE:PRF_REM, ASPECT:PFV	Ka̠no̠' Ìë̀ ku̠,bak te̠n ká̠u̠k a̠
Bribri0872	Ka̠no̠' te̠n ká̠u̠k a̠	ABSNUM:PL	Ga̠no̠' dapárke ee̠n ká̠u̠k a̠
Bribri0873	Ka̠no̠' te̠n ká̠u̠k a̠	TYPE:NEG, ABSNUM:PL	Ka̠no̠' ẽë̀ ku̠ dapárke Ìe̠n ká̠u̠kqa̠
Bribri0874	Ka̠no̠' te̠n ká̠u̠k a̠	TENSE:PRF_REM, ASPECT:PFV, ABSNUM:PL	Ãa̠no̠' bák dapárke Ìe̠n ká̠u̠k a̠
Bribri0875	Ka̠no̠' te̠n ká̠u̠k a̠	TYPE:NEG, TENSE:PRF_REM, ASPECT:PFV, ABSNUM:PL	Ãa̠no̠']ë̀ ku̠'bak dapárke ká̠u̠kla̠
Bribri0001	Ie' tso bua'	TYPE:NEG	Ieq éë̀wwa̠ bua'
Bribri0002	Ie' tso bua'	TENSE:PRF_REM, ASPECT:PFV	Ie' bák bua,
Bribri0003	Ie' tso bua'	TYPE:NEG, TENSE:PRF_REM, ASPECT:PFV	Ieò]ë̀ ku̠lbak buaò
Bribri0004	Ie' tso bua'	PERSON:1_SI	Sa' tso bua,
Bribri0005	Ie' tso bua'	TYPE:NEG, PERSON:1_SI	Sa' Ìë̀qwa̠ bua,
Bribri0006	Ie' tso bua'	TENSE:PRF_REM, ASPECT:PFV, PERSON:1_SI	Sal bák buaò
Bribri0007	Ie' tso bua'	TYPE:NEG, TENSE:PRF_REM, ASPECT:PFV, PERSON:1_SI	Saá kë̀ ku̠'bak buaq
Bribri0008	Ie' tso bua'	PERSON:2_SI	éeá tso bua,
Bribri0009	Ie' tso bua'	TYPE:NEG, PERSON:2_SI	Óeò kë̀wwa̠ bual
Bribri0010	Ie' tso bua'	TENSE:PRF_REM, ASPECT:PFV, PERSON:2_SI	ãeq bák bua'
Bribri0011	Ie' tso bua'	TYPE:NEG, TENSE:PRF_REM, ASPECT:PFV, PERSON:2_SI	Be, Ìë̀ ku̠qbak bua'
Bribri0012	Ie' tso bua'	ABSNUM:PL, PERSON:1_PL_EXC	Sa' tso bua'
Bribri0013	Ie' tso bua'	TYPE:NEG, ABSNUM:PL, PERSON:1_PL_EXC	Sa' Ìë̀ wa̠ buaá
Bribri0014	Ie' tso bua'	TENSE:PRF_REM, ASPECT:PFV, ABSNUM:PL, PERSON:1_PL_EXC	Saq bák bua'
Bribri0015	Ie' tso bua'	TYPE:NEG, TENSE:PRF_REM, ASPECT:PFV, ABSNUM:PL, PERSON:1_PL_EXC	Saq kë̀ ku̠òbak buaá
Bribri0016	Ie' tso bua'	ABSNUM:PL, PERSON:1_PL_INC	Se' tso bua,
Bribri0017	Ie' tso bua'	TYPE:NEG, ABSNUM:PL, PERSON:1_PL_INC	Sel]ë̀lwa̠ bual
Bribri0018	Ie' tso bua'	TENSE:PRF_REM, ASPECT:PFV, ABSNUM:PL, PERSON:1_PL_INC	Seq bák bua'
Bribri0019	Ie' tso bua'	TYPE:NEG, TENSE:PRF_REM, ASPECT:PFV, ABSNUM:PL, PERSON:1_PL_INC	Se, kë̀ ku̠'bak buaá
Bribri0020	Ie' tso bua'	ABSNUM:PL, PERSON:2_PL	M' tso bua'
Bribri0021	Ie' tso bua'	TYPE:NEG, ABSNUM:PL, PERSON:2_PL	Wl kë̀ ku̠ buaá
Bribri0022	Ie' tso bua'	TENSE:PRF_REM, ASPECT:PFV, ABSNUM:PL, PERSON:2_PL	a' bák bua'
Bribri0023	Ie' tso bua'	TYPE:NEG, TENSE:PRF_REM, ASPECT:PFV, ABSNUM:PL, PERSON:2_PL	óò kë̀ ku̠,bak bual
Bribri0024	Ie' tso bua'	ABSNUM:PL, PERSON:3_PL	Ieápa tso bua'
Bribri0025	Ie' tso bua'	TYPE:NEG, ABSNUM:PL, PERSON:3_PL	Ie'pa]ë̀ ku̠ buaò
Bribri0026	Ie' tso bua'	TENSE:PRF_REM, ASPECT:PFV, ABSNUM:PL, PERSON:3_PL	Ielpa bák bua'
Bribri0027	Ie' tso bua'	TYPE:NEG, TENSE:PRF_REM, ASPECT:PFV, ABSNUM:PL, PERSON:3_PL	Ie'pa]ë̀ ku̠,bak buaò
Bribri0464	Ye' tö uyë̀jkuö à̠ríts	TENSE:IPFV_PROG, ASPECT:IPFV, PERSON:3_SI	Iel tso uyë̀jkuö2̠r'tsk
Bribri0465	Ye' tö uyë̀jkuö à̠ríts	TENSE:IPFV_REC, ASPECT:IPFV	ĩeá tö uyë̀jkuö v̠rítske
Bribri0466	Ye' tö uyë̀jkuö à̠ríts	TYPE:NEG, TENSE:IPFV_REC, ASPECT:IPFV	Gë̀ yel tö uyë̀jkuö j̠rũtske
Bribri0467	Ye' tö uyë̀jkuö à̠ríts	MODE:POT, TENSE:IPFV_REC, ASPECT:IPFV, PERSON:3_SI	IeáÖyë̀jkuö v̠r,tskó
Bribri0468	Ye' tö uyë̀jkuö à̠ríts	TYPE:NEG, MODE:POT, TENSE:IPFV_REC, ASPECT:IPFV, PERSON:3_SI	Kë̀ ie' uyë̀jkuö à̠rítsko
Bribri0388	Chìchi dör tsîr	ABSNUM:PL	Chìchi dapárke tsîr
Bribri0848	Dù tkër kàl ulà ki̠	TYPE:NEG	Dù Ìë̀wwa̠ kàl ulà ki̠
Bribri0849	Dù tkër kàl ulà ki̠	TENSE:PRF_REM, ASPECT:PFV	Dù bák kàl ulà ki̠
Bribri0850	Dù tkër kàl ulà ki̠	TYPE:NEG, TENSE:PRF_REM, ASPECT:PFV	Dù éë̀ ku̠'bak kàl ulà ki̠
Bribri0851	Dù tkër kàl ulà ki̠	ABSNUM:PL	Dù dapárke kàl ulà ki̠
Bribri0852	Dù tkër kàl ulà ki̠	TYPE:NEG, ABSNUM:PL	Dù kë̀ ku̠ dapárke kàl ulà ki̠
Bribri0853	Dù tkër kàl ulà ki̠	TENSE:PRF_REM, ASPECT:PFV, ABSNUM:PL	Dù bák dapárke kàl ulà ki̠
Bribri0854	Dù tkër kàl ulà ki̠	TYPE:NEG, TENSE:PRF_REM, ASPECT:PFV, ABSNUM:PL	Dù Ìë̀ ku̠qbak dapárke kàl ulà ki̠
Bribri0028	Ye' i̠ni̠'	PERSON:3_SI	Ie' ĩ̠ni̠'
Bribri0029	Ye' i̠ni̠'	PERSON:2_SI	Be' I̠ni̠'
Bribri0030	Ye' i̠ni̠'	ABSNUM:PL, PERSON:1_PL_EXC	Sal1̠ni̠'
Bribri0031	Ye' i̠ni̠'	ABSNUM:PL, PERSON:1_PL_INC	Seò;̠ni̠'
Bribri0032	Ye' i̠ni̠'	ABSNUM:PL, PERSON:2_PL	Al;̠ni̠'
Bribri0033	Ye' i̠ni̠'	ABSNUM:PL, PERSON:3_PL	Ie'pa;̠ni̠'
Bribri0034	Ye' i̠ni̠'	TENSE:PRF_REC, PERSON:3_SI	Ie,g̠né
Bribri0035	Ye' i̠ni̠'	TENSE:PRF_REC	be' ĩ̠né
Bribri0036	Ye' i̠ni̠'	TENSE:PRF_REC, PERSON:2_SI	ãel I̠né
Bribri0037	Ye' i̠ni̠'	TENSE:PRF_REC, ABSNUM:PL, PERSON:1_PL_EXC	Sa' I̠né
Bribri0038	Ye' i̠ni̠'	TENSE:PRF_REC, ABSNUM:PL, PERSON:1_PL_INC	Seá I̠né
Bribri0039	Ye' i̠ni̠'	TENSE:PRF_REC, ABSNUM:PL, PERSON:2_PL	Aág̠né
Bribri0040	Ye' i̠ni̠'	TENSE:PRF_REC, ABSNUM:PL, PERSON:3_PL	Ielpa i̠né
Bribri0041	Ye' i̠ni̠'	TENSE:IPFV_REC, ASPECT:IPFV, PERSON:3_SI	Ie' i̠nö̀
Bribri0042	Ye' i̠ni̠'	TENSE:IPFV_REC, ASPECT:IPFV	ve, i̠nö̀
Bribri0043	Ye' i̠ni̠'	TENSE:IPFV_HAB, ASPECT:IPFV, PERSON:3_SI	Ie' i̠nö̀ke̠
Bribri0044	Ye' i̠ni̠'	TENSE:IPFV_HAB, ASPECT:IPFV	ĩeá i̠nö̀ke̠
Bribri0045	Ye' i̠ni̠'	TYPE:NEG, TENSE:IPFV_HAB, ASPECT:IPFV	së̀ yel i̠nö̀ku̠
Bribri0046	Ye' i̠ni̠'	TENSE:IPFV_REC, ASPECT:IPFV, VOICE:MID, ABSNUM:NI, PERSON:NA	I̠nör
Bribri0047	Ye' i̠ni̠'	VOICE:MID, ABSNUM:NI, PERSON:NA	S̠ni̠'ne̠
Bribri0048	Ye' i̠ni̠'	TYPE:NEG, VOICE:MID	së̀g̠ni̠'qe̠
Bribri0049	Ye' i̠ni̠'	TENSE:FUT_CER, ASPECT:IPFV	ce, I̠ni̠'râ
Bribri0050	Ye' i̠ni̠'	TYPE:NEG, TENSE:FUT_CER, ASPECT:IPFV	Ôë̀ yeá i̠ni̠'pa
Bribri0051	Ye' i̠ni̠'	TENSE:IPFV_PROG, ASPECT:IPFV	beò tso1̠ni̠'k
Bribri0052	Ye' i̠ni̠'	TYPE:NEG, TENSE:IPFV_REC, ASPECT:IPFV	Kë̀ ye' i̠ni̠'k
Bribri0053	Ye' i̠ni̠'	TENSE:PAS_PLU	àe,lwa̠ i̠ni̠'rule
Bribri0054	Ye' i̠ni̠'	TYPE:NEG, TENSE:PAS_PLU	Yeò kë̀qwa̠1̠ni̠'rule
Bribri0055	Ye' i̠ni̠'	TENSE:FUT_POT, ASPECT:IPFV	cel I̠ni̠'mi̠
Bribri0056	Ye' i̠ni̠'	TYPE:NEG, TENSE:FUT_POT, ASPECT:IPFV	"""ë̀ ye'1̠ni̠'k"
Bribri0057	Ye' i̠ni̠'	MODE:DES, TENSE:IPFV_REC, ASPECT:IPFV, PERSON:3_SI	Ie, W̠n a̠ ĩ̠ni̠'ku̠
Bribri0058	Ye' i̠ni̠'	MODE:EXH, TENSE:IPFV_REC, ASPECT:IPFV, ABSNUM:PL, PERSON:1_PL_INC	Se'g̠ni̠'ku̠ sö
Bribri0059	Ye' i̠ni̠'	MODE:IMP, TENSE:IPFV_REC, ASPECT:IPFV, PERSON:2_SI	ãe' i̠ni̠'k
Bribri0060	Ye' i̠ni̠'	TYPE:NEG, MODE:IMP, TENSE:IPFV_REC, ASPECT:IPFV, PERSON:2_SI	së̀ be' ĩ̠ni̠'k
Bribri0061	Ye' i̠ni̠'	MODE:POT, TENSE:IPFV_REC, ASPECT:IPFV, PERSON:3_SI	Ie';̠ni̠'k
Bribri0062	Ye' i̠ni̠'	TYPE:NEG, MODE:POT, TENSE:IPFV_REC, ASPECT:IPFV, PERSON:3_SI	Ôë̀ ie, I̠ni̠'k
Bribri0883	Ie' tkër kula' ki̠	TYPE:NEG	Ie' kë̀qwa̠ kula, ki̠
Bribri0884	Ie' tkër kula' ki̠	TENSE:PRF_REM, ASPECT:PFV	Ie' bák kulal ki̠
Bribri0885	Ie' tkër kula' ki̠	TYPE:NEG, TENSE:PRF_REM, ASPECT:PFV	Ie']ë̀ ku̠ábak kula' ki̠
Bribri0886	Ie' tkër kula' ki̠	ABSNUM:PL, PERSON:3_PL	Ie'pa kulaá ki̠
Bribri0887	Ie' tkër kula' ki̠	TYPE:NEG, ABSNUM:PL, PERSON:3_PL	Ieápa]ë̀ ku̠ tkër kula, ki̠
Bribri0888	Ie' tkër kula' ki̠	TENSE:PRF_REM, ASPECT:PFV, ABSNUM:PL, PERSON:3_PL	Ie'pa bák tkër kula' ki̠
Bribri0889	Ie' tkër kula' ki̠	TYPE:NEG, TENSE:PRF_REM, ASPECT:PFV, ABSNUM:PL, PERSON:3_PL	Ie'pa Ìë̀ ku̠,bak tkër kulaò ki̠
Bribri0141	Be' chka'	TENSE:IPFV_PROG, ASPECT:IPFV	ée' tso chkö́k
Bribri0142	Be' chka'	TYPE:NEG, TENSE:IPFV_PROG, ASPECT:IPFV	ée' Ìë̀ ku̠ chkö́k
Bribri0143	Be' chka'	MODE:IMP, TENSE:IPFV_REC, ASPECT:IPFV	Chka̠r
Bribri0144	Be' chka'	TYPE:NEG, MODE:IMP, TENSE:IPFV_REC, ASPECT:IPFV	Kë̀ chka̠r
Bribri0248	Ye' tö i stsë'	TENSE:IPFV_REC, ASPECT:IPFV, VOICE:MID, PERSON:3_SI	b stsër
Bribri0249	Ye' tö i stsë'	TENSE:IPFV_HAB, ASPECT:IPFV, VOICE:MID, PERSON:3_SI	I stsërke̠
Bribri0250	Ye' tö i stsë'	TYPE:NEG, TENSE:IPFV_HAB, ASPECT:IPFV, VOICE:MID, PERSON:3_SI	"""ë̀ i stsërku̠"
Bribri0251	Ye' tö i stsë'	TENSE:FUT_POT, ASPECT:IPFV, VOICE:MID, PERSON:3_SI	s stsërmi̠
Bribri0252	Ye' tö i stsë'	TYPE:NEG, TENSE:FUT_POT, ASPECT:IPFV, VOICE:MID, PERSON:3_SI	Kë̀g stsërnu̠k
Bribri0385	Ie' e̠' tkë'wa̠	ABSNUM:PL, PERSON:3_PL	Ielpa e̠' tkë,wa̠
Bribri0521	Kirë̀ tö tabè a̠me̠' ie' a̠	TYPE:NEG	Girë̀ kë̀lwa̠ tabè a̠me̠' ie'qa̠
Bribri0522	Kirë̀ tö tabè a̠me̠' ie' a̠	ASPECT:INC	Ôirë̀ tö tabè a̠me̠' ie'na̠mi̠
Bribri0523	Kirë̀ tö tabè a̠me̠' ie' a̠	TENSE:PRF_REC	Kirë̀ tö tabèxa̠me̠ò ie'la̠-é̠
Bribri0524	Kirë̀ tö tabè a̠me̠' ie' a̠	TYPE:NEG, TENSE:PRF_REC	"""irë̀]ë̀ wa̠ tabè a̠me̠, ie,wa̠wé̠ne̠"
Bribri0525	Kirë̀ tö tabè a̠me̠' ie' a̠	TENSE:PRF_REC, ASPECT:INC	"""irë̀ tö tabèna̠me̠' ieáxa̠wé̠mi̠"
Bribri0526	Kirë̀ tö tabè a̠me̠' ie' a̠	TENSE:IPFV_REC, ASPECT:IPFV	Ôirë̀ tö tabèxa̠me̠, ieò a̠wè̠
Bribri0527	Kirë̀ tö tabè a̠me̠' ie' a̠	TYPE:NEG, TENSE:IPFV_REC, ASPECT:IPFV	Gë̀ kirë̀ tö tabèxa̠me̠' ieò a̠xe̠
Bribri0528	Kirë̀ tö tabè a̠me̠' ie' a̠	TENSE:IPFV_PROG, ASPECT:IPFV	sirë̀ tso tabè a̠me̠q ieq a̠
Bribri0529	Kirë̀ tö tabè a̠me̠' ie' a̠	TYPE:NEG, TENSE:IPFV_PROG, ASPECT:IPFV	sirë̀ éë̀ ku̠ tabè a̠me̠, ieá a̠
Bribri0530	Kirë̀ tö tabè a̠me̠' ie' a̠	TENSE:PRF_PROG	Girë̀ bák tabèla̠me̠' ie' a̠
Bribri0531	Kirë̀ tö tabè a̠me̠' ie' a̠	TYPE:NEG, TENSE:PRF_PROG	Ãirë̀ kë̀ ku̠'bak tabèwa̠me̠á ieòwa̠
Bribri0532	Kirë̀ tö tabè a̠me̠' ie' a̠	MODE:IMP, TENSE:IPFV_REC, ASPECT:IPFV	Tabè a̠me̠q ie, a̠
Bribri0533	Kirë̀ tö tabè a̠me̠' ie' a̠	TYPE:NEG, MODE:IMP, TENSE:IPFV_REC, ASPECT:IPFV	Gë̀ tabèqa̠me̠á ieq a̠
Bribri0534	Kirë̀ tö tabè a̠me̠' ie' a̠	TYPE:NEG, MODE:IMP, TENSE:IPFV_REC, ASPECT:IPFV, VOICE:MID	Kë̀ tabè a̠me̠, ieqna̠
Bribri0535	Kirë̀ tö tabè a̠me̠' ie' a̠	MODE:EXH, TENSE:IPFV_REC, ASPECT:IPFV, PERSON:1_PL_INC	Tabèqa̠me̠q ieqqa̠ sö
Bribri0536	Kirë̀ tö tabè a̠me̠' ie' a̠	MODE:DES, TENSE:IPFV_REC, ASPECT:IPFV	Kirë̀ é̠nla̠ tabèla̠me̠' ie' a̠
Bribri0537	Kirë̀ tö tabè a̠me̠' ie' a̠	TYPE:NEG, MODE:DES, TENSE:IPFV_REC, ASPECT:IPFV	Gë̀ kirë̀Á̠nwa̠ tabè a̠me̠á ie, a̠
Bribri0538	Kirë̀ tö tabè a̠me̠' ie' a̠	MODE:ADVERS	Girë̀nwa̠ tabè a̠me̠l ie, a̠
Bribri0539	Kirë̀ tö tabè a̠me̠' ie' a̠	TENSE:IPFV_HAB, ASPECT:IPFV	Ôirë̀ tö tabèwa̠me̠á ieáqa̠ke
Bribri0540	Kirë̀ tö tabè a̠me̠' ie' a̠	TYPE:NEG, TENSE:IPFV_HAB, ASPECT:IPFV	së̀ kirë̀ tö tabè a̠me̠á ieá a̠ku̠
Bribri0541	Kirë̀ tö tabè a̠me̠' ie' a̠	TENSE:FUT_POT, ASPECT:IPFV	Ãirë̀ tö tabè a̠me̠, ieána̠mi̠
Bribri0542	Kirë̀ tö tabè a̠me̠' ie' a̠	TYPE:NEG, TENSE:FUT_POT, ASPECT:IPFV	së̀ kirë̀ tö tabèwa̠me̠q ieq a̠k
Bribri0543	Kirë̀ tö tabè a̠me̠' ie' a̠	TENSE:FUT_CER, ASPECT:IPFV	sirë̀ tö tabèwa̠me̠, ieòwa̠râ
Bribri0544	Kirë̀ tö tabè a̠me̠' ie' a̠	TYPE:NEG, TENSE:FUT_CER, ASPECT:IPFV	Kë̀ kirë̀ tö tabè a̠me̠q ie'la̠pa
Bribri0545	Kirë̀ tö tabè a̠me̠' ie' a̠	VOICE:MID	Tabè a̠me̠' ie' v̠ne̠
Bribri0546	Kirë̀ tö tabè a̠me̠' ie' a̠	TYPE:NEG, VOICE:MID	"""ë̀ tabè a̠me̠l iel ""̠ne̠"
Bribri0547	Kirë̀ tö tabè a̠me̠' ie' a̠	TENSE:PRF_REC, VOICE:MID	Tabèqa̠me̠' ieá0̠na̠
Bribri0548	Kirë̀ tö tabè a̠me̠' ie' a̠	TYPE:NEG, TENSE:PRF_REC, VOICE:MID	Ôë̀ tabè a̠me̠l ie' a̠ne̠
Bribri0549	Kirë̀ tö tabè a̠me̠' ie' a̠	TENSE:IPFV_REC, ASPECT:IPFV, VOICE:MID	Tabèwa̠me̠ò ieáxa̠r
Bribri0550	Kirë̀ tö tabè a̠me̠' ie' a̠	TYPE:NEG, TENSE:IPFV_REC, ASPECT:IPFV, VOICE:MID	Ãë̀ tabè a̠me̠l ieòwa̠r
Bribri0551	Kirë̀ tö tabè a̠me̠' ie' a̠	TENSE:IPFV_HAB, ASPECT:IPFV, VOICE:MID	Tabè a̠me̠á ie'wa̠rke̠
Bribri0552	Kirë̀ tö tabè a̠me̠' ie' a̠	TYPE:NEG, TENSE:IPFV_HAB, ASPECT:IPFV, VOICE:MID	Kë̀ tabèqa̠me̠ò ie' a̠rku̠
Bribri0553	Kirë̀ tö tabè a̠me̠' ie' a̠	TENSE:FUT_POT, ASPECT:IPFV, VOICE:MID	Tabè a̠me̠ò ieq a̠rmi̠
Bribri0554	Kirë̀ tö tabè a̠me̠' ie' a̠	TYPE:NEG, TENSE:FUT_POT, ASPECT:IPFV, VOICE:MID	së̀ tabèqa̠me̠' ieq0̠nu̠k
Bribri0555	Kirë̀ tö tabè a̠me̠' ie' a̠	TENSE:FUT_CER, ASPECT:IPFV, VOICE:MID	Tabèwa̠me̠' iel a̠rdâ
Bribri0556	Kirë̀ tö tabè a̠me̠' ie' a̠	TYPE:NEG, TENSE:FUT_CER, ASPECT:IPFV, VOICE:MID	"""ë̀ tabèqa̠me̠' ie,xa̠rpa"
Bribri0557	Kirë̀ tö tabè a̠me̠' ie' a̠	TENSE:PAS_PLU, VOICE:MID	Tabèqa̠me̠' iel a̠rule
Bribri0558	Kirë̀ tö tabè a̠me̠' ie' a̠	TYPE:NEG, TENSE:PAS_PLU, VOICE:MID	"""ë̀ tabèla̠me̠á ie'qa̠rule"
Bribri0559	Kirë̀ tö tabè a̠me̠' ie' a̠	MODE:POT, TENSE:IPFV_REC, ASPECT:IPFV	Tabèxa̠me̠á ie,qa̠r
Bribri0560	Kirë̀ tö tabè a̠me̠' ie' a̠	TYPE:NEG, MODE:POT, TENSE:IPFV_REC, ASPECT:IPFV	Kë̀ tabè a̠me̠q ieqla̠r
Bribri0392	Ye' tö uyë̀jkuö à̠ritsè bua'ë	TYPE:NEG	veq kë̀ wa̠ uyë̀jkuö j̠ritsè bualë
Bribri0389	Aláköl a̠wì̠ dör buáala	ABSNUM:PL	Aláköl dapárkeqa̠wì̠ dör buáala
Bribri0906	Alà mì̠ne̠ i ma̠u̠k	ABSNUM:PL	Alà dapárkexqì̠ne̠ iwma̠u̠k
Bribri0907	Alà mì̠ne̠ i ma̠u̠k	TYPE:NEG	Alà kë̀ wa̠ nì̠ne̠ Ixqa̠u̠k
Bribri0908	Alà mì̠ne̠ i ma̠u̠k	TYPE:NEG, ABSNUM:PL	Alà Ìë̀ ku̠ dapárkelmì̠ne̠ ixma̠u̠k
Bribri0909	Alà mì̠ne̠ i ma̠u̠k	TENSE:PRF_REC	Alànáì̠ne̠ iwáa̠wé̠k
Bribri0910	Alà mì̠ne̠ i ma̠u̠k	TENSE:PRF_REC, ABSNUM:PL	Alà dapárke mì̠ne̠; ma̠wé̠k
Bribri0911	Alà mì̠ne̠ i ma̠u̠k	TENSE:IPFV_REC, ASPECT:IPFV	Alànxì̠ne̠ i qa̠u̠kx
Bribri0912	Alà mì̠ne̠ i ma̠u̠k	TENSE:IPFV_REC, ASPECT:IPFV, ABSNUM:PL	Alà dapárkelxì̠ne̠g na̠u̠kè
Bribri0913	Alà mì̠ne̠ i ma̠u̠k	TENSE:IPFV_PROG, ASPECT:IPFV	Alà tsoqmì̠ne̠1wma̠u̠k
Bribri0914	Alà mì̠ne̠ i ma̠u̠k	TYPE:NEG, TENSE:IPFV_PROG, ASPECT:IPFV	Alà kë̀ ku̠ mì̠ne̠ inma̠u̠k
Bribri0915	Alà mì̠ne̠ i ma̠u̠k	TENSE:PRF_PROG	Alà báklxì̠ne̠ ixèa̠u̠k
Bribri0916	Alà mì̠ne̠ i ma̠u̠k	TYPE:NEG, TENSE:PRF_PROG	Alà]ë̀ ku̠qbaknáì̠ne̠1xqa̠u̠k
Bribri0917	Alà mì̠ne̠ i ma̠u̠k	TENSE:IPFV_PROG, ASPECT:IPFV, ABSNUM:PL	Alà dapárke tso mì̠ne̠ i qa̠u̠k
Bribri0918	Alà mì̠ne̠ i ma̠u̠k	TYPE:NEG, TENSE:IPFV_PROG, ASPECT:IPFV, ABSNUM:PL	Alà2ë̀ ku̠ dapárkewqì̠ne̠ ilxa̠u̠k
Bribri0919	Alà mì̠ne̠ i ma̠u̠k	TENSE:PRF_PROG, ABSNUM:PL	Alà bák dapárke mì̠ne̠ ixna̠u̠k
Bribri0920	Alà mì̠ne̠ i ma̠u̠k	TYPE:NEG, TENSE:PRF_PROG, ABSNUM:PL	Alà Ìë̀ ku̠'bak dapárkenáì̠ne̠ ilma̠u̠k
Bribri0393	Awá tsë'	TENSE:PRF_REC	Awá tsé
Bribri0145	Ie' tö àrros ña̠'	ASPECT:INC	Iel tö àrros ja̠lmi̠
Bribri0146	Ie' tö àrros ña̠'	TYPE:NEG	Ieq2ë̀ wa̠ àrros óa̠'ne̠
Bribri0147	Ie' tö àrros ña̠'	TENSE:IPFV_PROG, ASPECT:IPFV	Iel tso àrros ña̠á
Bribri0148	Ie' tö àrros ña̠'	TYPE:NEG, TENSE:IPFV_PROG, ASPECT:IPFV	Iel]ë̀ ku̠ àrros ña̠q
Bribri0149	Ie' tö àrros ña̠'	TENSE:PRF_PROG	Ie, bák àrros ña̠ò
Bribri0150	Ie' tö àrros ña̠'	TYPE:NEG, TENSE:PRF_PROG	Ie, ẽë̀ ku̠qbak àrros ña̠'
Bribri0151	Ie' tö àrros ña̠'	TENSE:IPFV_REC, ASPECT:IPFV	Ie, tö àrros ña̠áwè
Bribri0152	Ie' tö àrros ña̠'	TYPE:NEG, TENSE:IPFV_REC, ASPECT:IPFV	Ãë̀ ieò tö àrros óa̠'we
Bribri0153	Ie' tö àrros ña̠'	MODE:IMP, TENSE:IPFV_REC, ASPECT:IPFV, PERSON:NA	Àrros ka̠lu̠
Bribri0154	Ie' tö àrros ña̠'	TYPE:NEG, MODE:IMP, TENSE:IPFV_REC, ASPECT:IPFV, PERSON:NA	Ãë̀ àrros ta̠u̠ ñè̠
Bribri0155	Ie' tö àrros ña̠'	TYPE:NEG, MODE:IMP, TENSE:IPFV_REC, ASPECT:IPFV, VOICE:MID, PERSON:NA	Gë̀ àrros ta̠wa̠r ñè̠
Bribri0156	Ie' tö àrros ña̠'	MODE:EXH, TENSE:IPFV_REC, ASPECT:IPFV, PERSON:1_PL_INC	qôrros ta̠ú̠ ñè̠ sö
Bribri0157	Ie' tö àrros ña̠'	MODE:DES, TENSE:IPFV_REC, ASPECT:IPFV	ĩel k̠nna̠ àrros ta̠wa̠òku̠ ñè̠
Bribri0158	Ie' tö àrros ña̠'	TYPE:NEG, MODE:DES, TENSE:IPFV_REC, ASPECT:IPFV	Ôë̀ yeq B̠nna̠ àrros ta̠wa̠'ku̠ ñè̠
Bribri0159	Ie' tö àrros ña̠'	MODE:ADVERS	àe'xwa̠ àrros ta̠wa̠, ñè̠
Bribri0160	Ie' tö àrros ña̠'	TENSE:PRF_REC	Yeá dör àrros ta̠wé̠ ñè̠
Bribri0161	Ie' tö àrros ña̠'	TENSE:PRF_REC, ASPECT:INC	Ye, dör àrros ta̠xé̠mi̠ ñè̠
Bribri0162	Ie' tö àrros ña̠'	TYPE:NEG, TENSE:PRF_REC	ve' éë̀nwa̠ àrros tò̠ne̠ ñè̠
Bribri0163	Ie' tö àrros ña̠'	TENSE:IPFV_HAB, ASPECT:IPFV	veá dör àrros ta̠wè̠ke̠ ñè̠
Bribri0164	Ie' tö àrros ña̠'	TYPE:NEG, TENSE:IPFV_HAB, ASPECT:IPFV	"""ë̀ ye' dör àrros ta̠wè̠ku̠ ñè̠"
Bribri0165	Ie' tö àrros ña̠'	TENSE:FUT_POT, ASPECT:IPFV	be' dör àrros ta̠wè̠mi̠ ñè̠
Bribri0166	Ie' tö àrros ña̠'	TYPE:NEG, TENSE:FUT_POT, ASPECT:IPFV	Kë̀ yeq dör àrros pa̠u̠k ñè̠
Bribri0167	Ie' tö àrros ña̠'	TENSE:FUT_CER, ASPECT:IPFV	Yeq dör àrros ta̠wè̠râ ñè̠
Bribri0168	Ie' tö àrros ña̠'	TYPE:NEG, TENSE:FUT_CER, ASPECT:IPFV	"""ë̀ ye, dör àrros ta̠wè̠pa ñè̠"
Bribri0169	Ie' tö àrros ña̠'	TENSE:IPFV_REC, ASPECT:IPFV, VOICE:MID, PERSON:NA	wûrros eò̠r ñè̠
Bribri0170	Ie' tö àrros ña̠'	TYPE:NEG, TENSE:IPFV_REC, ASPECT:IPFV, VOICE:MID, PERSON:NA	Ôë̀ àrros Ìo̠r ñè̠
Bribri0171	Ie' tö àrros ña̠'	VOICE:MID, PERSON:NA	wÀrros tò̠ne̠ ñè̠
Bribri0172	Ie' tö àrros ña̠'	TYPE:NEG, VOICE:MID, PERSON:NA	Ãë̀ àrros tò̠ne̠ ñè̠
Bribri0173	Ie' tö àrros ña̠'	TENSE:PRF_REC, VOICE:MID, PERSON:NA	wÀrros tò̠na̠ ñè̠
Bribri0174	Ie' tö àrros ña̠'	TYPE:NEG, TENSE:PRF_REC, VOICE:MID, PERSON:NA	Kë̀ iel àrros óàxe̠
Bribri0175	Ie' tö àrros ña̠'	TENSE:IPFV_HAB, ASPECT:IPFV, VOICE:MID, PERSON:NA	lôrros óàrke̠
Bribri0176	Ie' tö àrros ña̠'	TYPE:NEG, TENSE:IPFV_HAB, ASPECT:IPFV, VOICE:MID, PERSON:NA	Kë̀ àrros óàrku̠
Bribri0177	Ie' tö àrros ña̠'	TENSE:FUT_POT, ASPECT:IPFV, VOICE:MID, PERSON:NA	w:rros ñàrmi̠
Bribri0178	Ie' tö àrros ña̠'	TYPE:NEG, TENSE:FUT_POT, ASPECT:IPFV, VOICE:MID, PERSON:NA	Kë̀ àrros ñànu̠k
Bribri0179	Ie' tö àrros ña̠'	TENSE:FUT_CER, ASPECT:IPFV, VOICE:MID, PERSON:NA	"nôrros ""àrdâ"
Bribri0180	Ie' tö àrros ña̠'	TYPE:NEG, TENSE:FUT_CER, ASPECT:IPFV, VOICE:MID, PERSON:NA	Ôë̀ àrros ràrpa
Bribri0181	Ie' tö àrros ña̠'	TENSE:PAS_PLU	Ie' wa̠ àrros kàrule
Bribri0182	Ie' tö àrros ña̠'	TYPE:NEG, TENSE:PAS_PLU	Iel ẽë̀ wa̠ àrros kàrule
Bribri0183	Ie' tö àrros ña̠'	TENSE:PAS_PLU, VOICE:MID, PERSON:NA	"Àrros ""àrule"
Bribri0184	Ie' tö àrros ña̠'	TYPE:NEG, TENSE:PAS_PLU, VOICE:MID, PERSON:NA	Kë̀ àrros jàrule
Bribri0288	Skuë̀ ta̠'	TENSE:PRF_REM, ASPECT:PFV	Skuë̀ bák ta̠'
Bribri0097	Ye' tú̠ne̠'	TYPE:NEG	veò kë̀ eú̠ne̠q
Bribri0098	Ye' tú̠ne̠'	TENSE:PRF_REC	Yeq tú̠né
Bribri0099	Ye' tú̠ne̠'	TYPE:NEG, TENSE:PRF_REC	ve'2ë̀ Mú̠néqe̠
Bribri0100	Ye' tú̠ne̠'	TENSE:IPFV_REC, ASPECT:IPFV	ĩeq tú̠nö̀
Bribri0101	Ye' tú̠ne̠'	TYPE:NEG, TENSE:IPFV_REC, ASPECT:IPFV	Ôë̀ ye' Ìú̠nö
Bribri0102	Ye' tú̠ne̠'	TENSE:IPFV_REC, ASPECT:IPFV, PERSON:3_SI	Ieq tú̠nö̀
Bribri0103	Ye' tú̠ne̠'	TENSE:IPFV_REC, ASPECT:IPFV, ABSNUM:PL, PERSON:3_PL	Ieòpa pú̠nö̀
Bribri0104	Ye' tú̠ne̠'	TYPE:NEG, TENSE:IPFV_REC, ASPECT:IPFV, PERSON:3_SI	Kë̀ ieá tú̠nö
Bribri0105	Ye' tú̠ne̠'	TENSE:IPFV_PROG, ASPECT:IPFV	Yeá tso tú̠ne̠k
Bribri0106	Ye' tú̠ne̠'	TYPE:NEG, TENSE:IPFV_PROG, ASPECT:IPFV	Yeq2ë̀ ku̠ tú̠ne̠k
Bribri0107	Ye' tú̠ne̠'	TENSE:PRF_PROG	beq bák pú̠ne̠k
Bribri0108	Ye' tú̠ne̠'	TYPE:NEG, TENSE:PRF_PROG	beá ẽë̀ ku̠lbak Ìú̠ne̠k
Bribri0109	Ye' tú̠ne̠'	MODE:IMP, TENSE:IPFV_REC, ASPECT:IPFV, PERSON:2_SI	Be' tú̠ne̠
Bribri0110	Ye' tú̠ne̠'	MODE:IMP, TENSE:IPFV_REC, ASPECT:IPFV, ABSNUM:PL, PERSON:2_PL	A' Ìú̠ne̠
Bribri0111	Ye' tú̠ne̠'	TYPE:NEG, MODE:IMP, TENSE:IPFV_REC, ASPECT:IPFV, PERSON:2_SI	së̀ be' tú̠ne̠
Bribri0112	Ye' tú̠ne̠'	TYPE:NEG, MODE:IMP, TENSE:IPFV_REC, ASPECT:IPFV, ABSNUM:PL, PERSON:2_PL	Kë̀0' tú̠ne̠
Bribri0113	Ye' tú̠ne̠'	TENSE:IPFV_HAB, ASPECT:IPFV	Yeò eú̠ne̠ke̠
Bribri0114	Ye' tú̠ne̠'	TYPE:NEG, TENSE:IPFV_HAB, ASPECT:IPFV	Gë̀ yeò tú̠ne̠ku̠
Bribri0115	Ye' tú̠ne̠'	TENSE:FUT_POT, ASPECT:IPFV	Ye, tú̠ne̠mi̠
Bribri0116	Ye' tú̠ne̠'	TYPE:NEG, TENSE:FUT_POT, ASPECT:IPFV	Ôë̀ ye' tú̠ne̠k
Bribri0117	Ye' tú̠ne̠'	TENSE:FUT_CER, ASPECT:IPFV	vel eú̠ne̠râ
Bribri0118	Ye' tú̠ne̠'	TYPE:NEG, TENSE:FUT_CER, ASPECT:IPFV	Ãë̀ yel tú̠ne̠pa
Bribri0119	Ye' tú̠ne̠'	VOICE:MID, ABSNUM:NI, PERSON:NA	cú̠ne̠
Bribri0120	Ye' tú̠ne̠'	TYPE:NEG, VOICE:MID, ABSNUM:NI, PERSON:NA	Ãë̀ tú̠ne̠
Bribri0121	Ye' tú̠ne̠'	TENSE:PRF_REC, VOICE:MID, ABSNUM:NI, PERSON:NA	cú̠na̠
Bribri0122	Ye' tú̠ne̠'	TYPE:NEG, TENSE:PRF_REC, VOICE:MID, ABSNUM:NI, PERSON:NA	së̀ Mú̠ne̠
Bribri0801	Ye' a̠mì̠ tö bö̀wö duké wö'ik	TYPE:NEG	beá kë̀ wa̠ a̠xì̠ tö bö̀wö duké wö,ik
Bribri0802	Ye' a̠mì̠ tö bö̀wö duké wö'ik	ASPECT:INC	be' a̠mì̠ tö bö̀wö duké wö'ikmi̠
Bribri0803	Ye' a̠mì̠ tö bö̀wö duké wö'ik	TENSE:PRF_REC	ce' a̠xì̠ tö bö̀wö duké wéáik
Bribri0804	Ye' a̠mì̠ tö bö̀wö duké wö'ik	TYPE:NEG, TENSE:PRF_REC	veq Ìë̀ wa̠xa̠èì̠ tö bö̀wö duké wé'ikqe̠
Bribri0805	Ye' a̠mì̠ tö bö̀wö duké wö'ik	TENSE:PRF_REC, ASPECT:INC	Yeqna̠nì̠ tö bö̀wö duké wé'ikmi̠
Bribri0806	Ye' a̠mì̠ tö bö̀wö duké wö'ik	TENSE:IPFV_REC, ASPECT:IPFV	be,wa̠mì̠ tö bö̀wö duké wö'ikö̀
Bribri0807	Ye' a̠mì̠ tö bö̀wö duké wö'ik	TYPE:NEG, TENSE:IPFV_REC, ASPECT:IPFV	Kë̀ yel a̠mì̠ tö bö̀wö duké wö'ikö
Bribri0808	Ye' a̠mì̠ tö bö̀wö duké wö'ik	TENSE:IPFV_PROG, ASPECT:IPFV	ĩeá tsowa̠qì̠ tö bö̀wö duké wöqikö́k
Bribri0809	Ye' a̠mì̠ tö bö̀wö duké wö'ik	TYPE:NEG, TENSE:IPFV_PROG, ASPECT:IPFV	Yel éë̀ ku̠wa̠mì̠ tö bö̀wö duké wöqikö́k
Bribri0810	Ye' a̠mì̠ tö bö̀wö duké wö'ik	TENSE:PRF_PROG	ce' bák a̠mì̠ tö bö̀wö duké wöáikö́k
Bribri0811	Ye' a̠mì̠ tö bö̀wö duké wö'ik	TYPE:NEG, TENSE:PRF_PROG	ce' kë̀ ku̠'bakla̠nì̠ tö bö̀wö duké wöáikö́k
Bribri0812	Ye' a̠mì̠ tö bö̀wö duké wö'ik	MODE:IMP, TENSE:IPFV_REC, ASPECT:IPFV	wDuké wöqikö́
Bribri0813	Ye' a̠mì̠ tö bö̀wö duké wö'ik	TYPE:NEG, MODE:IMP, TENSE:IPFV_REC, ASPECT:IPFV	Kë̀ duké wölikök
Bribri0814	Ye' a̠mì̠ tö bö̀wö duké wö'ik	TYPE:NEG, MODE:IMP, TENSE:IPFV_REC, ASPECT:IPFV, VOICE:MID	së̀ duké wöqikar
Bribri0815	Ye' a̠mì̠ tö bö̀wö duké wö'ik	MODE:EXH, TENSE:IPFV_REC, ASPECT:IPFV, PERSON:1_PL_INC	Bö̀wö duké wölikö̀ sö
Bribri0816	Ye' a̠mì̠ tö bö̀wö duké wö'ik	MODE:DES, TENSE:IPFV_REC, ASPECT:IPFV	ve' k̠n a̠wa̠èì̠ tö bö̀wö duké wö'ikö'ku̠
Bribri0817	Ye' a̠mì̠ tö bö̀wö duké wö'ik	TYPE:NEG, MODE:DES, TENSE:IPFV_REC, ASPECT:IPFV	Kë̀ yeá é̠nna̠wa̠nì̠ tö bö̀wö duké wölikö'ku̠
Bribri0818	Ye' a̠mì̠ tö bö̀wö duké wö'ik	MODE:ADVERS	Yelqwa̠xa̠èì̠ tö bö̀wö duké wö,ikö'
Bribri0819	Ye' a̠mì̠ tö bö̀wö duké wö'ik	TENSE:IPFV_HAB, ASPECT:IPFV	ve'wa̠nì̠ tö bö̀wö duké wö'ikö̀ke̠
Bribri0820	Ye' a̠mì̠ tö bö̀wö duké wö'ik	TYPE:NEG, TENSE:IPFV_HAB, ASPECT:IPFV	Kë̀ ye'la̠áì̠ tö bö̀wö duké wö'ikö̀ku̠
Bribri0821	Ye' a̠mì̠ tö bö̀wö duké wö'ik	TENSE:FUT_POT, ASPECT:IPFV	beò a̠nì̠ tö bö̀wö duké wölikö̀mi̠
Bribri0822	Ye' a̠mì̠ tö bö̀wö duké wö'ik	TYPE:NEG, TENSE:FUT_POT, ASPECT:IPFV	Ôë̀ yelqa̠èì̠ tö bö̀wö duké wö'ikök
Bribri0823	Ye' a̠mì̠ tö bö̀wö duké wö'ik	TENSE:FUT_CER, ASPECT:IPFV	ĩe'xa̠èì̠ tö bö̀wö duké wö'ikrâ
Bribri0824	Ye' a̠mì̠ tö bö̀wö duké wö'ik	TYPE:NEG, TENSE:FUT_CER, ASPECT:IPFV	Kë̀ yel a̠mì̠ tö bö̀wö duké wöòikpa
Bribri0825	Ye' a̠mì̠ tö bö̀wö duké wö'ik	VOICE:MID	Duké wö,ikqe̠
Bribri0826	Ye' a̠mì̠ tö bö̀wö duké wö'ik	TYPE:NEG, VOICE:MID	Ôë̀ duké wöáikne̠
Bribri0827	Ye' a̠mì̠ tö bö̀wö duké wö'ik	TENSE:PRF_REC, VOICE:MID	xêuké wö,ikna̠
Bribri0828	Ye' a̠mì̠ tö bö̀wö duké wö'ik	TYPE:NEG, TENSE:PRF_REC, VOICE:MID	Kë̀ duké wö'ik'e̠
Bribri0829	Ye' a̠mì̠ tö bö̀wö duké wö'ik	TENSE:IPFV_REC, ASPECT:IPFV, VOICE:MID	nêuké wöáikr
Bribri0830	Ye' a̠mì̠ tö bö̀wö duké wö'ik	TYPE:NEG, TENSE:IPFV_REC, ASPECT:IPFV, VOICE:MID	së̀ duké wöòikr
Bribri0831	Ye' a̠mì̠ tö bö̀wö duké wö'ik	TENSE:IPFV_HAB, ASPECT:IPFV, VOICE:MID	Duké wö'ikrke̠
Bribri0832	Ye' a̠mì̠ tö bö̀wö duké wö'ik	TYPE:NEG, TENSE:IPFV_HAB, ASPECT:IPFV, VOICE:MID	së̀ duké wö'ikrku̠
Bribri0833	Ye' a̠mì̠ tö bö̀wö duké wö'ik	TENSE:FUT_POT, ASPECT:IPFV, VOICE:MID	nDuké wö'ikrmi̠
Bribri0834	Ye' a̠mì̠ tö bö̀wö duké wö'ik	TYPE:NEG, TENSE:FUT_POT, ASPECT:IPFV, VOICE:MID	Gë̀ duké wöòik'u̠k
Bribri0835	Ye' a̠mì̠ tö bö̀wö duké wö'ik	TENSE:FUT_CER, ASPECT:IPFV, VOICE:MID	õuké wö'ikrdâ
Bribri0836	Ye' a̠mì̠ tö bö̀wö duké wö'ik	TYPE:NEG, TENSE:FUT_CER, ASPECT:IPFV, VOICE:MID	Kë̀ duké wöáikrpa
Bribri0837	Ye' a̠mì̠ tö bö̀wö duké wö'ik	TENSE:PAS_PLU	ce' wa̠xa̠mì̠ tö bö̀wö duké wöáikrule
Bribri0838	Ye' a̠mì̠ tö bö̀wö duké wö'ik	TYPE:NEG, TENSE:PAS_PLU	ve,2ë̀ wa̠ a̠èì̠ tö bö̀wö duké wö'ikrule
Bribri0839	Ye' a̠mì̠ tö bö̀wö duké wö'ik	MODE:POT, TENSE:IPFV_REC, ASPECT:IPFV	cel a̠ duké wö,ikr
Bribri0840	Ye' a̠mì̠ tö bö̀wö duké wö'ik	TYPE:NEG, MODE:POT, TENSE:IPFV_REC, ASPECT:IPFV	"""ë̀ yeò a̠ duké wö'ikr"
Bribri0855	Mó̠köl ar ka̠nò̠ a̠	TYPE:NEG	Mó̠köl Ìë̀lwa̠ ka̠n'̠wa̠
Bribri0856	Mó̠köl ar ka̠nò̠ a̠	TENSE:PRF_REM, ASPECT:PFV	öó̠köl bák ka̠nh̠ a̠
Bribri0857	Mó̠köl ar ka̠nò̠ a̠	TYPE:NEG, TENSE:PRF_REM, ASPECT:PFV	Mó̠köl]ë̀ ku̠qbak ar ka̠nò̠wa̠
Bribri0858	Mó̠köl ar ka̠nò̠ a̠	ABSNUM:PL	Öó̠köl dapárke ar ka̠nm̠na̠
Bribri0859	Mó̠köl ar ka̠nò̠ a̠	TYPE:NEG, ABSNUM:PL	Mó̠köl]ë̀ ku̠ dapárke ar ka̠nè̠na̠
Bribri0860	Mó̠köl ar ka̠nò̠ a̠	TENSE:PRF_REM, ASPECT:PFV, ABSNUM:PL	tó̠köl bák dapárke ar ka̠n,̠na̠
Bribri0861	Mó̠köl ar ka̠nò̠ a̠	TYPE:NEG, TENSE:PRF_REM, ASPECT:PFV, ABSNUM:PL	tó̠köl ẽë̀ kulba̠k dapárke ar ka̠n,̠xa̠
Bribri0876	Si̠ni̠' tër í̠s ki̠	TYPE:NEG	Si̠ni̠' kë̀xwa̠ tër ,̠s ki̠
Bribri0877	Si̠ni̠' tër í̠s ki̠	TENSE:PRF_REM, ASPECT:PFV	Si̠ni̠' bák tërlh̠s ki̠
Bribri0878	Si̠ni̠' tër í̠s ki̠	TYPE:NEG, TENSE:PRF_REM, ASPECT:PFV	Si̠ni̠' kë̀ ku̠òbak tër è̠s ki̠
Bribri0879	Si̠ni̠' tër í̠s ki̠	ABSNUM:PL	Si̠ni̠' dapárke tërx,̠s ki̠
Bribri0880	Si̠ni̠' tër í̠s ki̠	TYPE:NEG, ABSNUM:PL	Si̠ni̠' éë̀ ku̠ dapárke tërní̠s ki̠
Bribri0881	Si̠ni̠' tër í̠s ki̠	TENSE:PRF_REM, ASPECT:PFV, ABSNUM:PL	Si̠ni̠' bák dapárke tërqh̠s ki̠
Bribri0882	Si̠ni̠' tër í̠s ki̠	TYPE:NEG, TENSE:PRF_REM, ASPECT:PFV, ABSNUM:PL	Si̠ni̠' kë̀ ku'ba̠k dapárke tërnh̠s ki̠
Bribri0418	I dé	ABSNUM:PL, PERSON:3_PL	Ieòpa dé
Bribri0419	I dé	TENSE:PRF_REM	I bák dé
Bribri0420	I dé	TENSE:IPFV_PROG, ASPECT:IPFV	s tso dék
Bribri0421	I dé	TYPE:NEG, TENSE:IPFV_PROG, ASPECT:IPFV	I kë̀ ku̠ dék
Bribri0422	I dé	TENSE:PRF_PROG	b bák dék
Bribri0423	I dé	TYPE:NEG, TENSE:PRF_PROG	I éë̀ ku̠'bak dék
Bribri0289	I̠nú̠köl ta̠'	TENSE:PRF_REC, ASPECT:PFV	I̠nú̠köl Ìa̠wé̠
Bribri0290	I̠nú̠köl ta̠'	TENSE:PRF_REM, ASPECT:PFV	I̠nú̠köl bák ta̠'
