ID	Source	Change	Target
Bribri0561	Ye' tö àrros ali' ù̠ i' a̠	TYPE:NEG	Ye' kë̀ wa̠ àrros ali' ù̠ i' a̠
Bribri0562	Ye' tö àrros ali' ù̠ i' a̠	ASPECT:INC	Ye' tö àrros ali' ù̠mi̠ i' a̠
Bribri0563	Ye' tö àrros ali' ù̠ i' a̠	TENSE:PRF_REC	Ye' tö àrros ali' ù̠wé̠ i' a̠
Bribri0564	Ye' tö àrros ali' ù̠ i' a̠	TYPE:NEG, TENSE:PRF_REC	Ye' kë̀ wa̠ àrros ali' ù̠ne̠ i' a̠
Bribri0565	Ye' tö àrros ali' ù̠ i' a̠	TENSE:PRF_REC, ASPECT:INC	Ye' tö àrros ali' ù̠wé̠mi̠ i' a̠
Bribri0566	Ye' tö àrros ali' ù̠ i' a̠	TENSE:IPFV_REC, ASPECT:IPFV	Ye' tö àrros ali' ù̠wè̠ i' a̠
Bribri0567	Ye' tö àrros ali' ù̠ i' a̠	TYPE:NEG, TENSE:IPFV_REC, ASPECT:IPFV	Kë̀ ye' tö àrros ali' ù̠we̠ i' a̠
Bribri0568	Ye' tö àrros ali' ù̠ i' a̠	TENSE:IPFV_PROG, ASPECT:IPFV	Ye' tso àrros ali' ù̠ú̠k i' a̠
Bribri0569	Ye' tö àrros ali' ù̠ i' a̠	TYPE:NEG, TENSE:IPFV_PROG, ASPECT:IPFV	Ye' kë̀ ku̠ àrros ali' ù̠ú̠k i' a̠
Bribri0570	Ye' tö àrros ali' ù̠ i' a̠	TENSE:PRF_PROG	Ye' bák àrros ali' ù̠ú̠k i' a̠
Bribri0571	Ye' tö àrros ali' ù̠ i' a̠	TYPE:NEG, TENSE:PRF_PROG	Ye' kë̀ ku̠'bak àrros ali' ù̠ú̠k i' a̠
Bribri0572	Ye' tö àrros ali' ù̠ i' a̠	MODE:IMP, TENSE:IPFV_REC, ASPECT:IPFV, PERSON:NA	Àrros ali' ù̠ú̠ i' a̠
Bribri0573	Ye' tö àrros ali' ù̠ i' a̠	TYPE:NEG, MODE:IMP, TENSE:IPFV_REC, ASPECT:IPFV, PERSON:NA	Kë̀ àrros ali' ù̠uk i' a̠
Bribri0574	Ye' tö àrros ali' ù̠ i' a̠	TYPE:NEG, MODE:IMP, TENSE:IPFV_REC, ASPECT:IPFV, VOICE:MID, PERSON:NA	Kë̀ àrros ali' ù̠war i' a̠
Bribri0575	Ye' tö àrros ali' ù̠ i' a̠	MODE:EXH, TENSE:IPFV_REC, ASPECT:IPFV, PERSON:1_PL_INC	Àrros ali' ù̠ú̠ i' a̠ sö
Bribri0576	Ye' tö àrros ali' ù̠ i' a̠	MODE:DES, TENSE:IPFV_REC, ASPECT:IPFV	Ye' é̠n a̠ àrros ali' ù̠wa̠'ku̠ i' a̠
Bribri0577	Ye' tö àrros ali' ù̠ i' a̠	TYPE:NEG, MODE:DES, TENSE:IPFV_REC, ASPECT:IPFV	Kë̀ ye' é̠n a̠ àrros ali' ù̠wa̠'ku̠ i' a̠
Bribri0578	Ye' tö àrros ali' ù̠ i' a̠	MODE:ADVERS	Ye' wa̠ àrros ali' ù̠wa̠' i' a̠
Bribri0579	Ye' tö àrros ali' ù̠ i' a̠	TENSE:IPFV_HAB, ASPECT:IPFV	Ye' tö àrros ali' ù̠wè̠ke̠ i' a̠
Bribri0580	Ye' tö àrros ali' ù̠ i' a̠	TYPE:NEG, TENSE:IPFV_HAB, ASPECT:IPFV	Kë̀ ye' tö àrros ali' ù̠wè̠ku̠ i' a̠
Bribri0581	Ye' tö àrros ali' ù̠ i' a̠	TENSE:FUT_POT, ASPECT:IPFV	Ye' tö àrros ali' ù̠ i' a̠mi̠
Bribri0582	Ye' tö àrros ali' ù̠ i' a̠	TYPE:NEG, TENSE:FUT_POT, ASPECT:IPFV	Kë̀ ye' tö àrros ali' ù̠ i' a̠k
Bribri0583	Ye' tö àrros ali' ù̠ i' a̠	TENSE:FUT_CER, ASPECT:IPFV	Ye' tö àrros ali' ù̠ i' a̠râ
Bribri0584	Ye' tö àrros ali' ù̠ i' a̠	TYPE:NEG, TENSE:FUT_CER, ASPECT:IPFV	Kë̀ ye' tö àrros ali' ù̠ i' a̠pa
Bribri0585	Ye' tö àrros ali' ù̠ i' a̠	VOICE:MID, PERSON:NA	Àrros ali' ù̠ i' a̠ne̠
Bribri0586	Ye' tö àrros ali' ù̠ i' a̠	TYPE:NEG, VOICE:MID, PERSON:NA	Kë̀ àrros ali' ù̠ i' a̠ne̠
Bribri0587	Ye' tö àrros ali' ù̠ i' a̠	TENSE:PRF_REC, VOICE:MID, PERSON:NA	Àrros ali' ù̠ i' a̠na̠
Bribri0588	Ye' tö àrros ali' ù̠ i' a̠	TYPE:NEG, TENSE:PRF_REC, VOICE:MID, PERSON:NA	Kë̀ àrros ali' ù̠ i' a̠ne̠
Bribri0589	Ye' tö àrros ali' ù̠ i' a̠	TENSE:IPFV_REC, ASPECT:IPFV, VOICE:MID, PERSON:NA	Àrros ali' ù̠ i' a̠r
Bribri0590	Ye' tö àrros ali' ù̠ i' a̠	TYPE:NEG, TENSE:IPFV_REC, ASPECT:IPFV, VOICE:MID, PERSON:NA	Kë̀ àrros ali' ù̠ i' a̠r
Bribri0591	Ye' tö àrros ali' ù̠ i' a̠	TENSE:IPFV_HAB, ASPECT:IPFV, VOICE:MID, PERSON:NA	Àrros ali' ù̠ i' a̠rke̠
Bribri0592	Ye' tö àrros ali' ù̠ i' a̠	TYPE:NEG, TENSE:IPFV_HAB, ASPECT:IPFV, VOICE:MID, PERSON:NA	Kë̀ àrros ali' ù̠ i' a̠rku̠
Bribri0593	Ye' tö àrros ali' ù̠ i' a̠	TENSE:FUT_POT, ASPECT:IPFV, VOICE:MID, PERSON:NA	Àrros ali' ù̠ i' a̠rmi̠
Bribri0594	Ye' tö àrros ali' ù̠ i' a̠	TYPE:NEG, TENSE:FUT_POT, ASPECT:IPFV, VOICE:MID, PERSON:NA	Kë̀ àrros ali' ù̠ i' a̠nu̠k
Bribri0595	Ye' tö àrros ali' ù̠ i' a̠	TENSE:FUT_CER, ASPECT:IPFV, VOICE:MID, PERSON:NA	Àrros ali' ù̠ i' a̠rdâ
Bribri0596	Ye' tö àrros ali' ù̠ i' a̠	TYPE:NEG, TENSE:FUT_CER, ASPECT:IPFV, VOICE:MID, PERSON:NA	Kë̀ àrros ali' ù̠ i' a̠rpa
Bribri0597	Ye' tö àrros ali' ù̠ i' a̠	TENSE:PAS_PLU	Ye' wa̠ àrros ali' ù̠ i' a̠rule
Bribri0598	Ye' tö àrros ali' ù̠ i' a̠	TYPE:NEG, TENSE:PAS_PLU	Ye' kë̀ wa̠ àrros ali' ù̠ i' a̠rule
Bribri0599	Ye' tö àrros ali' ù̠ i' a̠	MODE:POT, TENSE:IPFV_REC, ASPECT:IPFV	Ye' a̠ àrros ali' ù̠ i' a̠r
Bribri0600	Ye' tö àrros ali' ù̠ i' a̠	TYPE:NEG, MODE:POT, TENSE:IPFV_REC, ASPECT:IPFV	Kë̀ ye' a̠ àrros ali' ù̠ i' a̠r
Bribri0416	I kiö́	ABSNUM:PL	I kiö́'ulur
Bribri0417	I tso'	ABSNUM:PL, PERSON:3_PL	Ie'pa tso'
Bribri0721	Maria dör kápi u'	TYPE:NEG	Maria kë̀ wa̠ kápi ùne̠
Bribri0722	Maria dör kápi u'	ASPECT:INC	Maria dör kápi u'mi̠
Bribri0723	Maria dör kápi u'	TENSE:PRF_REC	Maria dör kápi úe
Bribri0724	Maria dör kápi u'	TYPE:NEG, TENSE:PRF_REC	Maria kë̀ wa̠ kápi ùne̠
Bribri0725	Maria dör kápi u'	TENSE:PRF_REC, ASPECT:INC	Maria dör kápi úemi̠
Bribri0726	Maria dör kápi u'	TENSE:IPFV_REC, ASPECT:IPFV	Maria dör kápi uè
Bribri0727	Maria dör kápi u'	TYPE:NEG, TENSE:IPFV_REC, ASPECT:IPFV	Kë̀ Maria dör kápi ue
Bribri0728	Maria dör kápi u'	TENSE:IPFV_PROG, ASPECT:IPFV	Maria tso kápi uö́k
Bribri0729	Maria dör kápi u'	TYPE:NEG, TENSE:IPFV_PROG, ASPECT:IPFV	Maria kë̀ ku̠ kápi uö́k
Bribri0730	Maria dör kápi u'	TENSE:PRF_PROG	Maria bák kápi uö́k
Bribri0731	Maria dör kápi u'	TYPE:NEG, TENSE:PRF_PROG	Maria kë̀ ku̠'bak kápi uö́k
Bribri0732	Maria dör kápi u'	MODE:IMP, TENSE:IPFV_REC, ASPECT:IPFV	Kápi uö́
Bribri0733	Maria dör kápi u'	TYPE:NEG, MODE:IMP, TENSE:IPFV_REC, ASPECT:IPFV	Kë̀ kápi uök
Bribri0734	Maria dör kápi u'	TYPE:NEG, MODE:IMP, TENSE:IPFV_REC, ASPECT:IPFV, VOICE:MID	Kë̀ kápi uwar
Bribri0735	Maria dör kápi u'	MODE:EXH, TENSE:IPFV_REC, ASPECT:IPFV, PERSON:1_PL_INC	Kápi uö̀ sö
Bribri0736	Maria dör kápi u'	MODE:DES, TENSE:IPFV_REC, ASPECT:IPFV	Maria é̠n a̠ kápi ua'ku̠
Bribri0737	Maria dör kápi u'	TYPE:NEG, MODE:DES, TENSE:IPFV_REC, ASPECT:IPFV	Kë̀ Maria é̠n a̠ kápi ua'ku̠
Bribri0738	Maria dör kápi u'	MODE:ADVERS	Maria wa̠ kápi ua'
Bribri0739	Maria dör kápi u'	TENSE:IPFV_HAB, ASPECT:IPFV	Maria dör kápi u'ke̠
Bribri0740	Maria dör kápi u'	TYPE:NEG, TENSE:IPFV_HAB, ASPECT:IPFV	Kë̀ Maria dör kápi u'ku̠
Bribri0741	Maria dör kápi u'	TENSE:FUT_POT, ASPECT:IPFV	Maria dör kápi u'mi̠
Bribri0742	Maria dör kápi u'	TYPE:NEG, TENSE:FUT_POT, ASPECT:IPFV	Kë̀ Maria dör kápi uk
Bribri0743	Maria dör kápi u'	TENSE:FUT_CER, ASPECT:IPFV	Maria dör kápi u'râ
Bribri0744	Maria dör kápi u'	TYPE:NEG, TENSE:FUT_CER, ASPECT:IPFV	Kë̀ Maria dör kápi u'pa
Bribri0745	Maria dör kápi u'	VOICE:MID	Kápi u'ne̠
Bribri0746	Maria dör kápi u'	TYPE:NEG, VOICE:MID	Kë̀ kápi u'ne̠
Bribri0747	Maria dör kápi u'	TENSE:PRF_REC, VOICE:MID	Kápi u'na̠
Bribri0748	Maria dör kápi u'	TYPE:NEG, TENSE:PRF_REC, VOICE:MID	Kë̀ kápi u'ne̠
Bribri0749	Maria dör kápi u'	TENSE:IPFV_REC, ASPECT:IPFV, VOICE:MID	Kápi u'r
Bribri0750	Maria dör kápi u'	TYPE:NEG, TENSE:IPFV_REC, ASPECT:IPFV, VOICE:MID	Kë̀ kápi ur
Bribri0751	Maria dör kápi u'	TENSE:IPFV_HAB, ASPECT:IPFV, VOICE:MID	Kápi u'rke̠
Bribri0752	Maria dör kápi u'	TYPE:NEG, TENSE:IPFV_HAB, ASPECT:IPFV, VOICE:MID	Kë̀ kápi u'rku̠
Bribri0753	Maria dör kápi u'	TENSE:FUT_POT, ASPECT:IPFV, VOICE:MID	Kápi u'rmi̠
Bribri0754	Maria dör kápi u'	TYPE:NEG, TENSE:FUT_POT, ASPECT:IPFV, VOICE:MID	Kë̀ kápi u'nu̠k
Bribri0755	Maria dör kápi u'	TENSE:FUT_CER, ASPECT:IPFV, VOICE:MID	Kápi u'rdâ
Bribri0756	Maria dör kápi u'	TYPE:NEG, TENSE:FUT_CER, ASPECT:IPFV, VOICE:MID	Kë̀ kápi u'rpa
Bribri0757	Maria dör kápi u'	TENSE:PAS_PLU	Maria wa̠ kápi u'rule
Bribri0758	Maria dör kápi u'	TYPE:NEG, TENSE:PAS_PLU	Maria kë̀ wa̠ kápi u'rule
Bribri0759	Maria dör kápi u'	MODE:POT, TENSE:IPFV_REC, ASPECT:IPFV	Maria a̠ kápi u̠'
Bribri0760	Maria dör kápi u'	TYPE:NEG, MODE:POT, TENSE:IPFV_REC, ASPECT:IPFV	Kë̀ Maria a̠ kápi u̠'
Bribri0336	Ye' ka̠nè̠balë'	TENSE:IPFV_REC, ASPECT:IPFV, VOICE:MID, ABSNUM:NI, PERSON:NA	Ka̠nè̠balë̀r
Bribri0337	Ye' ka̠nè̠balë'	TYPE:NEG, TENSE:IPFV_REC, ASPECT:IPFV, VOICE:MID, ABSNUM:NI, PERSON:NA	Kë̀ ka̠nè̠balë̀r
Bribri0932	Ye' tö i yë́	TYPE:NEG	Ye' kë̀ wa̠ i yë̀ne̠
Bribri0933	Ye' tö i yë́	PERSON:2_SI	Be' i yë́
Bribri0934	Ye' tö i yë́	TYPE:NEG, PERSON:2_SI	Be' kë̀ i yë́
Bribri0935	Ye' tö i yë́	PERSON:3_SI	Ie' i yë́
Bribri0936	Ye' tö i yë́	TYPE:NEG, PERSON:3_SI	Ie' kë̀ i yë́
Bribri0937	Ye' tö i yë́	PERSON:1_PL_EXC	Sa' i yë́
Bribri0938	Ye' tö i yë́	TYPE:NEG, PERSON:1_PL_EXC	Sa' kë̀ i yë́
Bribri0939	Ye' tö i yë́	PERSON:1_PL_INC	Se' i yë́
Bribri0940	Ye' tö i yë́	TYPE:NEG, PERSON:1_PL_INC	Se' kë̀ i yë́
Bribri0941	Ye' tö i yë́	PERSON:2_PL	A' i yë́
Bribri0942	Ye' tö i yë́	TYPE:NEG, PERSON:2_PL	A' kë̀ i yë́
Bribri0943	Ye' tö i yë́	PERSON:3_PL	Ie'pa i yë́
Bribri0944	Ye' tö i yë́	TYPE:NEG, PERSON:3_PL	Ie'pa kë̀ i yë́
Bribri0945	Ye' tö i yë́	TENSE:PRF_REC	Ye' i yéstë
Bribri0946	Ye' tö i yë́	TENSE:IPFV_REC, ASPECT:IPFV	Ye' tö i yë̀
Bribri0947	Ye' tö i yë́	TENSE:IPFV_PROG, ASPECT:IPFV	Ye' tso i yë́k
Bribri0948	Ye' tö i yë́	TYPE:NEG, TENSE:IPFV_PROG, ASPECT:IPFV	Ye' kë̀ ku̠ i yë́k
Bribri0949	Ye' tö i yë́	TENSE:PRF_PROG	Ye' bák i yë́k
Bribri0950	Ye' tö i yë́	TYPE:NEG, TENSE:PRF_PROG	Ye' kë̀ ku̠'bak i yë́k
Bribri0951	Ye' tö i yë́	MODE:IMP, TENSE:IPFV_REC, ASPECT:IPFV, PERSON:NA	I yë́
Bribri0952	Ye' tö i yë́	TENSE:FUT_POT, ASPECT:IPFV	Ye' tö i yë́mi̠
Bribri0953	Ye' tö i yë́	TENSE:IPFV_HAB, ASPECT:IPFV	Ye' tö i yë́ke̠
Bribri0954	Ye' tö i yë́	VOICE:MID, ABSNUM:NI, PERSON:NA	I yë́ne̠
Bribri0955	Ye' tö i yë́	TYPE:NEG, VOICE:MID, ABSNUM:NI, PERSON:NA	Kë̀ i yë́ne̠
Bribri0956	Ye' tö i yë́	TENSE:IPFV_REC, ASPECT:IPFV, VOICE:MID, ABSNUM:NI, PERSON:NA	I yë́r
Bribri0424	Ye' tö shkame̠' yö'	ASPECT:INC	Ye' tö shkame̠' yö'mi̠
Bribri0425	Ye' tö shkame̠' yö'	TYPE:NEG	Ye' kë̀ wa̠ shkame̠' yö̀ne̠
Bribri0426	Ye' tö shkame̠' yö'	TENSE:PRF_REC	Ye' tö shkame̠' yé
Bribri0427	Ye' tö shkame̠' yö'	TENSE:PRF_REC, ASPECT:INC	Ye' tö shkame̠' yémi̠
Bribri0428	Ye' tö shkame̠' yö'	TYPE:NEG, TENSE:PRF_REC	Ye' kë̀ wa̠ shkame̠' yö̀ne̠
Bribri0429	Ye' tö shkame̠' yö'	TENSE:IPFV_REC, ASPECT:IPFV	Ye' tö shkame̠' yè
Bribri0430	Ye' tö shkame̠' yö'	TYPE:NEG, TENSE:IPFV_REC, ASPECT:IPFV	Kë̀ ye' tö shkame̠' ye
Bribri0431	Ye' tö shkame̠' yö'	MODE:POT, TENSE:IPFV_REC, ASPECT:IPFV	Ye' shkame̠' yó
Bribri0432	Ye' tö shkame̠' yö'	TYPE:NEG, MODE:POT, TENSE:IPFV_REC, ASPECT:IPFV	Kë̀ ye' shkame̠' yo
Bribri0433	Ye' tö shkame̠' yö'	TENSE:IPFV_PROG, ASPECT:IPFV	Ye' tso shkame̠' yö́k
Bribri0434	Ye' tö shkame̠' yö'	TYPE:NEG, TENSE:IPFV_PROG, ASPECT:IPFV	Ye' kë̀ ku̠ shkame̠' yö́k
Bribri0435	Ye' tö shkame̠' yö'	TENSE:PRF_PROG	Ye' bák shkame̠' yö́k
Bribri0436	Ye' tö shkame̠' yö'	TYPE:NEG, TENSE:PRF_PROG	Ye' kë̀ ku̠'bak shkame̠' yö́k
Bribri0437	Ye' tö shkame̠' yö'	MODE:IMP, TENSE:IPFV_REC, ASPECT:IPFV, PERSON:NA	Shkame̠' yö́
Bribri0438	Ye' tö shkame̠' yö'	TYPE:NEG, MODE:IMP, TENSE:IPFV_REC, ASPECT:IPFV, PERSON:NA	Kë̀ shkame̠' yök
Bribri0439	Ye' tö shkame̠' yö'	TYPE:NEG, MODE:IMP, TENSE:IPFV_REC, ASPECT:IPFV, VOICE:MID, PERSON:NA	Kë̀ shkame̠' yar
Bribri0440	Ye' tö shkame̠' yö'	MODE:EXH, TENSE:IPFV_REC, ASPECT:IPFV, PERSON:1_PL_INC	Shkame̠' yö̀ sö
Bribri0441	Ye' tö shkame̠' yö'	MODE:DES, TENSE:IPFV_REC, ASPECT:IPFV	Ye' é̠n a̠ shkame̠' ya'ku̠
Bribri0442	Ye' tö shkame̠' yö'	TYPE:NEG, MODE:DES, TENSE:IPFV_REC, ASPECT:IPFV	Kë̀ ye' é̠n a̠ shkame̠' ya'ku̠
Bribri0443	Ye' tö shkame̠' yö'	MODE:ADVERS	Ye' wa̠ shkame̠' ya'
Bribri0444	Ye' tö shkame̠' yö'	TENSE:IPFV_HAB, ASPECT:IPFV	Ye' tö shkame̠' yö̀ke̠
Bribri0445	Ye' tö shkame̠' yö'	TYPE:NEG, TENSE:IPFV_HAB, ASPECT:IPFV	Kë̀ ye' tö shkame̠' yö̀ku̠
Bribri0446	Ye' tö shkame̠' yö'	TENSE:FUT_POT, ASPECT:IPFV	Ye' tö shkame̠' yö̀mi̠
Bribri0447	Ye' tö shkame̠' yö'	TYPE:NEG, TENSE:FUT_POT, ASPECT:IPFV	Kë̀ ye' tö shkame̠' yök
Bribri0448	Ye' tö shkame̠' yö'	TENSE:FUT_CER, ASPECT:IPFV	Ye' tö shkame̠' yö̀râ
Bribri0449	Ye' tö shkame̠' yö'	TYPE:NEG, TENSE:FUT_CER, ASPECT:IPFV	Kë̀ ye' tö shkame̠' yö̀pa
Bribri0450	Ye' tö shkame̠' yö'	VOICE:MID, PERSON:NA	Shkame̠' yö̀ne̠
Bribri0451	Ye' tö shkame̠' yö'	TYPE:NEG, VOICE:MID, PERSON:NA	Kë̀ shkame̠' yö̀ne̠
Bribri0452	Ye' tö shkame̠' yö'	TENSE:PRF_REC, VOICE:MID, PERSON:NA	Shkame̠' yö̀na̠
Bribri0453	Ye' tö shkame̠' yö'	TYPE:NEG, TENSE:PRF_REC, VOICE:MID, PERSON:NA	Kë̀ shkame̠' yö̀ne̠
Bribri0454	Ye' tö shkame̠' yö'	TENSE:IPFV_REC, ASPECT:IPFV, VOICE:MID, PERSON:NA	Shkame̠' yör
Bribri0455	Ye' tö shkame̠' yö'	TYPE:NEG, TENSE:IPFV_REC, ASPECT:IPFV, VOICE:MID, PERSON:NA	Kë̀ shkamër
Bribri0456	Ye' tö shkame̠' yö'	TENSE:IPFV_HAB, ASPECT:IPFV, VOICE:MID, PERSON:NA	Shkamërke̠
Bribri0457	Ye' tö shkame̠' yö'	TYPE:NEG, TENSE:IPFV_HAB, ASPECT:IPFV, VOICE:MID, PERSON:NA	Kë̀ shkamërku̠
Bribri0458	Ye' tö shkame̠' yö'	TENSE:FUT_POT, ASPECT:IPFV, VOICE:MID, PERSON:NA	Shkamërmi̠
Bribri0459	Ye' tö shkame̠' yö'	TYPE:NEG, TENSE:FUT_POT, ASPECT:IPFV, VOICE:MID, PERSON:NA	Kë̀ shkamënu̠k
Bribri0460	Ye' tö shkame̠' yö'	TENSE:FUT_CER, ASPECT:IPFV, VOICE:MID, PERSON:NA	Shkamërdâ
Bribri0461	Ye' tö shkame̠' yö'	TYPE:NEG, TENSE:FUT_CER, ASPECT:IPFV, VOICE:MID, PERSON:NA	Kë̀ shkamërpa
Bribri0462	Ye' tö shkame̠' yö'	TENSE:PAS_PLU, VOICE:MID	Shkamërulë
Bribri0463	Ye' tö shkame̠' yö'	TYPE:NEG, TENSE:PAS_PLU, VOICE:MID	Kë̀ shkamërulë
Bribri0253	Ye' tö kápi ya'	TYPE:NEG	Ye' kë̀ wa̠ kápi ya̠
Bribri0254	Ye' tö kápi ya'	TENSE:IPFV_PROG, ASPECT:IPFV	Ye' tso kápi yök
Bribri0255	Ye' tö kápi ya'	TYPE:NEG, TENSE:IPFV_PROG, ASPECT:IPFV	Ye' kë̀ ku̠ kápi yök
Bribri0256	Ye' tö kápi ya'	TENSE:PRF_PROG	Ye' bák kápi yök
Bribri0257	Ye' tö kápi ya'	TYPE:NEG, TENSE:PRF_PROG	Ye' kë̀ ku̠'bak kápi yök
Bribri0258	Ye' tö kápi ya'	TENSE:PRF_REC	Ye' kápi yé
Bribri0259	Ye' tö kápi ya'	TYPE:NEG, TENSE:PRF_REC	Ye' kë̀ wa̠ kápi ya̠
Bribri0260	Ye' tö kápi ya'	TENSE:IPFV_REC, ASPECT:IPFV	Ye' tö kápi yè
Bribri0261	Ye' tö kápi ya'	TYPE:NEG, TENSE:IPFV_REC, ASPECT:IPFV	Kë̀ ye' tö kápi ye
Bribri0262	Ye' tö kápi ya'	TENSE:IPFV_HAB, ASPECT:IPFV	Ye' tö kápi yèke
Bribri0263	Ye' tö kápi ya'	TYPE:NEG, TENSE:IPFV_HAB, ASPECT:IPFV	Kë̀ ye' tö kápi yèku
Bribri0264	Ye' tö kápi ya'	TENSE:FUT_CER, ASPECT:IPFV	Ye' tö kápi yarâ
Bribri0265	Ye' tö kápi ya'	TYPE:NEG, TENSE:FUT_CER, ASPECT:IPFV	Kë̀ ye' tö kápi yapa
Bribri0266	Ye' tö kápi ya'	VOICE:MID, PERSON:NA	Kápi yáne̠
Bribri0267	Ye' tö kápi ya'	TYPE:NEG, VOICE:MID, PERSON:NA	Kë̀ kápi yáne̠
Bribri0268	Ye' tö kápi ya'	TENSE:PRF_REC, VOICE:MID, PERSON:NA	Kápi yána̠
Bribri0269	Ye' tö kápi ya'	TYPE:NEG, TENSE:PRF_REC, VOICE:MID, PERSON:NA	Kë̀ kápi yáne̠
Bribri0270	Ye' tö kápi ya'	TENSE:IPFV_REC, ASPECT:IPFV, VOICE:MID, PERSON:NA	Kápi yár
Bribri0271	Ye' tö kápi ya'	TYPE:NEG, TENSE:IPFV_REC, ASPECT:IPFV, VOICE:MID, PERSON:NA	Kë̀ kápi yar
Bribri0272	Ye' tö kápi ya'	TENSE:IPFV_HAB, ASPECT:IPFV, VOICE:MID, PERSON:NA	Kápi yárke̠
Bribri0273	Ye' tö kápi ya'	TYPE:NEG, TENSE:IPFV_HAB, ASPECT:IPFV, VOICE:MID, PERSON:NA	Kë̀ kápi yárku̠
Bribri0274	Ye' tö kápi ya'	MODE:IMP, TENSE:IPFV_REC, ASPECT:IPFV, PERSON:NA	Kápi yáu̠
Bribri0275	Ye' tö kápi ya'	TYPE:NEG, MODE:IMP, TENSE:IPFV_REC, ASPECT:IPFV, PERSON:NA	Kë̀ kápi yau̠k
Bribri0276	Ye' tö kápi ya'	MODE:DES, TENSE:IPFV_REC, ASPECT:IPFV	Ye' é̠n a̠ kápi yawa'ku̠
Bribri0277	Ye' tö kápi ya'	MODE:DES, TENSE:IPFV_REC, ASPECT:IPFV, VOICE:MID, PERSON:NA	Kë̀ ye' é̠n a̠ kápi yawa'ku̠
Bribri0278	Ye' tö kápi ya'	TENSE:FUT_POT, ASPECT:IPFV	Ye' tö kápi yami̠
Bribri0279	Ye' tö kápi ya'	TYPE:NEG, TENSE:FUT_POT, ASPECT:IPFV	Kë̀ ye' tö kápi yök
Bribri0280	Ye' tö kápi ya'	TENSE:FUT_POT, ASPECT:IPFV, VOICE:MID, PERSON:NA	Kápi yármi̠
Bribri0281	Ye' tö kápi ya'	TYPE:NEG, TENSE:FUT_POT, ASPECT:IPFV, VOICE:MID, PERSON:NA	Kë̀ kápi yánu̠k
Bribri0282	Ye' tö kápi ya'	MODE:ADVERS, VOICE:MID, PERSON:NA	Kápi yáwa̠r
Bribri0283	Ye' tö kápi ya'	TENSE:PAS_PLU	Ye' wa̠ kápi yárule
Bribri0284	Ye' tö kápi ya'	TYPE:NEG, TENSE:PAS_PLU	Ye' kë̀ wa̠ kápi ya̠rule
Bribri0989	Ye' úk	TYPE:NEG	Ye' kë̀ úkne̠
Bribri0990	Ye' úk	PERSON:2_SI	Be' úk
Bribri0991	Ye' úk	TYPE:NEG, PERSON:2_SI	Kë̀ be' úk
Bribri0992	Ye' úk	TENSE:IPFV_REC, ASPECT:IPFV	Ye' úkö̀
Bribri0993	Ye' úk	TENSE:IPFV_PROG, ASPECT:IPFV	Ye' tso úkö́k
Bribri0994	Ye' úk	TYPE:NEG, TENSE:IPFV_PROG, ASPECT:IPFV	Ye' kë̀ ku̠ úkö́k
Bribri0995	Ye' úk	TENSE:PRF_PROG	Ye' bák úkö́k
Bribri0996	Ye' úk	TYPE:NEG, TENSE:PRF_PROG	Ye' kë̀ ku̠'bak úkö́k
Bribri0997	Ye' úk	MODE:IMP, TENSE:IPFV_REC, ASPECT:IPFV, PERSON:2_SI	Be' úkö́
Bribri0998	Ye' úk	TENSE:IPFV_HAB, ASPECT:IPFV	Ye' úkö̀ke̠
Bribri0999	Ye' úk	VOICE:MID, ABSNUM:NI, PERSON:NA	Úkne̠
Bribri1000	Ye' úk	TYPE:NEG, VOICE:MID, ABSNUM:NI, PERSON:NA	Kë̀ úkne̠
Bribri1001	Ye' úk	TENSE:IPFV_REC, ASPECT:IPFV, VOICE:MID, ABSNUM:NI, PERSON:NA	Úkö̀r
Bribri0869	Ka̠no̠' te̠n ká̠u̠k a̠	TYPE:NEG	Ka̠no̠' kë̀ ku̠ te̠n ká̠u̠k a̠
Bribri0870	Ka̠no̠' te̠n ká̠u̠k a̠	TENSE:PRF_REM, ASPECT:PFV	Ka̠no̠' bák te̠n ká̠u̠k a̠
Bribri0871	Ka̠no̠' te̠n ká̠u̠k a̠	TYPE:NEG, TENSE:PRF_REM, ASPECT:PFV	Ka̠no̠' kë̀ ku̠'bak te̠n ká̠u̠k a̠
Bribri0872	Ka̠no̠' te̠n ká̠u̠k a̠	ABSNUM:PL	Ka̠no̠' dapárke te̠n ká̠u̠k a̠
Bribri0873	Ka̠no̠' te̠n ká̠u̠k a̠	TYPE:NEG, ABSNUM:PL	Ka̠no̠' kë̀ ku̠ dapárke te̠n ká̠u̠k a̠
Bribri0874	Ka̠no̠' te̠n ká̠u̠k a̠	TENSE:PRF_REM, ASPECT:PFV, ABSNUM:PL	Ka̠no̠' bák dapárke te̠n ká̠u̠k a̠
Bribri0875	Ka̠no̠' te̠n ká̠u̠k a̠	TYPE:NEG, TENSE:PRF_REM, ASPECT:PFV, ABSNUM:PL	Ka̠no̠' kë̀ ku̠'bak dapárke ká̠u̠k a̠
Bribri0001	Ie' tso bua'	TYPE:NEG	Ie' kë̀ wa̠ bua'
Bribri0002	Ie' tso bua'	TENSE:PRF_REM, ASPECT:PFV	Ie' bák bua'
Bribri0003	Ie' tso bua'	TYPE:NEG, TENSE:PRF_REM, ASPECT:PFV	Ie' kë̀ ku̠'bak bua'
Bribri0004	Ie' tso bua'	PERSON:1_SI	Sa' tso bua'
Bribri0005	Ie' tso bua'	TYPE:NEG, PERSON:1_SI	Sa' kë̀ wa̠ bua'
Bribri0006	Ie' tso bua'	TENSE:PRF_REM, ASPECT:PFV, PERSON:1_SI	Sa' bák bua'
Bribri0007	Ie' tso bua'	TYPE:NEG, TENSE:PRF_REM, ASPECT:PFV, PERSON:1_SI	Sa' kë̀ ku̠'bak bua'
Bribri0008	Ie' tso bua'	PERSON:2_SI	Be' tso bua'
Bribri0009	Ie' tso bua'	TYPE:NEG, PERSON:2_SI	Be' kë̀ wa̠ bua'
Bribri0010	Ie' tso bua'	TENSE:PRF_REM, ASPECT:PFV, PERSON:2_SI	Be' bák bua'
Bribri0011	Ie' tso bua'	TYPE:NEG, TENSE:PRF_REM, ASPECT:PFV, PERSON:2_SI	Be' kë̀ ku̠'bak bua'
Bribri0012	Ie' tso bua'	ABSNUM:PL, PERSON:1_PL_EXC	Sa' tso bua'
Bribri0013	Ie' tso bua'	TYPE:NEG, ABSNUM:PL, PERSON:1_PL_EXC	Sa' kë̀ wa̠ bua'
Bribri0014	Ie' tso bua'	TENSE:PRF_REM, ASPECT:PFV, ABSNUM:PL, PERSON:1_PL_EXC	Sa' bák bua'
Bribri0015	Ie' tso bua'	TYPE:NEG, TENSE:PRF_REM, ASPECT:PFV, ABSNUM:PL, PERSON:1_PL_EXC	Sa' kë̀ ku̠'bak bua'
Bribri0016	Ie' tso bua'	ABSNUM:PL, PERSON:1_PL_INC	Se' tso bua'
Bribri0017	Ie' tso bua'	TYPE:NEG, ABSNUM:PL, PERSON:1_PL_INC	Se' kë̀ wa̠ bua'
Bribri0018	Ie' tso bua'	TENSE:PRF_REM, ASPECT:PFV, ABSNUM:PL, PERSON:1_PL_INC	Se' bák bua'
Bribri0019	Ie' tso bua'	TYPE:NEG, TENSE:PRF_REM, ASPECT:PFV, ABSNUM:PL, PERSON:1_PL_INC	Se' kë̀ ku̠'bak bua'
Bribri0020	Ie' tso bua'	ABSNUM:PL, PERSON:2_PL	A' tso bua'
Bribri0021	Ie' tso bua'	TYPE:NEG, ABSNUM:PL, PERSON:2_PL	A' kë̀ ku̠ bua'
Bribri0022	Ie' tso bua'	TENSE:PRF_REM, ASPECT:PFV, ABSNUM:PL, PERSON:2_PL	A' bák bua'
Bribri0023	Ie' tso bua'	TYPE:NEG, TENSE:PRF_REM, ASPECT:PFV, ABSNUM:PL, PERSON:2_PL	A' kë̀ ku̠'bak bua'
Bribri0024	Ie' tso bua'	ABSNUM:PL, PERSON:3_PL	Ie'pa tso bua'
Bribri0025	Ie' tso bua'	TYPE:NEG, ABSNUM:PL, PERSON:3_PL	Ie'pa kë̀ ku̠ bua'
Bribri0026	Ie' tso bua'	TENSE:PRF_REM, ASPECT:PFV, ABSNUM:PL, PERSON:3_PL	Ie'pa bák bua'
Bribri0027	Ie' tso bua'	TYPE:NEG, TENSE:PRF_REM, ASPECT:PFV, ABSNUM:PL, PERSON:3_PL	Ie'pa kë̀ ku̠'bak bua'
Bribri0464	Ye' tö uyë̀jkuö à̠ríts	TENSE:IPFV_PROG, ASPECT:IPFV, PERSON:3_SI	Ie' tso uyë̀jkuö à̠rítsk
Bribri0465	Ye' tö uyë̀jkuö à̠ríts	TENSE:IPFV_REC, ASPECT:IPFV	Ye' tö uyë̀jkuö à̠rítske
Bribri0466	Ye' tö uyë̀jkuö à̠ríts	TYPE:NEG, TENSE:IPFV_REC, ASPECT:IPFV	Kë̀ ye' tö uyë̀jkuö à̠rítske
Bribri0467	Ye' tö uyë̀jkuö à̠ríts	MODE:POT, TENSE:IPFV_REC, ASPECT:IPFV, PERSON:3_SI	Ie' uyë̀jkuö à̠rítskó
Bribri0468	Ye' tö uyë̀jkuö à̠ríts	TYPE:NEG, MODE:POT, TENSE:IPFV_REC, ASPECT:IPFV, PERSON:3_SI	Kë̀ ie' uyë̀jkuö à̠rítsko
Bribri0388	Chìchi dör tsîr	ABSNUM:PL	Chìchi dapárke tsîr
Bribri0848	Dù tkër kàl ulà ki̠	TYPE:NEG	Dù kë̀ wa̠ kàl ulà ki̠
Bribri0849	Dù tkër kàl ulà ki̠	TENSE:PRF_REM, ASPECT:PFV	Dù bák kàl ulà ki̠
Bribri0850	Dù tkër kàl ulà ki̠	TYPE:NEG, TENSE:PRF_REM, ASPECT:PFV	Dù kë̀ ku̠'bak kàl ulà ki̠
Bribri0851	Dù tkër kàl ulà ki̠	ABSNUM:PL	Dù dapárke kàl ulà ki̠
Bribri0852	Dù tkër kàl ulà ki̠	TYPE:NEG, ABSNUM:PL	Dù kë̀ ku̠ dapárke kàl ulà ki̠
Bribri0853	Dù tkër kàl ulà ki̠	TENSE:PRF_REM, ASPECT:PFV, ABSNUM:PL	Dù bák dapárke kàl ulà ki̠
Bribri0854	Dù tkër kàl ulà ki̠	TYPE:NEG, TENSE:PRF_REM, ASPECT:PFV, ABSNUM:PL	Dù kë̀ ku̠'bak dapárke kàl ulà ki̠
Bribri0028	Ye' i̠ni̠'	PERSON:3_SI	Ie' i̠ni̠'
Bribri0029	Ye' i̠ni̠'	PERSON:2_SI	Be' i̠ni̠'
Bribri0030	Ye' i̠ni̠'	ABSNUM:PL, PERSON:1_PL_EXC	Sa' i̠ni̠'
Bribri0031	Ye' i̠ni̠'	ABSNUM:PL, PERSON:1_PL_INC	Se' i̠ni̠'
Bribri0032	Ye' i̠ni̠'	ABSNUM:PL, PERSON:2_PL	A' i̠ni̠'
Bribri0033	Ye' i̠ni̠'	ABSNUM:PL, PERSON:3_PL	Ie'pa i̠ni̠'
Bribri0034	Ye' i̠ni̠'	TENSE:PRF_REC, PERSON:3_SI	Ie' i̠né
Bribri0035	Ye' i̠ni̠'	TENSE:PRF_REC	Ye' i̠né
Bribri0036	Ye' i̠ni̠'	TENSE:PRF_REC, PERSON:2_SI	Be' i̠né
Bribri0037	Ye' i̠ni̠'	TENSE:PRF_REC, ABSNUM:PL, PERSON:1_PL_EXC	Sa' i̠né
Bribri0038	Ye' i̠ni̠'	TENSE:PRF_REC, ABSNUM:PL, PERSON:1_PL_INC	Se' i̠né
Bribri0039	Ye' i̠ni̠'	TENSE:PRF_REC, ABSNUM:PL, PERSON:2_PL	A' i̠né
Bribri0040	Ye' i̠ni̠'	TENSE:PRF_REC, ABSNUM:PL, PERSON:3_PL	Ie'pa i̠né
Bribri0041	Ye' i̠ni̠'	TENSE:IPFV_REC, ASPECT:IPFV, PERSON:3_SI	Ie' i̠nö̀
Bribri0042	Ye' i̠ni̠'	TENSE:IPFV_REC, ASPECT:IPFV	Ye' i̠nö̀
Bribri0043	Ye' i̠ni̠'	TENSE:IPFV_HAB, ASPECT:IPFV, PERSON:3_SI	Ie' i̠nö̀ke̠
Bribri0044	Ye' i̠ni̠'	TENSE:IPFV_HAB, ASPECT:IPFV	Ye' i̠nö̀ke̠
Bribri0045	Ye' i̠ni̠'	TYPE:NEG, TENSE:IPFV_HAB, ASPECT:IPFV	Kë̀ ye' i̠nö̀ku̠
Bribri0046	Ye' i̠ni̠'	TENSE:IPFV_REC, ASPECT:IPFV, VOICE:MID, ABSNUM:NI, PERSON:NA	I̠nör
Bribri0047	Ye' i̠ni̠'	VOICE:MID, ABSNUM:NI, PERSON:NA	I̠ni̠'ne̠
Bribri0048	Ye' i̠ni̠'	TYPE:NEG, VOICE:MID	Kë̀ i̠ni̠'ne̠
Bribri0049	Ye' i̠ni̠'	TENSE:FUT_CER, ASPECT:IPFV	Ye' i̠ni̠'râ
Bribri0050	Ye' i̠ni̠'	TYPE:NEG, TENSE:FUT_CER, ASPECT:IPFV	Kë̀ ye' i̠ni̠'pa
Bribri0051	Ye' i̠ni̠'	TENSE:IPFV_PROG, ASPECT:IPFV	Ye' tso i̠ni̠'k
Bribri0052	Ye' i̠ni̠'	TYPE:NEG, TENSE:IPFV_REC, ASPECT:IPFV	Kë̀ ye' i̠ni̠'k
Bribri0053	Ye' i̠ni̠'	TENSE:PAS_PLU	Ye' wa̠ i̠ni̠'rule
Bribri0054	Ye' i̠ni̠'	TYPE:NEG, TENSE:PAS_PLU	Ye' kë̀ wa̠ i̠ni̠'rule
Bribri0055	Ye' i̠ni̠'	TENSE:FUT_POT, ASPECT:IPFV	Ye' i̠ni̠'mi̠
Bribri0056	Ye' i̠ni̠'	TYPE:NEG, TENSE:FUT_POT, ASPECT:IPFV	Kë̀ ye' i̠ni̠'k
Bribri0057	Ye' i̠ni̠'	MODE:DES, TENSE:IPFV_REC, ASPECT:IPFV, PERSON:3_SI	Ie' é̠n a̠ i̠ni̠'ku̠
Bribri0058	Ye' i̠ni̠'	MODE:EXH, TENSE:IPFV_REC, ASPECT:IPFV, ABSNUM:PL, PERSON:1_PL_INC	Se' i̠ni̠'ku̠ sö
Bribri0059	Ye' i̠ni̠'	MODE:IMP, TENSE:IPFV_REC, ASPECT:IPFV, PERSON:2_SI	Be' i̠ni̠'k
Bribri0060	Ye' i̠ni̠'	TYPE:NEG, MODE:IMP, TENSE:IPFV_REC, ASPECT:IPFV, PERSON:2_SI	Kë̀ be' i̠ni̠'k
Bribri0061	Ye' i̠ni̠'	MODE:POT, TENSE:IPFV_REC, ASPECT:IPFV, PERSON:3_SI	Ie' i̠ni̠'k
Bribri0062	Ye' i̠ni̠'	TYPE:NEG, MODE:POT, TENSE:IPFV_REC, ASPECT:IPFV, PERSON:3_SI	Kë̀ ie' i̠ni̠'k
Bribri0883	Ie' tkër kula' ki̠	TYPE:NEG	Ie' kë̀ wa̠ kula' ki̠
Bribri0884	Ie' tkër kula' ki̠	TENSE:PRF_REM, ASPECT:PFV	Ie' bák kula' ki̠
Bribri0885	Ie' tkër kula' ki̠	TYPE:NEG, TENSE:PRF_REM, ASPECT:PFV	Ie' kë̀ ku̠'bak kula' ki̠
Bribri0886	Ie' tkër kula' ki̠	ABSNUM:PL, PERSON:3_PL	Ie'pa kula' ki̠
Bribri0887	Ie' tkër kula' ki̠	TYPE:NEG, ABSNUM:PL, PERSON:3_PL	Ie'pa kë̀ ku̠ tkër kula' ki̠
Bribri0888	Ie' tkër kula' ki̠	TENSE:PRF_REM, ASPECT:PFV, ABSNUM:PL, PERSON:3_PL	Ie'pa bák tkër kula' ki̠
Bribri0889	Ie' tkër kula' ki̠	TYPE:NEG, TENSE:PRF_REM, ASPECT:PFV, ABSNUM:PL, PERSON:3_PL	Ie'pa kë̀ ku̠'bak tkër kula' ki̠
Bribri0141	Be' chka'	TENSE:IPFV_PROG, ASPECT:IPFV	Be' tso chkö́k
Bribri0142	Be' chka'	TYPE:NEG, TENSE:IPFV_PROG, ASPECT:IPFV	Be' kë̀ ku̠ chkö́k
Bribri0143	Be' chka'	MODE:IMP, TENSE:IPFV_REC, ASPECT:IPFV	Chka̠r
Bribri0144	Be' chka'	TYPE:NEG, MODE:IMP, TENSE:IPFV_REC, ASPECT:IPFV	Kë̀ chka̠r
Bribri0248	Ye' tö i stsë'	TENSE:IPFV_REC, ASPECT:IPFV, VOICE:MID, PERSON:3_SI	I stsër
Bribri0249	Ye' tö i stsë'	TENSE:IPFV_HAB, ASPECT:IPFV, VOICE:MID, PERSON:3_SI	I stsërke̠
Bribri0250	Ye' tö i stsë'	TYPE:NEG, TENSE:IPFV_HAB, ASPECT:IPFV, VOICE:MID, PERSON:3_SI	Kë̀ i stsërku̠
Bribri0251	Ye' tö i stsë'	TENSE:FUT_POT, ASPECT:IPFV, VOICE:MID, PERSON:3_SI	I stsërmi̠
Bribri0252	Ye' tö i stsë'	TYPE:NEG, TENSE:FUT_POT, ASPECT:IPFV, VOICE:MID, PERSON:3_SI	Kë̀ i stsërnu̠k
Bribri0385	Ie' e̠' tkë'wa̠	ABSNUM:PL, PERSON:3_PL	Ie'pa e̠' tkë'wa̠
Bribri0521	Kirë̀ tö tabè a̠me̠' ie' a̠	TYPE:NEG	Kirë̀ kë̀ wa̠ tabè a̠me̠' ie' a̠
Bribri0522	Kirë̀ tö tabè a̠me̠' ie' a̠	ASPECT:INC	Kirë̀ tö tabè a̠me̠' ie' a̠mi̠
Bribri0523	Kirë̀ tö tabè a̠me̠' ie' a̠	TENSE:PRF_REC	Kirë̀ tö tabè a̠me̠' ie' a̠wé̠
Bribri0524	Kirë̀ tö tabè a̠me̠' ie' a̠	TYPE:NEG, TENSE:PRF_REC	Kirë̀ kë̀ wa̠ tabè a̠me̠' ie' a̠wé̠ne̠
Bribri0525	Kirë̀ tö tabè a̠me̠' ie' a̠	TENSE:PRF_REC, ASPECT:INC	Kirë̀ tö tabè a̠me̠' ie' a̠wé̠mi̠
Bribri0526	Kirë̀ tö tabè a̠me̠' ie' a̠	TENSE:IPFV_REC, ASPECT:IPFV	Kirë̀ tö tabè a̠me̠' ie' a̠wè̠
Bribri0527	Kirë̀ tö tabè a̠me̠' ie' a̠	TYPE:NEG, TENSE:IPFV_REC, ASPECT:IPFV	Kë̀ kirë̀ tö tabè a̠me̠' ie' a̠we̠
Bribri0528	Kirë̀ tö tabè a̠me̠' ie' a̠	TENSE:IPFV_PROG, ASPECT:IPFV	Kirë̀ tso tabè a̠me̠' ie' a̠
Bribri0529	Kirë̀ tö tabè a̠me̠' ie' a̠	TYPE:NEG, TENSE:IPFV_PROG, ASPECT:IPFV	Kirë̀ kë̀ ku̠ tabè a̠me̠' ie' a̠
Bribri0530	Kirë̀ tö tabè a̠me̠' ie' a̠	TENSE:PRF_PROG	Kirë̀ bák tabè a̠me̠' ie' a̠
Bribri0531	Kirë̀ tö tabè a̠me̠' ie' a̠	TYPE:NEG, TENSE:PRF_PROG	Kirë̀ kë̀ ku̠'bak tabè a̠me̠' ie' a̠
Bribri0532	Kirë̀ tö tabè a̠me̠' ie' a̠	MODE:IMP, TENSE:IPFV_REC, ASPECT:IPFV	Tabè a̠me̠' ie' a̠
Bribri0533	Kirë̀ tö tabè a̠me̠' ie' a̠	TYPE:NEG, MODE:IMP, TENSE:IPFV_REC, ASPECT:IPFV	Kë̀ tabè a̠me̠' ie' a̠
Bribri0534	Kirë̀ tö tabè a̠me̠' ie' a̠	TYPE:NEG, MODE:IMP, TENSE:IPFV_REC, ASPECT:IPFV, VOICE:MID	Kë̀ tabè a̠me̠' ie' a̠
Bribri0535	Kirë̀ tö tabè a̠me̠' ie' a̠	MODE:EXH, TENSE:IPFV_REC, ASPECT:IPFV, PERSON:1_PL_INC	Tabè a̠me̠' ie' a̠ sö
Bribri0536	Kirë̀ tö tabè a̠me̠' ie' a̠	MODE:DES, TENSE:IPFV_REC, ASPECT:IPFV	Kirë̀ é̠n a̠ tabè a̠me̠' ie' a̠
Bribri0537	Kirë̀ tö tabè a̠me̠' ie' a̠	TYPE:NEG, MODE:DES, TENSE:IPFV_REC, ASPECT:IPFV	Kë̀ kirë̀ é̠n a̠ tabè a̠me̠' ie' a̠
Bribri0538	Kirë̀ tö tabè a̠me̠' ie' a̠	MODE:ADVERS	Kirë̀ wa̠ tabè a̠me̠' ie' a̠
Bribri0539	Kirë̀ tö tabè a̠me̠' ie' a̠	TENSE:IPFV_HAB, ASPECT:IPFV	Kirë̀ tö tabè a̠me̠' ie' a̠ke
Bribri0540	Kirë̀ tö tabè a̠me̠' ie' a̠	TYPE:NEG, TENSE:IPFV_HAB, ASPECT:IPFV	Kë̀ kirë̀ tö tabè a̠me̠' ie' a̠ku̠
Bribri0541	Kirë̀ tö tabè a̠me̠' ie' a̠	TENSE:FUT_POT, ASPECT:IPFV	Kirë̀ tö tabè a̠me̠' ie' a̠mi̠
Bribri0542	Kirë̀ tö tabè a̠me̠' ie' a̠	TYPE:NEG, TENSE:FUT_POT, ASPECT:IPFV	Kë̀ kirë̀ tö tabè a̠me̠' ie' a̠k
Bribri0543	Kirë̀ tö tabè a̠me̠' ie' a̠	TENSE:FUT_CER, ASPECT:IPFV	Kirë̀ tö tabè a̠me̠' ie' a̠râ
Bribri0544	Kirë̀ tö tabè a̠me̠' ie' a̠	TYPE:NEG, TENSE:FUT_CER, ASPECT:IPFV	Kë̀ kirë̀ tö tabè a̠me̠' ie' a̠pa
Bribri0545	Kirë̀ tö tabè a̠me̠' ie' a̠	VOICE:MID	Tabè a̠me̠' ie' a̠ne̠
Bribri0546	Kirë̀ tö tabè a̠me̠' ie' a̠	TYPE:NEG, VOICE:MID	Kë̀ tabè a̠me̠' ie' a̠ne̠
Bribri0547	Kirë̀ tö tabè a̠me̠' ie' a̠	TENSE:PRF_REC, VOICE:MID	Tabè a̠me̠' ie' a̠na̠
Bribri0548	Kirë̀ tö tabè a̠me̠' ie' a̠	TYPE:NEG, TENSE:PRF_REC, VOICE:MID	Kë̀ tabè a̠me̠' ie' a̠ne̠
Bribri0549	Kirë̀ tö tabè a̠me̠' ie' a̠	TENSE:IPFV_REC, ASPECT:IPFV, VOICE:MID	Tabè a̠me̠' ie' a̠r
Bribri0550	Kirë̀ tö tabè a̠me̠' ie' a̠	TYPE:NEG, TENSE:IPFV_REC, ASPECT:IPFV, VOICE:MID	Kë̀ tabè a̠me̠' ie' a̠r
Bribri0551	Kirë̀ tö tabè a̠me̠' ie' a̠	TENSE:IPFV_HAB, ASPECT:IPFV, VOICE:MID	Tabè a̠me̠' ie' a̠rke̠
Bribri0552	Kirë̀ tö tabè a̠me̠' ie' a̠	TYPE:NEG, TENSE:IPFV_HAB, ASPECT:IPFV, VOICE:MID	Kë̀ tabè a̠me̠' ie' a̠rku̠
Bribri0553	Kirë̀ tö tabè a̠me̠' ie' a̠	TENSE:FUT_POT, ASPECT:IPFV, VOICE:MID	Tabè a̠me̠' ie' a̠rmi̠
Bribri0554	Kirë̀ tö tabè a̠me̠' ie' a̠	TYPE:NEG, TENSE:FUT_POT, ASPECT:IPFV, VOICE:MID	Kë̀ tabè a̠me̠' ie' a̠nu̠k
Bribri0555	Kirë̀ tö tabè a̠me̠' ie' a̠	TENSE:FUT_CER, ASPECT:IPFV, VOICE:MID	Tabè a̠me̠' ie' a̠rdâ
Bribri0556	Kirë̀ tö tabè a̠me̠' ie' a̠	TYPE:NEG, TENSE:FUT_CER, ASPECT:IPFV, VOICE:MID	Kë̀ tabè a̠me̠' ie' a̠rpa
Bribri0557	Kirë̀ tö tabè a̠me̠' ie' a̠	TENSE:PAS_PLU, VOICE:MID	Tabè a̠me̠' ie' a̠rule
Bribri0558	Kirë̀ tö tabè a̠me̠' ie' a̠	TYPE:NEG, TENSE:PAS_PLU, VOICE:MID	Kë̀ tabè a̠me̠' ie' a̠rule
Bribri0559	Kirë̀ tö tabè a̠me̠' ie' a̠	MODE:POT, TENSE:IPFV_REC, ASPECT:IPFV	Tabè a̠me̠' ie' a̠r
Bribri0560	Kirë̀ tö tabè a̠me̠' ie' a̠	TYPE:NEG, MODE:POT, TENSE:IPFV_REC, ASPECT:IPFV	Kë̀ tabè a̠me̠' ie' a̠r
Bribri0392	Ye' tö uyë̀jkuö à̠ritsè bua'ë	TYPE:NEG	Ye' kë̀ wa̠ uyë̀jkuö à̠ritsè bua'ë
Bribri0389	Aláköl a̠wì̠ dör buáala	ABSNUM:PL	Aláköl dapárke a̠wì̠ dör buáala
Bribri0906	Alà mì̠ne̠ i ma̠u̠k	ABSNUM:PL	Alà dapárke mì̠ne̠ i ma̠u̠k
Bribri0907	Alà mì̠ne̠ i ma̠u̠k	TYPE:NEG	Alà kë̀ wa̠ mì̠ne̠ i ma̠u̠k
Bribri0908	Alà mì̠ne̠ i ma̠u̠k	TYPE:NEG, ABSNUM:PL	Alà kë̀ ku̠ dapárke mì̠ne̠ i ma̠u̠k
Bribri0909	Alà mì̠ne̠ i ma̠u̠k	TENSE:PRF_REC	Alà mì̠ne̠ i ma̠wé̠k
Bribri0910	Alà mì̠ne̠ i ma̠u̠k	TENSE:PRF_REC, ABSNUM:PL	Alà dapárke mì̠ne̠ i ma̠wé̠k
Bribri0911	Alà mì̠ne̠ i ma̠u̠k	TENSE:IPFV_REC, ASPECT:IPFV	Alà mì̠ne̠ i ma̠u̠kè
Bribri0912	Alà mì̠ne̠ i ma̠u̠k	TENSE:IPFV_REC, ASPECT:IPFV, ABSNUM:PL	Alà dapárke mì̠ne̠ i ma̠u̠kè
Bribri0913	Alà mì̠ne̠ i ma̠u̠k	TENSE:IPFV_PROG, ASPECT:IPFV	Alà tso mì̠ne̠ i ma̠u̠k
Bribri0914	Alà mì̠ne̠ i ma̠u̠k	TYPE:NEG, TENSE:IPFV_PROG, ASPECT:IPFV	Alà kë̀ ku̠ mì̠ne̠ i ma̠u̠k
Bribri0915	Alà mì̠ne̠ i ma̠u̠k	TENSE:PRF_PROG	Alà bák mì̠ne̠ i ma̠u̠k
Bribri0916	Alà mì̠ne̠ i ma̠u̠k	TYPE:NEG, TENSE:PRF_PROG	Alà kë̀ ku̠'bak mì̠ne̠ i ma̠u̠k
Bribri0917	Alà mì̠ne̠ i ma̠u̠k	TENSE:IPFV_PROG, ASPECT:IPFV, ABSNUM:PL	Alà dapárke tso mì̠ne̠ i ma̠u̠k
Bribri0918	Alà mì̠ne̠ i ma̠u̠k	TYPE:NEG, TENSE:IPFV_PROG, ASPECT:IPFV, ABSNUM:PL	Alà kë̀ ku̠ dapárke mì̠ne̠ i ma̠u̠k
Bribri0919	Alà mì̠ne̠ i ma̠u̠k	TENSE:PRF_PROG, ABSNUM:PL	Alà bák dapárke mì̠ne̠ i ma̠u̠k
Bribri0920	Alà mì̠ne̠ i ma̠u̠k	TYPE:NEG, TENSE:PRF_PROG, ABSNUM:PL	Alà kë̀ ku̠'bak dapárke mì̠ne̠ i ma̠u̠k
Bribri0393	Awá tsë'	TENSE:PRF_REC	Awá tsé
Bribri0145	Ie' tö àrros ña̠'	ASPECT:INC	Ie' tö àrros ña̠'mi̠
Bribri0146	Ie' tö àrros ña̠'	TYPE:NEG	Ie' kë̀ wa̠ àrros ña̠'ne̠
Bribri0147	Ie' tö àrros ña̠'	TENSE:IPFV_PROG, ASPECT:IPFV	Ie' tso àrros ña̠'
Bribri0148	Ie' tö àrros ña̠'	TYPE:NEG, TENSE:IPFV_PROG, ASPECT:IPFV	Ie' kë̀ ku̠ àrros ña̠'
Bribri0149	Ie' tö àrros ña̠'	TENSE:PRF_PROG	Ie' bák àrros ña̠'
Bribri0150	Ie' tö àrros ña̠'	TYPE:NEG, TENSE:PRF_PROG	Ie' kë̀ ku̠'bak àrros ña̠'
Bribri0151	Ie' tö àrros ña̠'	TENSE:IPFV_REC, ASPECT:IPFV	Ie' tö àrros ña̠'wè
Bribri0152	Ie' tö àrros ña̠'	TYPE:NEG, TENSE:IPFV_REC, ASPECT:IPFV	Kë̀ ie' tö àrros ña̠'we
Bribri0153	Ie' tö àrros ña̠'	MODE:IMP, TENSE:IPFV_REC, ASPECT:IPFV, PERSON:NA	Àrros ña̠'u̠
Bribri0154	Ie' tö àrros ña̠'	TYPE:NEG, MODE:IMP, TENSE:IPFV_REC, ASPECT:IPFV, PERSON:NA	Kë̀ àrros ta̠u̠ ñè̠
Bribri0155	Ie' tö àrros ña̠'	TYPE:NEG, MODE:IMP, TENSE:IPFV_REC, ASPECT:IPFV, VOICE:MID, PERSON:NA	Kë̀ àrros ta̠wa̠r ñè̠
Bribri0156	Ie' tö àrros ña̠'	MODE:EXH, TENSE:IPFV_REC, ASPECT:IPFV, PERSON:1_PL_INC	Àrros ta̠ú̠ ñè̠ sö
Bribri0157	Ie' tö àrros ña̠'	MODE:DES, TENSE:IPFV_REC, ASPECT:IPFV	Ye' é̠n a̠ àrros ta̠wa̠'ku̠ ñè̠
Bribri0158	Ie' tö àrros ña̠'	TYPE:NEG, MODE:DES, TENSE:IPFV_REC, ASPECT:IPFV	Kë̀ ye' é̠n a̠ àrros ta̠wa̠'ku̠ ñè̠
Bribri0159	Ie' tö àrros ña̠'	MODE:ADVERS	Ye' wa̠ àrros ta̠wa̠' ñè̠
Bribri0160	Ie' tö àrros ña̠'	TENSE:PRF_REC	Ye' dör àrros ta̠wé̠ ñè̠
Bribri0161	Ie' tö àrros ña̠'	TENSE:PRF_REC, ASPECT:INC	Ye' dör àrros ta̠wé̠mi̠ ñè̠
Bribri0162	Ie' tö àrros ña̠'	TYPE:NEG, TENSE:PRF_REC	Ye' kë̀ wa̠ àrros tò̠ne̠ ñè̠
Bribri0163	Ie' tö àrros ña̠'	TENSE:IPFV_HAB, ASPECT:IPFV	Ye' dör àrros ta̠wè̠ke̠ ñè̠
Bribri0164	Ie' tö àrros ña̠'	TYPE:NEG, TENSE:IPFV_HAB, ASPECT:IPFV	Kë̀ ye' dör àrros ta̠wè̠ku̠ ñè̠
Bribri0165	Ie' tö àrros ña̠'	TENSE:FUT_POT, ASPECT:IPFV	Ye' dör àrros ta̠wè̠mi̠ ñè̠
Bribri0166	Ie' tö àrros ña̠'	TYPE:NEG, TENSE:FUT_POT, ASPECT:IPFV	Kë̀ ye' dör àrros ta̠u̠k ñè̠
Bribri0167	Ie' tö àrros ña̠'	TENSE:FUT_CER, ASPECT:IPFV	Ye' dör àrros ta̠wè̠râ ñè̠
Bribri0168	Ie' tö àrros ña̠'	TYPE:NEG, TENSE:FUT_CER, ASPECT:IPFV	Kë̀ ye' dör àrros ta̠wè̠pa ñè̠
Bribri0169	Ie' tö àrros ña̠'	TENSE:IPFV_REC, ASPECT:IPFV, VOICE:MID, PERSON:NA	Àrros tò̠r ñè̠
Bribri0170	Ie' tö àrros ña̠'	TYPE:NEG, TENSE:IPFV_REC, ASPECT:IPFV, VOICE:MID, PERSON:NA	Kë̀ àrros to̠r ñè̠
Bribri0171	Ie' tö àrros ña̠'	VOICE:MID, PERSON:NA	Àrros tò̠ne̠ ñè̠
Bribri0172	Ie' tö àrros ña̠'	TYPE:NEG, VOICE:MID, PERSON:NA	Kë̀ àrros tò̠ne̠ ñè̠
Bribri0173	Ie' tö àrros ña̠'	TENSE:PRF_REC, VOICE:MID, PERSON:NA	Àrros tò̠na̠ ñè̠
Bribri0174	Ie' tö àrros ña̠'	TYPE:NEG, TENSE:PRF_REC, VOICE:MID, PERSON:NA	Kë̀ ie' àrros ñàne̠
Bribri0175	Ie' tö àrros ña̠'	TENSE:IPFV_HAB, ASPECT:IPFV, VOICE:MID, PERSON:NA	Àrros ñàrke̠
Bribri0176	Ie' tö àrros ña̠'	TYPE:NEG, TENSE:IPFV_HAB, ASPECT:IPFV, VOICE:MID, PERSON:NA	Kë̀ àrros ñàrku̠
Bribri0177	Ie' tö àrros ña̠'	TENSE:FUT_POT, ASPECT:IPFV, VOICE:MID, PERSON:NA	Àrros ñàrmi̠
Bribri0178	Ie' tö àrros ña̠'	TYPE:NEG, TENSE:FUT_POT, ASPECT:IPFV, VOICE:MID, PERSON:NA	Kë̀ àrros ñànu̠k
Bribri0179	Ie' tö àrros ña̠'	TENSE:FUT_CER, ASPECT:IPFV, VOICE:MID, PERSON:NA	Àrros ñàrdâ
Bribri0180	Ie' tö àrros ña̠'	TYPE:NEG, TENSE:FUT_CER, ASPECT:IPFV, VOICE:MID, PERSON:NA	Kë̀ àrros ñàrpa
Bribri0181	Ie' tö àrros ña̠'	TENSE:PAS_PLU	Ie' wa̠ àrros ñàrule
Bribri0182	Ie' tö àrros ña̠'	TYPE:NEG, TENSE:PAS_PLU	Ie' kë̀ wa̠ àrros ñàrule
Bribri0183	Ie' tö àrros ña̠'	TENSE:PAS_PLU, VOICE:MID, PERSON:NA	Àrros ñàrule
Bribri0184	Ie' tö àrros ña̠'	TYPE:NEG, TENSE:PAS_PLU, VOICE:MID, PERSON:NA	Kë̀ àrros ñàrule
Bribri0288	Skuë̀ ta̠'	TENSE:PRF_REM, ASPECT:PFV	Skuë̀ bák ta̠'
Bribri0097	Ye' tú̠ne̠'	TYPE:NEG	Ye' kë̀ tú̠ne̠'
Bribri0098	Ye' tú̠ne̠'	TENSE:PRF_REC	Ye' tú̠né
Bribri0099	Ye' tú̠ne̠'	TYPE:NEG, TENSE:PRF_REC	Ye' kë̀ tú̠néne̠
Bribri0100	Ye' tú̠ne̠'	TENSE:IPFV_REC, ASPECT:IPFV	Ye' tú̠nö̀
Bribri0101	Ye' tú̠ne̠'	TYPE:NEG, TENSE:IPFV_REC, ASPECT:IPFV	Kë̀ ye' tú̠nö
Bribri0102	Ye' tú̠ne̠'	TENSE:IPFV_REC, ASPECT:IPFV, PERSON:3_SI	Ie' tú̠nö̀
Bribri0103	Ye' tú̠ne̠'	TENSE:IPFV_REC, ASPECT:IPFV, ABSNUM:PL, PERSON:3_PL	Ie'pa tú̠nö̀
Bribri0104	Ye' tú̠ne̠'	TYPE:NEG, TENSE:IPFV_REC, ASPECT:IPFV, PERSON:3_SI	Kë̀ ie' tú̠nö
Bribri0105	Ye' tú̠ne̠'	TENSE:IPFV_PROG, ASPECT:IPFV	Ye' tso tú̠ne̠k
Bribri0106	Ye' tú̠ne̠'	TYPE:NEG, TENSE:IPFV_PROG, ASPECT:IPFV	Ye' kë̀ ku̠ tú̠ne̠k
Bribri0107	Ye' tú̠ne̠'	TENSE:PRF_PROG	Ye' bák tú̠ne̠k
Bribri0108	Ye' tú̠ne̠'	TYPE:NEG, TENSE:PRF_PROG	Ye' kë̀ ku̠'bak tú̠ne̠k
Bribri0109	Ye' tú̠ne̠'	MODE:IMP, TENSE:IPFV_REC, ASPECT:IPFV, PERSON:2_SI	Be' tú̠ne̠
Bribri0110	Ye' tú̠ne̠'	MODE:IMP, TENSE:IPFV_REC, ASPECT:IPFV, ABSNUM:PL, PERSON:2_PL	A' tú̠ne̠
Bribri0111	Ye' tú̠ne̠'	TYPE:NEG, MODE:IMP, TENSE:IPFV_REC, ASPECT:IPFV, PERSON:2_SI	Kë̀ be' tú̠ne̠
Bribri0112	Ye' tú̠ne̠'	TYPE:NEG, MODE:IMP, TENSE:IPFV_REC, ASPECT:IPFV, ABSNUM:PL, PERSON:2_PL	Kë̀ a' tú̠ne̠
Bribri0113	Ye' tú̠ne̠'	TENSE:IPFV_HAB, ASPECT:IPFV	Ye' tú̠ne̠ke̠
Bribri0114	Ye' tú̠ne̠'	TYPE:NEG, TENSE:IPFV_HAB, ASPECT:IPFV	Kë̀ ye' tú̠ne̠ku̠
Bribri0115	Ye' tú̠ne̠'	TENSE:FUT_POT, ASPECT:IPFV	Ye' tú̠ne̠mi̠
Bribri0116	Ye' tú̠ne̠'	TYPE:NEG, TENSE:FUT_POT, ASPECT:IPFV	Kë̀ ye' tú̠ne̠k
Bribri0117	Ye' tú̠ne̠'	TENSE:FUT_CER, ASPECT:IPFV	Ye' tú̠ne̠râ
Bribri0118	Ye' tú̠ne̠'	TYPE:NEG, TENSE:FUT_CER, ASPECT:IPFV	Kë̀ ye' tú̠ne̠pa
Bribri0119	Ye' tú̠ne̠'	VOICE:MID, ABSNUM:NI, PERSON:NA	Tú̠ne̠
Bribri0120	Ye' tú̠ne̠'	TYPE:NEG, VOICE:MID, ABSNUM:NI, PERSON:NA	Kë̀ tú̠ne̠
Bribri0121	Ye' tú̠ne̠'	TENSE:PRF_REC, VOICE:MID, ABSNUM:NI, PERSON:NA	Tú̠na̠
Bribri0122	Ye' tú̠ne̠'	TYPE:NEG, TENSE:PRF_REC, VOICE:MID, ABSNUM:NI, PERSON:NA	Kë̀ tú̠ne̠
Bribri0801	Ye' a̠mì̠ tö bö̀wö duké wö'ik	TYPE:NEG	Ye' kë̀ wa̠ a̠mì̠ tö bö̀wö duké wö'ik
Bribri0802	Ye' a̠mì̠ tö bö̀wö duké wö'ik	ASPECT:INC	Ye' a̠mì̠ tö bö̀wö duké wö'ikmi̠
Bribri0803	Ye' a̠mì̠ tö bö̀wö duké wö'ik	TENSE:PRF_REC	Ye' a̠mì̠ tö bö̀wö duké wé'ik
Bribri0804	Ye' a̠mì̠ tö bö̀wö duké wö'ik	TYPE:NEG, TENSE:PRF_REC	Ye' kë̀ wa̠ a̠mì̠ tö bö̀wö duké wé'ikne̠
Bribri0805	Ye' a̠mì̠ tö bö̀wö duké wö'ik	TENSE:PRF_REC, ASPECT:INC	Ye' a̠mì̠ tö bö̀wö duké wé'ikmi̠
Bribri0806	Ye' a̠mì̠ tö bö̀wö duké wö'ik	TENSE:IPFV_REC, ASPECT:IPFV	Ye' a̠mì̠ tö bö̀wö duké wö'ikö̀
Bribri0807	Ye' a̠mì̠ tö bö̀wö duké wö'ik	TYPE:NEG, TENSE:IPFV_REC, ASPECT:IPFV	Kë̀ ye' a̠mì̠ tö bö̀wö duké wö'ikö
Bribri0808	Ye' a̠mì̠ tö bö̀wö duké wö'ik	TENSE:IPFV_PROG, ASPECT:IPFV	Ye' tso a̠mì̠ tö bö̀wö duké wö'ikö́k
Bribri0809	Ye' a̠mì̠ tö bö̀wö duké wö'ik	TYPE:NEG, TENSE:IPFV_PROG, ASPECT:IPFV	Ye' kë̀ ku̠ a̠mì̠ tö bö̀wö duké wö'ikö́k
Bribri0810	Ye' a̠mì̠ tö bö̀wö duké wö'ik	TENSE:PRF_PROG	Ye' bák a̠mì̠ tö bö̀wö duké wö'ikö́k
Bribri0811	Ye' a̠mì̠ tö bö̀wö duké wö'ik	TYPE:NEG, TENSE:PRF_PROG	Ye' kë̀ ku̠'bak a̠mì̠ tö bö̀wö duké wö'ikö́k
Bribri0812	Ye' a̠mì̠ tö bö̀wö duké wö'ik	MODE:IMP, TENSE:IPFV_REC, ASPECT:IPFV	Duké wö'ikö́
Bribri0813	Ye' a̠mì̠ tö bö̀wö duké wö'ik	TYPE:NEG, MODE:IMP, TENSE:IPFV_REC, ASPECT:IPFV	Kë̀ duké wö'ikök
Bribri0814	Ye' a̠mì̠ tö bö̀wö duké wö'ik	TYPE:NEG, MODE:IMP, TENSE:IPFV_REC, ASPECT:IPFV, VOICE:MID	Kë̀ duké wö'ikar
Bribri0815	Ye' a̠mì̠ tö bö̀wö duké wö'ik	MODE:EXH, TENSE:IPFV_REC, ASPECT:IPFV, PERSON:1_PL_INC	Bö̀wö duké wö'ikö̀ sö
Bribri0816	Ye' a̠mì̠ tö bö̀wö duké wö'ik	MODE:DES, TENSE:IPFV_REC, ASPECT:IPFV	Ye' é̠n a̠ a̠mì̠ tö bö̀wö duké wö'ikö'ku̠
Bribri0817	Ye' a̠mì̠ tö bö̀wö duké wö'ik	TYPE:NEG, MODE:DES, TENSE:IPFV_REC, ASPECT:IPFV	Kë̀ ye' é̠n a̠ a̠mì̠ tö bö̀wö duké wö'ikö'ku̠
Bribri0818	Ye' a̠mì̠ tö bö̀wö duké wö'ik	MODE:ADVERS	Ye' wa̠ a̠mì̠ tö bö̀wö duké wö'ikö'
Bribri0819	Ye' a̠mì̠ tö bö̀wö duké wö'ik	TENSE:IPFV_HAB, ASPECT:IPFV	Ye' a̠mì̠ tö bö̀wö duké wö'ikö̀ke̠
Bribri0820	Ye' a̠mì̠ tö bö̀wö duké wö'ik	TYPE:NEG, TENSE:IPFV_HAB, ASPECT:IPFV	Kë̀ ye' a̠mì̠ tö bö̀wö duké wö'ikö̀ku̠
Bribri0821	Ye' a̠mì̠ tö bö̀wö duké wö'ik	TENSE:FUT_POT, ASPECT:IPFV	Ye' a̠mì̠ tö bö̀wö duké wö'ikö̀mi̠
Bribri0822	Ye' a̠mì̠ tö bö̀wö duké wö'ik	TYPE:NEG, TENSE:FUT_POT, ASPECT:IPFV	Kë̀ ye' a̠mì̠ tö bö̀wö duké wö'ikök
Bribri0823	Ye' a̠mì̠ tö bö̀wö duké wö'ik	TENSE:FUT_CER, ASPECT:IPFV	Ye' a̠mì̠ tö bö̀wö duké wö'ikrâ
Bribri0824	Ye' a̠mì̠ tö bö̀wö duké wö'ik	TYPE:NEG, TENSE:FUT_CER, ASPECT:IPFV	Kë̀ ye' a̠mì̠ tö bö̀wö duké wö'ikpa
Bribri0825	Ye' a̠mì̠ tö bö̀wö duké wö'ik	VOICE:MID	Duké wö'ikne̠
Bribri0826	Ye' a̠mì̠ tö bö̀wö duké wö'ik	TYPE:NEG, VOICE:MID	Kë̀ duké wö'ikne̠
Bribri0827	Ye' a̠mì̠ tö bö̀wö duké wö'ik	TENSE:PRF_REC, VOICE:MID	Duké wö'ikna̠
Bribri0828	Ye' a̠mì̠ tö bö̀wö duké wö'ik	TYPE:NEG, TENSE:PRF_REC, VOICE:MID	Kë̀ duké wö'ikne̠
Bribri0829	Ye' a̠mì̠ tö bö̀wö duké wö'ik	TENSE:IPFV_REC, ASPECT:IPFV, VOICE:MID	Duké wö'ikr
Bribri0830	Ye' a̠mì̠ tö bö̀wö duké wö'ik	TYPE:NEG, TENSE:IPFV_REC, ASPECT:IPFV, VOICE:MID	Kë̀ duké wö'ikr
Bribri0831	Ye' a̠mì̠ tö bö̀wö duké wö'ik	TENSE:IPFV_HAB, ASPECT:IPFV, VOICE:MID	Duké wö'ikrke̠
Bribri0832	Ye' a̠mì̠ tö bö̀wö duké wö'ik	TYPE:NEG, TENSE:IPFV_HAB, ASPECT:IPFV, VOICE:MID	Kë̀ duké wö'ikrku̠
Bribri0833	Ye' a̠mì̠ tö bö̀wö duké wö'ik	TENSE:FUT_POT, ASPECT:IPFV, VOICE:MID	Duké wö'ikrmi̠
Bribri0834	Ye' a̠mì̠ tö bö̀wö duké wö'ik	TYPE:NEG, TENSE:FUT_POT, ASPECT:IPFV, VOICE:MID	Kë̀ duké wö'iknu̠k
Bribri0835	Ye' a̠mì̠ tö bö̀wö duké wö'ik	TENSE:FUT_CER, ASPECT:IPFV, VOICE:MID	Duké wö'ikrdâ
Bribri0836	Ye' a̠mì̠ tö bö̀wö duké wö'ik	TYPE:NEG, TENSE:FUT_CER, ASPECT:IPFV, VOICE:MID	Kë̀ duké wö'ikrpa
Bribri0837	Ye' a̠mì̠ tö bö̀wö duké wö'ik	TENSE:PAS_PLU	Ye' wa̠ a̠mì̠ tö bö̀wö duké wö'ikrule
Bribri0838	Ye' a̠mì̠ tö bö̀wö duké wö'ik	TYPE:NEG, TENSE:PAS_PLU	Ye' kë̀ wa̠ a̠mì̠ tö bö̀wö duké wö'ikrule
Bribri0839	Ye' a̠mì̠ tö bö̀wö duké wö'ik	MODE:POT, TENSE:IPFV_REC, ASPECT:IPFV	Ye' a̠ duké wö'ikr
Bribri0840	Ye' a̠mì̠ tö bö̀wö duké wö'ik	TYPE:NEG, MODE:POT, TENSE:IPFV_REC, ASPECT:IPFV	Kë̀ ye' a̠ duké wö'ikr
Bribri0855	Mó̠köl ar ka̠nò̠ a̠	TYPE:NEG	Mó̠köl kë̀ wa̠ ka̠nò̠ a̠
Bribri0856	Mó̠köl ar ka̠nò̠ a̠	TENSE:PRF_REM, ASPECT:PFV	Mó̠köl bák ka̠nò̠ a̠
Bribri0857	Mó̠köl ar ka̠nò̠ a̠	TYPE:NEG, TENSE:PRF_REM, ASPECT:PFV	Mó̠köl kë̀ ku̠'bak ar ka̠nò̠ a̠
Bribri0858	Mó̠köl ar ka̠nò̠ a̠	ABSNUM:PL	Mó̠köl dapárke ar ka̠nò̠ a̠
Bribri0859	Mó̠köl ar ka̠nò̠ a̠	TYPE:NEG, ABSNUM:PL	Mó̠köl kë̀ ku̠ dapárke ar ka̠nò̠ a̠
Bribri0860	Mó̠köl ar ka̠nò̠ a̠	TENSE:PRF_REM, ASPECT:PFV, ABSNUM:PL	Mó̠köl bák dapárke ar ka̠nò̠ a̠
Bribri0861	Mó̠köl ar ka̠nò̠ a̠	TYPE:NEG, TENSE:PRF_REM, ASPECT:PFV, ABSNUM:PL	Mó̠köl kë̀ ku'ba̠k dapárke ar ka̠nò̠ a̠
Bribri0876	Si̠ni̠' tër í̠s ki̠	TYPE:NEG	Si̠ni̠' kë̀ wa̠ tër í̠s ki̠
Bribri0877	Si̠ni̠' tër í̠s ki̠	TENSE:PRF_REM, ASPECT:PFV	Si̠ni̠' bák tër í̠s ki̠
Bribri0878	Si̠ni̠' tër í̠s ki̠	TYPE:NEG, TENSE:PRF_REM, ASPECT:PFV	Si̠ni̠' kë̀ ku̠'bak tër í̠s ki̠
Bribri0879	Si̠ni̠' tër í̠s ki̠	ABSNUM:PL	Si̠ni̠' dapárke tër í̠s ki̠
Bribri0880	Si̠ni̠' tër í̠s ki̠	TYPE:NEG, ABSNUM:PL	Si̠ni̠' kë̀ ku̠ dapárke tër í̠s ki̠
Bribri0881	Si̠ni̠' tër í̠s ki̠	TENSE:PRF_REM, ASPECT:PFV, ABSNUM:PL	Si̠ni̠' bák dapárke tër í̠s ki̠
Bribri0882	Si̠ni̠' tër í̠s ki̠	TYPE:NEG, TENSE:PRF_REM, ASPECT:PFV, ABSNUM:PL	Si̠ni̠' kë̀ ku'ba̠k dapárke tër í̠s ki̠
Bribri0418	I dé	ABSNUM:PL, PERSON:3_PL	Ie'pa dé
Bribri0419	I dé	TENSE:PRF_REM	I bák dé
Bribri0420	I dé	TENSE:IPFV_PROG, ASPECT:IPFV	I tso dék
Bribri0421	I dé	TYPE:NEG, TENSE:IPFV_PROG, ASPECT:IPFV	I kë̀ ku̠ dék
Bribri0422	I dé	TENSE:PRF_PROG	I bák dék
Bribri0423	I dé	TYPE:NEG, TENSE:PRF_PROG	I kë̀ ku̠'bak dék
Bribri0289	I̠nú̠köl ta̠'	TENSE:PRF_REC, ASPECT:PFV	I̠nú̠köl ta̠wé̠
Bribri0290	I̠nú̠köl ta̠'	TENSE:PRF_REM, ASPECT:PFV	I̠nú̠köl bák ta̠'
