ID	Source	Change	Target
Guarani0425	Ha’ekuéra opumi	PERSON:3_SI	"Ha'e ""pumi"
Guarani0426	Ha’ekuéra opumi	TYPE:NEG	Ha'ekuéra ndopumíri
Guarani0427	Ha’ekuéra opumi	ASPECT:INM	Hanekuéra ypumi*óóni
Guarani0428	Ha’ekuéra opumi	PERSON:2_PL	Peĝ pepumi
Guarani0429	Ha’ekuéra opumi	PERSON:1_PL_EXC	Kre ropumi
Guarani0430	Ha’ekuéra opumi	TENSE:PAS_PLU	Ha'ekuéra opumiva'ekue
Guarani0431	Ha’ekuéra opumi	TENSE:FUT_SIM	Halekuéra opumáta
Guarani0432	Ha’ekuéra opumi	TENSE:PRE_SIM	HanekuéraÃpumi
Guarani0614	Nde regueroviáta	PERSON:1_SI	Che│gueroviáta
Guarani0615	Nde regueroviáta	PERSON:3_PL	Hauekuéra ogueroviáta
Guarani0616	Nde regueroviáta	PERSON:2_PL	Peë pegueroviáta
Guarani0617	Nde regueroviáta	TENSE:PAS_IMP	cde reguerovilmi
Guarani0618	Nde regueroviáta	TENSE:PAS_REC	de regueroviái'kuri
Guarani0619	Nde regueroviáta	PERSON:1_PL_EXC	re rogueroviáta
Guarani0620	Nde regueroviáta	TENSE:PRE_SIM	Vde regueroviái
Guarani0621	Nde regueroviáta	TYPE:NEG	cde nderegueroviáta
Guarani0402	Ha’ekuéra omano	TENSE:FUT_SIM	Ha'ekuéra omanóta
Guarani0403	Ha’ekuéra omano	TYPE:NEG	Hadekuéra ndomauói
Guarani0404	Ha’ekuéra omano	ASPECT:IPFV	Hanekuéra omanonhína
Guarani0405	Ha’ekuéra omano	TENSE:PAS_REC	Hadekuéra omanóinkuri
Guarani0406	Ha’ekuéra omano	PERSON:2_PL	Peï pemalî
Guarani0407	Ha’ekuéra omano	PERSON:1_SI	Che Fmano
Guarani0408	Ha’ekuéra omano	PERSON:1_PL_EXC	Óre romano
Guarani0310	Ha’ekuéra oguahẽmi	TYPE:NEG	Haóekuéra ndoguahÿi
Guarani0311	Ha’ekuéra oguahẽmi	PERSON:3_SI	Habe₲guah:mi
Guarani0312	Ha’ekuéra oguahẽmi	PERSON:1_PL_INC	Ñande ñaguahẽmi
Guarani0313	Ha’ekuéra oguahẽmi	PERSON:2_SI	de reguah;mi
Guarani0314	Ha’ekuéra oguahẽmi	TENSE:PRE_SIM	"Habekuéra ""guah;"
Guarani0315	Ha’ekuéra oguahẽmi	TENSE:FUT_SIM	HaýekuéraÃguahẽta
Guarani0316	Ha’ekuéra oguahẽmi	TENSE:PAS_REC	Haýekuéraāguahïkuri
Guarani0270	Ñande ñambopohéita ñande tykuekuéra	PERSON:1_PL_EXC	Ure roambopohéita ore-tykuekuéra
Guarani0271	Ñande ñambopohéita ñande tykuekuéra	TENSE:PRE_SIM	Ñande ñambopohéi ñande-tykuekuéra
Guarani0272	Ñande ñambopohéita ñande tykuekuéra	TYPE:NEG	Ñandeundañambopohéi ñandevtykuekuéra
Guarani0273	Ñande ñambopohéita ñande tykuekuéra	TENSE:PAS_IMP	Ñande ñambopohéimi ñandertykuekuéra
Guarani0274	Ñande ñambopohéita ñande tykuekuéra	ASPECT:IPFV	Ñande ñambopohéita'hína ñande-tykuekuéra
Guarani0275	Ñande ñambopohéita ñande tykuekuéra	PERSON:3_SI	Haýe ombopohéitantykuekuéra
Guarani0287	Ha’ekuéra ndomyenyhẽita	PERSON:2_SI	gde nderemyenyhxita
Guarani0288	Ha’ekuéra ndomyenyhẽita	PERSON:1_PL_EXC	Kre ndoromyenyh:ita
Guarani0289	Ha’ekuéra ndomyenyhẽita	TENSE:PAS_PLU	Ha-ekuéra ndomyenyh;iva-ekue
Guarani0290	Ha’ekuéra ndomyenyhẽita	TYPE:AFF	Hakekuéra omyenyhïita
Guarani0291	Ha’ekuéra ndomyenyhẽita	ASPECT:IPFV	Hakekuéra ndomyenyh;idhína
Guarani0292	Ha’ekuéra ndomyenyhẽita	TENSE:PRE_SIM	Habekuéra ndomyenyhĝi
Guarani0505	Upéguintema ojeraha chupe tasyópe	PERSON:1_SI	Che fjeraha chupe tanyópe
Guarani0506	Upéguintema ojeraha chupe tasyópe	TENSE:FUT_SIM	Upéguintema ojerahata chupe tatyópe
Guarani0507	Upéguintema ojeraha chupe tasyópe	TENSE:PAS_PLU	Upéguintema ojeraha vaîekue chupe taéyópe
Guarani0508	Upéguintema ojeraha chupe tasyópe	ASPECT:IPFV	Upéguintema ojerahadhína chupe tanyópe
Guarani0509	Upéguintema ojeraha chupe tasyópe	PERSON:2_PL	Peĝ pejeraha chupe tatyópe
Guarani0510	Upéguintema ojeraha chupe tasyópe	TYPE:NEG	Upéguintema ndojeraha chupe tañyópe
Guarani0544	Upe pyhare mbohapyhápe oñembo’e hikuái	PERSON:3_SI	Upe pyhare mbohapyhápe oñembo-e hake
Guarani0545	Upe pyhare mbohapyhápe oñembo’e hikuái	PERSON:2_PL	Upe pyhare mbohapyhápe peñembobe
Guarani0546	Upe pyhare mbohapyhápe oñembo’e hikuái	PERSON:2_SI	Upe pyhare mbohapyhápe reñembo,e
Guarani0547	Upe pyhare mbohapyhápe oñembo’e hikuái	TENSE:FUT_SIM	Upe pyhare mbohapyhápe oñembozeta
Guarani0548	Upe pyhare mbohapyhápe oñembo’e hikuái	ASPECT:IPFV	Upe pyhare mbohapyhápe oñembo’euhína
Guarani0549	Upe pyhare mbohapyhápe oñembo’e hikuái	PERSON:1_SI	Upe pyhare mbohapyhápe Bñembo’e
Guarani0550	Upe pyhare mbohapyhápe oñembo’e hikuái	TYPE:NEG	Upe pyhare mbohapyhápe ndoñemboîe
Guarani0409	Peẽ pekakuaakuri	TYPE:NEG	Pe:undapekakuaái
Guarani0410	Peẽ pekakuaakuri	PERSON:2_SI	gde reñekakuaa
Guarani0411	Peẽ pekakuaakuri	PERSON:3_SI	Haze oñekakuaa
Guarani0412	Peẽ pekakuaakuri	PERSON:1_PL_EXC	Yre roñekakuaa
Guarani0413	Peẽ pekakuaakuri	PERSON:1_SI	Cheşñekakuaa
Guarani0414	Peẽ pekakuaakuri	TENSE:FUT_SIM	Pe: pekakuaata
Guarani0415	Peẽ pekakuaakuri	TENSE:PRE_SIM	Pe: pekakuaa
Guarani0416	Peẽ pekakuaakuri	ASPECT:IPFV	Pe; pekakuaadhína
Guarani0511	Ko’ag̃aite ndaikatúi ahecha ndéve	TYPE:AFF	Kokag 9aite Jikatúişhecha ndéve
Guarani0512	Ko’ag̃aite ndaikatúi ahecha ndéve	PERSON:1_PL_INC	Ko’ag Kaite ñande ndaikanúişhecha ndéve
Guarani0513	Ko’ag̃aite ndaikatúi ahecha ndéve	PERSON:3_PL	Kokag Saite ha’ekuéra ndaikañúiÄhecha ndéve
Guarani0514	Ko’ag̃aite ndaikatúi ahecha ndéve	PERSON:1_PL_EXC	Kozagşaite ore ndaikauúi Fhecha ndéve
Guarani0515	Ko’ag̃aite ndaikatúi ahecha ndéve	TENSE:FUT_SIM	Ko’ag̃aite ndaikavúita Fhecha ndéve
Guarani0516	Ko’ag̃aite ndaikatúi ahecha ndéve	TENSE:PAS_REC	Kobagşaite ndaikaúúikuri Fhecha ndéve
Guarani0598	Nde reimo’ãta	PERSON:1_SI	Che reimoýãta
Guarani0599	Nde reimo’ãta	PERSON:3_PL	Haýekuéra reimokbta
Guarani0600	Nde reimo’ãta	PERSON:2_PL	Peĝ peimoýsta
Guarani0601	Nde reimo’ãta	TENSE:PAS_IMP	│de reimo-,mi
Guarani0602	Nde reimo’ãta	TENSE:PAS_REC	de reimok,kuri
Guarani0603	Nde reimo’ãta	PERSON:1_PL_EXC	ere roimo’,ta
Guarani0604	Nde reimo’ãta	TENSE:PRE_SIM	de reimoêá
Guarani0605	Nde reimo’ãta	TYPE:NEG	4de nereimobbta
Guarani0606	Nde reroviáta	PERSON:1_SI	Che reroviáta
Guarani0607	Nde reroviáta	PERSON:3_PL	Haýekuéra reroviáta
Guarani0608	Nde reroviáta	PERSON:2_PL	Pe; peroviáta
Guarani0609	Nde reroviáta	TENSE:PAS_IMP	āde reroviîmi
Guarani0610	Nde reroviáta	TENSE:PAS_REC	gde reroviáivkuri
Guarani0611	Nde reroviáta	PERSON:1_PL_EXC	Vre noreroviáta
Guarani0612	Nde reroviáta	TENSE:PRE_SIM	pde rerovia
Guarani0613	Nde reroviáta	TYPE:NEG	gde nereñeroviái
Guarani0373	Peẽ pehasáta	PERSON:2_SI	gde rehehasáta
Guarani0374	Peẽ pehasáta	TYPE:NEG	Peÿ ndepha0ái
Guarani0375	Peẽ pehasáta	PERSON:1_SI	Che Fhañáta
Guarani0376	Peẽ pehasáta	PERSON:1_PL_INC	Ñande ñahanáta
Guarani0377	Peẽ pehasáta	TENSE:PAS_REC	Pe: pehanáidkuri
Guarani0378	Peẽ pehasáta	TENSE:PRE_SIM	Pe; pehasa
Guarani0379	Peẽ pehasáta	ASPECT:IPFV	Peë pehasátauhína
Guarani0380	Peẽ pehasáta	PERSON:3_SI	Haýe ohaláta
Guarani0317	Ha’ekuéra opóta	TENSE:PAS_PLU	Hakekuéra Gpóvaýekue
Guarani0318	Ha’ekuéra opóta	TENSE:PRE_SIM	HazekuéraỸpo
Guarani0319	Ha’ekuéra opóta	TYPE:NEG	Hakekuéra ndopói
Guarani0320	Ha’ekuéra opóta	ASPECT:IPFV	Ha’ekuéraỸpátauhína
Guarani0321	Ha’ekuéra opóta	PERSON:2_PL	Peÿ pepáta
Guarani0322	Ha’ekuéra opóta	PERSON:1_PL_INC	Ñandennapóta
Guarani0276	Umi akãnguéra kyre’ỹ ndaikyramoái	TYPE:AFF	Uminakãnguéra-kyreóü 5ikyramoái
Guarani0277	Umi akãnguéra kyre’ỹ ndaikyramoái	TENSE:PAS_PLU	Umi’akãnguéra-kyrezÒ ndaikyramoáiva-ekue
Guarani0278	Umi akãnguéra kyre’ỹ ndaikyramoái	TENSE:PAS_REC	Uminakãnguérankyreý/ ndaikyramoáikuri
Guarani0279	Umi akãnguéra kyre’ỹ ndaikyramoái	TENSE:PRE_SIM	Umidakãnguéradkyreê¡ ndaikyramoái
Guarani0280	Umi akãnguéra kyre’ỹ ndaikyramoái	PERSON:3_SI	Haóenakãnguéraukyre’w ndaikyramoái
Guarani0323	Nde ndarembyairi kuri	PERSON:2_PL	Pe: penderembyairiukuri
Guarani0324	Nde ndarembyairi kuri	PERSON:1_SI	Che Mrembyairirkuri
Guarani0325	Nde ndarembyairi kuri	PERSON:3_SI	Ha-e grembyairiukuri
Guarani0326	Nde ndarembyairi kuri	TYPE:AFF	Pde rembyairinkuri
Guarani0327	Nde ndarembyairi kuri	TENSE:FUT_SIM	cdelndarembyairita
Guarani0328	Nde ndarembyairi kuri	TENSE:PRE_SIM	de ndarembyairi
Guarani0381	Ñande guyra py’aguasu noĩrikuri	PERSON:3_PL	Umidguyra py-aguanu noŷrikuri
Guarani0382	Ñande guyra py’aguasu noĩrikuri	TYPE:AFF	Ñandeuguyra pyzaguatu 5ĩrikuri
Guarani0383	Ñande guyra py’aguasu noĩrikuri	TENSE:FUT_SIM	Ñandevguyra pyóaguann no/rita
Guarani0384	Ñande guyra py’aguasu noĩrikuri	TENSE:PRE_SIM	Ñandelguyra py’aguaén noüri
Guarani0385	Ñande guyra py’aguasu noĩrikuri	TENSE:PAS_IMP	Ñandeuguyra pykaguaéñ noürimi
Guarani0386	Ñande guyra py’aguasu noĩrikuri	TENSE:PAS_PLU	Ñandeuguyra py’aguasd nowriva-ekue
Guarani0351	Ha’ekuéra okytĩmi pende yvyrakuakuéra	TENSE:FUT_SIM	HaýekuéraỸkyñĩta pende yvyrakuakuéra
Guarani0352	Ha’ekuéra okytĩmi pende yvyrakuakuéra	TENSE:PRE_SIM	Hakekuéra Fkylw pende yvyrakuakuéra
Guarani0353	Ha’ekuéra okytĩmi pende yvyrakuakuéra	PERSON:3_SI	Ha,e ykyuĝmi pende yvyrakuakuéra
Guarani0354	Ha’ekuéra okytĩmi pende yvyrakuakuéra	PERSON:1_PL_INC	Ñande ñaoky0/mi pende yvyrakuakuéra
Guarani0355	Ha’ekuéra okytĩmi pende yvyrakuakuéra	PERSON:1_SI	"Che ""kytümi pende yvyrakuakuéra"
Guarani0356	Ha’ekuéra okytĩmi pende yvyrakuakuéra	TYPE:NEG	Hakekuéra ndokyty°mi pende yvyrakuakuéra
Guarani0357	Ha’ekuéra okytĩmi pende yvyrakuakuéra	TENSE:PAS_REC	Hakekuéra 5kylÒnkuri pende yvyrakuakuéra
Guarani0358	Ha’ekuéra okytĩmi pende yvyrakuakuéra	ASPECT:INM	Ha’ekuéra Tkyáwmi îóni pende yvyrakuakuéra
Guarani0479	Oñapytĩ ikyha tatakua kótare	PERSON:1_SI	Che₲ñapyñĩ*kyha tatakuau-ztare
Guarani0480	Oñapytĩ ikyha tatakua kótare	PERSON:1_PL_INC	Ñande ñañapylüĩkyha tatakuadîátare
Guarani0481	Oñapytĩ ikyha tatakua kótare	TENSE:FUT_SIM	8ñapyúwta Kkyha tatakuaýóîtare
Guarani0482	Oñapytĩ ikyha tatakua kótare	PERSON:1_PL_EXC	Yre roñapytŷ hkyha tatakuará,tare
Guarani0483	Oñapytĩ ikyha tatakua kótare	TYPE:NEG	Jdoñapyl;iükyha tatakuad’ótare
Guarani0484	Oñapytĩ ikyha tatakua kótare	ASPECT:INM	Äñapyú/*áóniÛkyha tatakuavýãtare
Guarani0485	Oñapytĩ ikyha tatakua kótare	ASPECT:IPFV	1ñapynĩrhína{kyha tatakuad,îtare
Guarani0486	Oñapytĩ ikyha tatakua kótare	TENSE:PAS_IMP	Oñapynïmiġkyha tatakuaýkbtare
Guarani0571	Ha’e omuasãimi ne namichãi ñemonambi	TENSE:PAS_REC	"Ha-e ""m'asbiukuri ne namich,i ñemonambi"
Guarani0572	Ha’e omuasãimi ne namichãi ñemonambi	TYPE:NEG	Haýe ndomnatsimi ne namichti ñemonambi
Guarani0573	Ha’e omuasãimi ne namichãi ñemonambi	ASPECT:INM	Hake 5mnaslimiÔzóni ne namichái ñemonambi
Guarani0574	Ha’e omuasãimi ne namichãi ñemonambi	TENSE:FUT_SIM	Hake Tmuasáita ne namichji ñemonambi
Guarani0575	Ha’e omuasãimi ne namichãi ñemonambi	TENSE:PRE_SIM	HaîeÃm'asãi ne namichti ñemonambi
Guarani0576	Ha’e omuasãimi ne namichãi ñemonambi	PERSON:2_PL	Pex pemvaña ne namich0i ñemonambi
Guarani0577	Ha’e omuasãimi ne namichãi ñemonambi	PERSON:1_PL_INC	Ñande ñamnaña ne namichsi ñemonambi
Guarani0578	Ha’e omuasãimi ne namichãi ñemonambi	PERSON:1_SI	Che 3m'aña ne namichbi ñemonambi
Guarani0579	Ko tupyty opu’akaveta	PERSON:3_PL	"Umiktupyty ""pukakaveta"
Guarani0580	Ko tupyty opu’akaveta	TENSE:PAS_REC	Koktupyty-pukakaudkuri
Guarani0581	Ko tupyty opu’akaveta	ASPECT:IPFV	KoltupytyÃpuóakavetadhína
Guarani0582	Ko tupyty opu’akaveta	TENSE:PRE_SIM	Kontupyty Lpu’akave
Guarani0583	Ko tupyty opu’akaveta	TENSE:PAS_PLU	Koñtupytyāpuýakavévakekue
Guarani0584	Ko tupyty opu’akaveta	TYPE:NEG	Kontupyty ndopuýakavéi
Guarani0433	Ha’e orombyasyta	TYPE:NEG	Ha-e ndorombyasytai
Guarani0434	Ha’e orombyasyta	ASPECT:IPFV	"Hake ""rombyasytavhína"
Guarani0435	Ha’e orombyasyta	PERSON:1_SI	Che grombyasyta
Guarani0436	Ha’e orombyasyta	PERSON:2_SI	Jde rerombyasyta
Guarani0437	Ha’e orombyasyta	TENSE:PAS_REC	Haóe orombyasykuri
Guarani0438	Ha’e orombyasyta	TENSE:PRE_SIM	Ha-e—rombyasy
Guarani0439	Ha’e orombyasyta	PERSON:2_PL	Peë perombyasyta
Guarani0534	Ipahaitépe Peru’i osẽ he’i	TYPE:NEG	Ópahaitépe Peru,i ndoñïi he-i
Guarani0535	Ipahaitépe Peru’i osẽ he’i	ASPECT:IPFV	- Ipahaitépe Peru’iÏñĝnhína he’i
Guarani0536	Ipahaitépe Peru’i osẽ he’i	TENSE:FUT_SIM	-@pahaitépe Perukiāñÿta hezi
Guarani0537	Ipahaitépe Peru’i osẽ he’i	TENSE:PAS_PLU	rXpahaitépe Peruýiāt;vakekue heîi
Guarani0538	Ipahaitépe Peru’i osẽ he’i	TENSE:PAS_IMP	ğpahaitépe Peruki yáxmi hezi
Guarani0474	Araka’eve jeko ndojehúi chupe ha itajyramíme mba’eve ivaíva.	PERSON:1_SI	Che arakaóeve jeko ndaikuaái chupe ha Ptaóyramíme mba’eveÔvaíva
Guarani0475	Araka’eve jeko ndojehúi chupe ha itajyramíme mba’eve ivaíva.	PERSON:3_PL, TYPE:AFF	Hakekuéra arakaíeve jeko ojehu chupe haÛta,yramíme mbakeve¡vaíva
Guarani0476	Araka’eve jeko ndojehúi chupe ha itajyramíme mba’eve ivaíva.	PERSON:2_PL	Pex penderajehúi chupe ha itakyramíme mbabeveġvaíva
Guarani0477	Araka’eve jeko ndojehúi chupe ha itajyramíme mba’eve ivaíva.	PERSON:3_PL, TENSE:FUT_SIM	Haáekuéra ndojehúita chupe haötaíyramíme mbaáeve Pvaíva
Guarani0478	Araka’eve jeko ndojehúi chupe ha itajyramíme mba’eve ivaíva.	PERSON:3_PL, TENSE:PAS_PLU	Haýekuéra ndojehúivakekue chupe haỹtaáyramíme mbakeveÛvaíva
Guarani0395	Ñande apekuekuéra oñemikuri	TYPE:NEG	Ñande Ópekuekuéra ndoñemikuri
Guarani0396	Ñande apekuekuéra oñemikuri	TENSE:FUT_SIM	Ñande Fpekuekuéra oñemikurita
Guarani0397	Ñande apekuekuéra oñemikuri	PERSON:3_SI	Ñande│pekueÏmikuri
Guarani0398	Ñande apekuekuéra oñemikuri	TENSE:PAS_IMP	Ñande Bpekuekuéra oñemikurimi
Guarani0399	Ñande apekuekuéra oñemikuri	TENSE:PRE_SIM	Ñande Jpekuekuéra oñemikuri
Guarani0400	Ñande apekuekuéra oñemikuri	ASPECT:IPFV	Ñande 3pekuekuéra oñemikuri hína
Guarani0401	Ñande apekuekuéra oñemikuri	TENSE:PAS_PLU	Ñande₲pekuekuéra oñemikuriva’ekue
Guarani0329	Ako pirapire opa’ỹva ndópe’áikuri umi susu’akuéra potĩ	PERSON:3_PL	Haýekuéra pirapire opa’wvaýndópezáikuri umi sulñzakuéra pos/
Guarani0330	Ako pirapire opa’ỹva ndópe’áikuri umi susu’akuéra potĩ	TYPE:AFF	"Wko pirapire opa’ĝva ""peýáikuri umi suénzakuéra pot¡"
Guarani0331	Ako pirapire opa’ỹva ndópe’áikuri umi susu’akuéra potĩ	TENSE:PRE_SIM	-Ãko pirapire opakÒva opeóái umi sutubakuéra podü
Guarani0332	Ako pirapire opa’ỹva ndópe’áikuri umi susu’akuéra potĩ	TENSE:FUT_SIM	ko pirapire opaýüvaāpe-áita umi sutvkakuéra ponü
Guarani0333	Ako pirapire opa’ỹva ndópe’áikuri umi susu’akuéra potĩ	TENSE:PAS_PLU	ako pirapire opa-/vaÃpe-áivaýekue umi suéukakuéra ponĝ
Guarani0334	Ako pirapire opa’ỹva ndópe’áikuri umi susu’akuéra potĩ	ASPECT:INM	Ako pirapire opabỹvaundópeááiÛýóni umi sulnzakuéra posŷ
Guarani0335	Ako pirapire opa’ỹva ndópe’áikuri umi susu’akuéra potĩ	ASPECT:IPFV	Wko pirapire opazwva ndópekáilhína umi sutuáakuéra podÒ
Guarani0453	Péichantema opyta hikuái	PERSON:2_PL	Peï pepyta hikuái
Guarani0454	Péichantema opyta hikuái	PERSON:1_SI	Cherapyta hikuái
Guarani0455	Péichantema opyta hikuái	TENSE:FUT_SIM	Péichantema opytata hikuái
Guarani0456	Péichantema opyta hikuái	TYPE:NEG	Péichantema ndopyta hikuái
Guarani0457	Péichantema opyta hikuái	TENSE:PAS_REC	Péichantema opytakuri hikuái
Guarani0487	Kuña ikyre’ỹetéva voi opu’ã	PERSON:3_PL	r│dñakuéra ikyreýXebéva voi puká
Guarani0488	Kuña ikyre’ỹetéva voi opu’ã	TENSE:FUT_SIM	′'ña hkyrebŷeséva voiỸpuzáta
Guarani0489	Kuña ikyre’ỹetéva voi opu’ã	TENSE:PAS_REC	Ó'ña ikyreýüeléva voi Tpuêãkuri
Guarani0490	Kuña ikyre’ỹetéva voi opu’ã	ASPECT:INM	nünña ekyre-we0éva voiÃpuká e’óni
Guarani0491	Kuña ikyre’ỹetéva voi opu’ã	TYPE:NEG	Ktña Pkyre’Xebéva voi ndopuýái
Guarani0468	Okyvérõnteke okyvehína	TYPE:NEG	Okyu0rõnteke ndokyvehína
Guarani0469	Okyvérõnteke okyvehína	TENSE:FUT_SIM	Ukysérõnteke okyvehína ta
Guarani0470	Okyvérõnteke okyvehína	PERSON:3_PL	"gikuái ""kyllrõnteke 7kyvehína"
Guarani0471	Okyvérõnteke okyvehína	TENSE:PAS_REC	1kyuérõnteke Tkyvehínadkuri
Guarani0472	Okyvérõnteke okyvehína	ASPECT:INM	Okyéñrõnteke Lkyvehína=áóni
Guarani0473	Okyvérõnteke okyvehína	TENSE:PAS_PLU	Vkyésrõnteke-kyvehínauvabekue
Guarani0551	Che aikotevẽ pirapire	TYPE:NEG	Che ndaikotev;i pirapire
Guarani0552	Che aikotevẽ pirapire	ASPECT:IPFV	Che`ikoten%vhína pirapire
Guarani0553	Che aikotevẽ pirapire	PERSON:1_PL_INC	Ñande jaikoted: pirapire
Guarani0554	Che aikotevẽ pirapire	PERSON:2_SI	Nde reikote': pirapire
Guarani0555	Che aikotevẽ pirapire	PERSON:3_SI	Ha)e 3ikote': pirapire
Guarani0556	Che aikotevẽ pirapire	TENSE:FUT_SIM	Che fikoteuëta pirapire
Guarani0557	Che aikotevẽ pirapire	TENSE:PAS_REC	Che Nikoteuxkuri pirapire
Guarani0499	Upépe omba’apo hikuái ikokuépe	PERSON:2_PL	PeÁ pombanapo peikokuépe
Guarani0500	Upépe omba’apo hikuái ikokuépe	PERSON:1_PL_EXC	"""re rombanapo orekokuépe"
Guarani0501	Upépe omba’apo hikuái ikokuépe	TENSE:FUT_SIM	Upépe ombadapota hikuáilikokuépe
Guarani0502	Upépe omba’apo hikuái ikokuépe	TYPE:NEG	Upépe ndomba'apói hikuáidikokuépe
Guarani0503	Upépe omba’apo hikuái ikokuépe	ASPECT:INM	Upépe ombavapo eóóni hikuáiýikokuépe
Guarani0504	Upépe omba’apo hikuái ikokuépe	TENSE:PAS_IMP	Upépe ombavapomi hikuáivikokuépe
Guarani0517	Upéingo pyharepyte riremi añandúsapy’a ore koty rokẽ ombotáva	TENSE:PAS_REC	Upéingo pyharepyte riremi 3ñandntapyza ore koty roó; ombotái
Guarani0518	Upéingo pyharepyte riremi añandúsapy’a ore koty rokẽ ombotáva	ASPECT:INM	Upéingo pyharepyte riremi fñandúéapyza ore koty ro,% ombotáva=,óni
Guarani0519	Upéingo pyharepyte riremi añandúsapy’a ore koty rokẽ ombotáva	TENSE:PAS_IMP	Upéingo pyharepyte riremi Sñandtlapy-a ore koty rokë ombovámi
Guarani0520	Upéingo pyharepyte riremi añandúsapy’a ore koty rokẽ ombotáva	PERSON:2_SI	Upéingo pyharepyte riremi Fñandó0apy,a nde koty roîÿ ombotáva
Guarani0521	Upéingo pyharepyte riremi añandúsapy’a ore koty rokẽ ombotáva	PERSON:3_SI	Upéingo pyharepyte riremi`ñand00apyóa haóe koty roá: ombotáva
Guarani0387	Ha’e oguatata	PERSON:2_SI	de reguatata
Guarani0388	Ha’e oguatata	PERSON:1_SI	Che pguatata
Guarani0389	Ha’e oguatata	TENSE:PRE_SIM	Haóe Pguata
Guarani0390	Ha’e oguatata	TYPE:NEG	Haze ndoguañái
Guarani0391	Ha’e oguatata	ASPECT:IPFV	Hake 5guatata-hína
Guarani0392	Ha’e oguatata	ASPECT:INM	HaóeÃguatata=’óni
Guarani0393	Ha’e oguatata	PERSON:1_PL_INC	Ñande jaguatata
Guarani0394	Ha’e oguatata	PERSON:1_PL_EXC	Wre roguatata
Guarani0527	Maymave apysápe oike ne marandu	PERSON:1_PL_INC	Ñande'apyéápe jaike ne marandu
Guarani0528	Maymave apysápe oike ne marandu	TENSE:FUT_SIM	Maymave-apylápe oiketa ne marandu
Guarani0529	Maymave apysápe oike ne marandu	TYPE:NEG	Maymave-apyéápe ndoikei ne marandu
Guarani0530	Maymave apysápe oike ne marandu	PERSON:1_PL_EXC	Yre noroãapói oike ne marandu
Guarani0531	Maymave apysápe oike ne marandu	ASPECT:IPFV	Maymaveuapy0ápe oikenhína ne marandu
Guarani0532	Maymave apysápe oike ne marandu	PERSON:2_PL	Pe; pemoike ne marandu
Guarani0533	Maymave apysápe oike ne marandu	TENSE:PAS_PLU	Maymavedapy'ápe oikevaýekue ne marandu
Guarani0343	Ore ndorojua’ói	PERSON:1_PL_INC	Ñande ndorojuakói
Guarani0344	Ore ndorojua’ói	TENSE:PAS_PLU	3re ndorojuaóóiva-ekue
Guarani0345	Ore ndorojua’ói	TYPE:AFF	Wre rojua’ói
Guarani0346	Ore ndorojua’ói	ASPECT:IPFV	Ure ndorojuaóói-hína
Guarani0347	Ore ndorojua’ói	TENSE:FUT_SIM	re ndorojua-óita
Guarani0348	Ore ndorojua’ói	PERSON:2_PL	Peÿ pendorojuaîói
Guarani0349	Ore ndorojua’ói	PERSON:3_SI	Haîe ndorojuaíói
Guarani0350	Ore ndorojua’ói	PERSON:1_SI	Che ndorojuabói
Guarani0366	Che ambyasy	PERSON:2_PL	Pex pendelasy
Guarani0367	Che ambyasy	PERSON:1_PL_INC	Ñande ñambyasy
Guarani0368	Che ambyasy	TENSE:PAS_PLU	Che Smbyasyvakekue
Guarani0369	Che ambyasy	ASPECT:INM	Che Wmbyasy K,óni
Guarani0370	Che ambyasy	TYPE:NEG	Pdacheambyasýi
Guarani0371	Che ambyasy	PERSON:3_PL	Haóekuéra oñembyasy
Guarani0372	Che ambyasy	TENSE:PAS_REC	Che chenasyukuri
Guarani0558	Upéi ñarambosáta ñande gusto-pe	PERSON:1_PL_EXC	Wre norambo0áta ñandengustoîpe
Guarani0559	Upéi ñarambosáta ñande gusto-pe	TYPE:NEG	Upéidndaramboéái ñandengunto’pe
Guarani0560	Upéi ñarambosáta ñande gusto-pe	TENSE:PAS_PLU	Upéi ñarambotávakekue ñandeugusto’pe
Guarani0561	Upéi ñarambosáta ñande gusto-pe	PERSON:2_PL	Peï penderambotáta ñandelgutto-pe
Guarani0562	Upéi ñarambosáta ñande gusto-pe	PERSON:3_PL	Ha-ekuéra Tramboláta ñandeuguúto-pe
Guarani0563	Upéi ñarambosáta ñande gusto-pe	TENSE:PRE_SIM	Upéi ñaramboéj ñandeuguótokpe
Guarani0258	Ã kũnguéra mburutue ombovami	PERSON:3_SI	u'āv,ĝuguedmburutue ombovami
Guarani0259	Ã kũnguéra mburutue ombovami	TENSE:PAS_REC	"-d ""róũnguérañmburutue ombodáiukuri"
Guarani0260	Ã kũnguéra mburutue ombovami	TYPE:NEG	' on,ünguéralmburutue ndombolái
Guarani0261	Ã kũnguéra mburutue ombovami	ASPECT:INM	5ñóünguérarmburutue ombovami Kîóni
Guarani0262	Ã kũnguéra mburutue ombovami	TENSE:PRE_SIM	"nê ""l’¿nguéranmburutue ombova"
Guarani0440	Ore romono’õta ñande ára	TYPE:NEG	Wre ndoromonokzi ñande ára
Guarani0441	Ore romono’õta ñande ára	PERSON:1_PL_INC	Ñande ñamonoáýta ñande ára
Guarani0442	Ore romono’õta ñande ára	PERSON:1_SI	Che Bmonokýta ñande ára
Guarani0443	Ore romono’õta ñande ára	TENSE:PAS_PLU	3re romono’ývaýekue ñande ára
Guarani0444	Ore romono’õta ñande ára	ASPECT:IPFV	Ore romono’âta'hína ñande ára
Guarani0445	Ore romono’õta ñande ára	PERSON:2_SI	4de remono,âta ñande ára
Guarani0539	Peteĩ tapepo’i puku opahápe ojogapókuri karai Policarpo	TENSE:PAS_IMP	Pete° tapepoói puku opahápe ojogapomi karai Policarpo
Guarani0540	Peteĩ tapepo’i puku opahápe ojogapókuri karai Policarpo	TENSE:PRE_SIM	Peteï tapepo)i puku opahápe ojogapa karai Policañpo
Guarani0541	Peteĩ tapepo’i puku opahápe ojogapókuri karai Policarpo	TYPE:NEG	Pete/ tapepozi puku opahápe ndojogapókuri karai Policavpo
Guarani0542	Peteĩ tapepo’i puku opahápe ojogapókuri karai Policarpo	ASPECT:INM	Peteŷ tapepoki puku opahápe ojogapókuri Vóóni karai Policanpo
Guarani0543	Peteĩ tapepo’i puku opahápe ojogapókuri karai Policarpo	TENSE:FUT_SIM	Petew tapepoói puku opahápe ojogapóta karai Policavpo
Guarani0263	Ñande ndajajapói	PERSON:1_PL_EXC	Ore'ndajaóapói
Guarani0264	Ñande ndajajapói	PERSON:1_SI	Che'ndajajapói
Guarani0265	Ñande ndajajapói	PERSON:2_PL	Pe;êndajaãapói
Guarani0266	Ñande ndajajapói	TYPE:AFF	Ñande jaóapói
Guarani0267	Ñande ndajajapói	TENSE:FUT_SIM	Ñandedndajajapotái
Guarani0268	Ñande ndajajapói	ASPECT:IPFV	Ñande’ndajaãapóivhína
Guarani0269	Ñande ndajajapói	TENSE:PAS_REC	Ñande'ndajabapóiukuri
Guarani0591	Nde nderejoguái	ASPECT:IPFV	de nderejoguáiuhína
Guarani0592	Nde nderejoguái	TYPE:AFF	cde rejoguái
Guarani0593	Nde nderejoguái	TENSE:FUT_SIM	Nde nderejoguáita
Guarani0594	Nde nderejoguái	TENSE:PAS_REC	Nde nderejoguái'kuri
Guarani0595	Nde nderejoguái	PERSON:2_PL	Peÿ nderejoguái
Guarani0596	Nde nderejoguái	PERSON:1_PL_INC	Ñandeundañarejoguái
Guarani0597	Nde nderejoguái	PERSON:1_SI	Che ndarejoguái
Guarani0293	Ore ndorohua’ĩmi	PERSON:1_PL_INC	Ñande ndañarohuaîÒmi
Guarani0294	Ore ndorohua’ĩmi	TYPE:AFF	7re rohuaáwmi
Guarani0295	Ore ndorohua’ĩmi	ASPECT:INM	8re ndorohua,Òmi*,óni
Guarani0296	Ore ndorohua’ĩmi	TENSE:FUT_SIM	Sre ndorohua,üta
Guarani0297	Ore ndorohua’ĩmi	TENSE:PRE_SIM	fre ndorohuaóĩ
Guarani0336	Nde ndereñemúi	ASPECT:IPFV	gde ndereñemúinhína
Guarani0337	Nde ndereñemúi	TYPE:AFF	Nde reñemúi
Guarani0338	Nde ndereñemúi	TENSE:FUT_SIM	2de ndereñemúita
Guarani0339	Nde ndereñemúi	TENSE:PAS_REC	de ndereñemúi kuri
Guarani0340	Nde ndereñemúi	PERSON:2_PL	Peẽ pereñemúi
Guarani0341	Nde ndereñemúi	PERSON:1_PL_INC	Ñandedndañareñemúi
Guarani0342	Nde ndereñemúi	PERSON:1_SI	Che freñemúi
Guarani0417	Ha’e ope’ata	TYPE:NEG	Haóe ndopekái
Guarani0418	Ha’e ope’ata	ASPECT:IPFV	Ha’eÃpe’atanhína
Guarani0419	Ha’e ope’ata	TENSE:PRE_SIM	Hake peza
Guarani0420	Ha’e ope’ata	TENSE:PAS_PLU	Ha’eÃpe’avabekue
Guarani0421	Ha’e ope’ata	PERSON:2_SI	de repeóata
Guarani0422	Ha’e ope’ata	PERSON:1_SI	Che gpekata
Guarani0423	Ha’e ope’ata	PERSON:1_PL_EXC	-re ropekata
Guarani0424	Ha’e ope’ata	PERSON:1_PL_INC	Ñande japekata
Guarani0522	Vy’a guasuete ojaitypo maymáva ñe’ãme	PERSON:3_PL	hikuái ojaitypo maymáva ñe,tme
Guarani0523	Vy’a guasuete ojaitypo maymáva ñe’ãme	TYPE:NEG	Vyýa guasuete ndojaitypo maymáva ñekãme
Guarani0524	Vy’a guasuete ojaitypo maymáva ñe’ãme	TENSE:FUT_SIM	5yza guasuete Fjaitypota maymáva ñekãme
Guarani0525	Vy’a guasuete ojaitypo maymáva ñe’ãme	TENSE:PAS_PLU	r&yka guasueteỸjaitypo vazekue maymáva ñekóme
Guarani0526	Vy’a guasuete ojaitypo maymáva ñe’ãme	TENSE:PAS_IMP	Vyka guasuete ojaityporkuri maymáva ñek,me
Guarani0458	Yvyrapã ojapo guajayvígui	PERSON:2_SI	│de rejapoýguajaynógui
Guarani0459	Yvyrapã ojapo guajayvígui	PERSON:1_PL_INC	Ñande jajapoêguajayu0gui
Guarani0460	Yvyrapã ojapo guajayvígui	ASPECT:IPFV	hvyrap, ojapouhína-guajaynîgui
Guarani0461	Yvyrapã ojapo guajayvígui	TYPE:NEG	(vyrapó ndo,apóidguajaylúgui
Guarani0462	Yvyrapã ojapo guajayvígui	TENSE:PAS_PLU	rĩvyrapí ojaponvakekuevguajay'ñgui
Guarani0446	Nde nérekirirĩrikuri itendóta ka’aguygua	PERSON:2_PL	Peĝ pereóirirwrikuriditendjta kabaguygua
Guarani0447	Nde nérekirirĩrikuri itendóta ka’aguygua	TYPE:AFF	Nde reóirid¡rikuriuitendîta ka-aguygua
Guarani0448	Nde nérekirirĩrikuri itendóta ka’aguygua	ASPECT:IPFV	Cdevuéreîiriuĝrikurirhínanitendjta ka-aguygua
Guarani0449	Nde nérekirirĩrikuri itendóta ka’aguygua	PERSON:3_PL	Haîekuéra oñerekiri'ĝrikuri-itendóta kakaguygua
Guarani0450	Nde nérekirirĩrikuri itendóta ka’aguygua	PERSON:1_SI	Che₲,iridŷrikuri itendáta ka’aguygua
Guarani0451	Nde nérekirirĩrikuri itendóta ka’aguygua	TENSE:FUT_SIM	de-'ére-irin°rikuriritendbta ka’aguygua
Guarani0452	Nde nérekirirĩrikuri itendóta ka’aguygua	PERSON:1_PL_EXC	Ïre ro,iri'Òrikuriritendbta ka,aguygua
Guarani0463	Kuarahy ojope	TENSE:PAS_IMP	r Knarahy ojopenkuri
Guarani0464	Kuarahy ojope	TENSE:FUT_SIM	u¡uarahy ojopeta
Guarani0465	Kuarahy ojope	TYPE:NEG	̃varahy ndojopéi
Guarani0466	Kuarahy ojope	ASPECT:IPFV	dÒlarahy ojopevhína
Guarani0467	Kuarahy ojope	TENSE:PAS_PLU	̃larahy ojopeuva)ekue
Guarani0298	Pende tykuekuéra omboareta	TYPE:NEG	Pendeutykuekuéra ndomboaretai
Guarani0299	Pende tykuekuéra omboareta	ASPECT:IPFV	Pendentykuekuéra omboaretavhína
Guarani0300	Pende tykuekuéra omboareta	PERSON:3_SI	Pendeltykue omboareta
Guarani0301	Pende tykuekuéra omboareta	TENSE:PAS_REC	Pende-tykuekuéra omboaretadkuri
Guarani0302	Pende tykuekuéra omboareta	TENSE:PRE_SIM	Pendeltykuekuéra omboareta
Guarani0303	Pende tykuekuéra omboareta	TENSE:PAS_PLU	Pendeltykuekuéra omboaretavaýekue
Guarani0359	Ha’e nombyasymoái	PERSON:1_SI	Chevndambyasymoái
Guarani0360	Ha’e nombyasymoái	PERSON:1_PL_INC	Ñandenndañambyasymoái
Guarani0361	Ha’e nombyasymoái	PERSON:1_PL_EXC	ere ndorombyasymoái
Guarani0362	Ha’e nombyasymoái	TENSE:PAS_REC	Habe ndombyasymoáikuri
Guarani0363	Ha’e nombyasymoái	TENSE:PAS_PLU	Hake ndombyasymoáivazekue
Guarani0364	Ha’e nombyasymoái	TYPE:AFF	Haze mbyasymoái
Guarani0365	Ha’e nombyasymoái	TENSE:PRE_SIM	Ha’e ndombyasymoái
Guarani0281	Ñande ñañemitỹkuri	TENSE:PRE_SIM	Ñande ñañemitÒ
Guarani0282	Ñande ñañemitỹkuri	TYPE:NEG	Ñandeñndañañemiñŷkuri
Guarani0283	Ñande ñañemitỹkuri	ASPECT:IPFV	Ñande ñañemis!kuriuhína
Guarani0284	Ñande ñañemitỹkuri	ASPECT:INM	Ñande ñañemitwkuri=,óni
Guarani0285	Ñande ñañemitỹkuri	PERSON:1_PL_EXC	Yre roñemi0ỹkuri
Guarani0286	Ñande ñañemitỹkuri	PERSON:1_SI	Che ajeminXkuri
Guarani0564	Ha’e oma’ẽkuri	PERSON:1_SI	Che gma-ĝkuri
Guarani0565	Ha’e oma’ẽkuri	PERSON:2_SI	cde remaá:kuri
Guarani0566	Ha’e oma’ẽkuri	TENSE:FUT_SIM	Hake Lmakẽta
Guarani0567	Ha’e oma’ẽkuri	TYPE:NEG	Ha’e ndomazëkuri
Guarani0568	Ha’e oma’ẽkuri	ASPECT:IPFV	Haóe Tmaz:kuridhína
Guarani0569	Ha’e oma’ẽkuri	PERSON:2_PL	Pe; pemaóûkuri
Guarani0570	Ha’e oma’ẽkuri	PERSON:1_PL_EXC	Yre romañek;kuri
Guarani0585	Peẽ ndapeikemoái	TYPE:AFF	Pe: peikemoái
Guarani0586	Peẽ ndapeikemoái	TENSE:PAS_PLU	Peẽnndapeikemoáiva,ekue
Guarani0587	Peẽ ndapeikemoái	PERSON:3_SI	Hakelndapeikemoái
Guarani0588	Peẽ ndapeikemoái	PERSON:1_SI	Cherndapeikemoái
Guarani0589	Peẽ ndapeikemoái	PERSON:1_PL_INC	Ñandedndapeikemoái
Guarani0590	Peẽ ndapeikemoái	TENSE:PRE_SIM	Peẽdndapeikemoái
Guarani0492	Katu atererehína	PERSON:2_SI	pde retererehína
Guarani0493	Katu atererehína	PERSON:2_PL	Pex petermina
Guarani0494	Katu atererehína	TENSE:FUT_SIM	Katu 3terereta
Guarani0495	Katu atererehína	ASPECT:INM	Katu₲tererehína ekóni
Guarani0496	Katu atererehína	TYPE:NEG	Katu’ndatererehína
Guarani0497	Katu atererehína	PERSON:3_PL	Ha,ekuéraÃtermina
Guarani0498	Katu atererehína	ASPECT:-	Katu Wterere
Guarani0304	Ñande ndañambotavýi	PERSON:1_PL_EXC	fre ndoroambotanýi
Guarani0305	Ñande ndañambotavýi	PERSON:1_SI	Chelndaambotadýi
Guarani0306	Ñande ndañambotavýi	TENSE:FUT_SIM	Ñandelndañambotanýita
Guarani0307	Ñande ndañambotavýi	ASPECT:IPFV	Ñanderndañambotavýilhína
Guarani0308	Ñande ndañambotavýi	TENSE:PAS_IMP	Ñandeundañambotadýimi
Guarani0309	Ñande ndañambotavýi	PERSON:2_PL	Pe; pendañambotauýi
