ID	Source	Change	Target
ID	Source	Change	Kë̀ ye' dör àrros a̠we̠ i̠
Bribri0561	Ye' tö àrros ali' ù̠ i' a̠	TYPE:NEG	Ye' dör àrros a̠wé̠mi̠ i̠ i̠ i̠ i̠ i̠ i̠ i̠ i̠ i̠ i̠ i̠ i̠ i̠ i̠ i̠ i̠ i̠ i̠ i̠ i̠ i̠ i̠ i̠ i̠ i̠ i̠ i̠ i̠ i̠ i̠ i̠ i̠ i̠ i̠ i̠ i̠ i̠ i̠ i̠ i̠ i̠ i̠ i̠ i̠ i̠ i̠ i̠ i̠ i̠ i̠ i̠ i̠ i̠ i̠ i̠ i̠ i̠ i̠ i̠ 
Bribri0562	Ye' tö àrros ali' ù̠ i' a̠	ASPECT:INC	Ye' dör àrros a̠wé̠ ùè̠
Bribri0563	Ye' tö àrros ali' ù̠ i' a̠	TENSE:PRF_REC	Ye' dör àrros a̠wè̠ ùè̠
Bribri0564	Ye' tö àrros ali' ù̠ i' a̠	TYPE:NEG, TENSE:PRF_REC	Ye' dör àrros a̠wè̠ ùè̠
Bribri0565	Ye' tö àrros ali' ù̠ i' a̠	TENSE:PRF_REC, ASPECT:INC	Ye' dör àrros a̠wè̠ ùè̠
Bribri0566	Ye' tö àrros ali' ù̠ i' a̠	TENSE:IPFV_REC, ASPECT:IPFV	Ye' dör àrros a̠wè̠ ùè̠
Bribri0567	Ye' tö àrros ali' ù̠ i' a̠	TYPE:NEG, TENSE:IPFV_REC, ASPECT:IPFV	Ye' dör àrros a̠wè̠ ùè̠
Bribri0568	Ye' tö àrros ali' ù̠ i' a̠	TENSE:IPFV_PROG, ASPECT:IPFV	Ye' dör àrros a̠wè̠ ùè̠
Bribri0569	Ye' tö àrros ali' ù̠ i' a̠	TYPE:NEG, TENSE:IPFV_PROG, ASPECT:IPFV	Ye' bák àrros a̠ú̠k ùè̠
Bribri0570	Ye' tö àrros ali' ù̠ i' a̠	TENSE:PRF_PROG	Ye' dör àrros a̠wè̠ ùè̠
Bribri0571	Ye' tö àrros ali' ù̠ i' a̠	TYPE:NEG, TENSE:PRF_PROG	Ye' dör àrros a̠wè̠ ùè̠
Bribri0572	Ye' tö àrros ali' ù̠ i' a̠	MODE:IMP, TENSE:IPFV_REC, ASPECT:IPFV, PERSON:NA	Ye' dör àrros a̠wè̠ ùè̠
Bribri0573	Ye' tö àrros ali' ù̠ i' a̠	TYPE:NEG, MODE:IMP, TENSE:IPFV_REC, ASPECT:IPFV, PERSON:NA	Ye' dör àrros a̠wè̠ ùè̠
Bribri0574	Ye' tö àrros ali' ù̠ i' a̠	TYPE:NEG, MODE:IMP, TENSE:IPFV_REC, ASPECT:IPFV, VOICE:MID, PERSON:NA	Ye' dör àrros a̠wè̠ ùè̠
Bribri0575	Ye' tö àrros ali' ù̠ i' a̠	MODE:EXH, TENSE:IPFV_REC, ASPECT:IPFV, PERSON:1_PL_INC	Ye' dör àrros a̠wè̠ ùè̠
Bribri0576	Ye' tö àrros ali' ù̠ i' a̠	MODE:DES, TENSE:IPFV_REC, ASPECT:IPFV	Ye' dör àrros a̠wè̠ ùè̠
Bribri0577	Ye' tö àrros ali' ù̠ i' a̠	TYPE:NEG, MODE:DES, TENSE:IPFV_REC, ASPECT:IPFV	Ye' wa̠ àrros a̠wa̠' ùa' ta̠wa̠' ùa' o̠ ia̠
Bribri0578	Ye' tö àrros ali' ù̠ i' a̠	MODE:ADVERS	Ye' dör àrros a̠wè̠ ùè̠
Bribri0579	Ye' tö àrros ali' ù̠ i' a̠	TENSE:IPFV_HAB, ASPECT:IPFV	Ye' dör àrros a̠wè̠ ùè̠
Bribri0580	Ye' tö àrros ali' ù̠ i' a̠	TYPE:NEG, TENSE:IPFV_HAB, ASPECT:IPFV	Ye' dör àrros a̠wè̠ ùè̠
Bribri0581	Ye' tö àrros ali' ù̠ i' a̠	TENSE:FUT_POT, ASPECT:IPFV	Ye' dör àrros a̠wè̠ ùè̠
Bribri0582	Ye' tö àrros ali' ù̠ i' a̠	TYPE:NEG, TENSE:FUT_POT, ASPECT:IPFV	Ye' dör àrros a̠wè̠ ùè̠
Bribri0583	Ye' tö àrros ali' ù̠ i' a̠	TENSE:FUT_CER, ASPECT:IPFV	Ye' dör àrros a̠wè̠ ùè̠
Bribri0584	Ye' tö àrros ali' ù̠ i' a̠	TYPE:NEG, TENSE:FUT_CER, ASPECT:IPFV	Ye' dör àrros a̠wè̠ ùè̠
Bribri0585	Ye' tö àrros ali' ù̠ i' a̠	VOICE:MID, PERSON:NA	Ye' dör àrros a̠wè̠ ùè̠
Bribri0586	Ye' tö àrros ali' ù̠ i' a̠	TYPE:NEG, VOICE:MID, PERSON:NA	Ye' dör àrros a̠wè̠ ùè̠
Bribri0587	Ye' tö àrros ali' ù̠ i' a̠	TENSE:PRF_REC, VOICE:MID, PERSON:NA	Ye' dör àrros a̠wè̠ ùè̠
Bribri0588	Ye' tö àrros ali' ù̠ i' a̠	TYPE:NEG, TENSE:PRF_REC, VOICE:MID, PERSON:NA	Ye' dör àrros a̠wè̠ ùè̠
Bribri0589	Ye' tö àrros ali' ù̠ i' a̠	TENSE:IPFV_REC, ASPECT:IPFV, VOICE:MID, PERSON:NA	Ye' dör àrros a̠wè̠ ùè̠
Bribri0590	Ye' tö àrros ali' ù̠ i' a̠	TYPE:NEG, TENSE:IPFV_REC, ASPECT:IPFV, VOICE:MID, PERSON:NA	Ye' dör àrros a̠wè̠ ùè̠
Bribri0591	Ye' tö àrros ali' ù̠ i' a̠	TENSE:IPFV_HAB, ASPECT:IPFV, VOICE:MID, PERSON:NA	Ye' dör àrros a̠wè̠ ùè̠
Bribri0592	Ye' tö àrros ali' ù̠ i' a̠	TYPE:NEG, TENSE:IPFV_HAB, ASPECT:IPFV, VOICE:MID, PERSON:NA	Ye' dör àrros a̠wè̠ ùè̠
Bribri0593	Ye' tö àrros ali' ù̠ i' a̠	TENSE:FUT_POT, ASPECT:IPFV, VOICE:MID, PERSON:NA	Ye' dör àrros a̠wè̠ ùè̠
Bribri0594	Ye' tö àrros ali' ù̠ i' a̠	TYPE:NEG, TENSE:FUT_POT, ASPECT:IPFV, VOICE:MID, PERSON:NA	Ye' dör àrros a̠wè̠ ùè̠
Bribri0595	Ye' tö àrros ali' ù̠ i' a̠	TENSE:FUT_CER, ASPECT:IPFV, VOICE:MID, PERSON:NA	Ye' dör àrros a̠wè̠ ùè̠
Bribri0596	Ye' tö àrros ali' ù̠ i' a̠	TYPE:NEG, TENSE:FUT_CER, ASPECT:IPFV, VOICE:MID, PERSON:NA	Ye' wa̠ àrros aówa̠rule i̠ i̠ i̠ i̠
Bribri0597	Ye' tö àrros ali' ù̠ i' a̠	TENSE:PAS_PLU	Ye' dör àrros a̠wè̠ ùè̠
Bribri0598	Ye' tö àrros ali' ù̠ i' a̠	TYPE:NEG, TENSE:PAS_PLU	Ye' dör àrros a̠wè̠ ùè̠
Bribri0599	Ye' tö àrros ali' ù̠ i' a̠	MODE:POT, TENSE:IPFV_REC, ASPECT:IPFV	Ye' dör àrros a̠wè̠ ùè̠
Bribri0600	Ye' tö àrros ali' ù̠ i' a̠	TYPE:NEG, MODE:POT, TENSE:IPFV_REC, ASPECT:IPFV	Ie' tök
Bribri0416	I kiö́	ABSNUM:PL	Ie' s 'so
Bribri0417	I tso'	ABSNUM:PL, PERSON:3_PL	Kë̀ kë̀ ku̠ dör kë̀ ku̠ da̠
Bribri0721	Maria dör kápi u'	TYPE:NEG	Ie' tö  ö' kë'mi̠
Bribri0722	Maria dör kápi u'	ASPECT:INC	Ie' tö dö' késtsa̠
Bribri0723	Maria dör kápi u'	TENSE:PRF_REC	Mari kë̀ ku̠ dapö́k
Bribri0724	Maria dör kápi u'	TYPE:NEG, TENSE:PRF_REC	Mari kë̀ ku̠ dapö́k
Bribri0725	Maria dör kápi u'	TENSE:PRF_REC, ASPECT:INC	Mari kë̀ ku̠ dapö́k
Bribri0726	Maria dör kápi u'	TENSE:IPFV_REC, ASPECT:IPFV	Mari kë̀ ku̠ dapö́k
Bribri0727	Maria dör kápi u'	TYPE:NEG, TENSE:IPFV_REC, ASPECT:IPFV	Mari kë̀ ku̠ dapö́k
Bribri0728	Maria dör kápi u'	TENSE:IPFV_PROG, ASPECT:IPFV	Mari kë̀ ku̠ dapö́k
Bribri0729	Maria dör kápi u'	TYPE:NEG, TENSE:IPFV_PROG, ASPECT:IPFV	Ie' bák kàr ku̠'bak dapö́k
Bribri0730	Maria dör kápi u'	TENSE:PRF_PROG	Mari kë̀ ku̠ dapö́k
Bribri0731	Maria dör kápi u'	TYPE:NEG, TENSE:PRF_PROG	Mari kë̀ ku̠ dapö́k
Bribri0732	Maria dör kápi u'	MODE:IMP, TENSE:IPFV_REC, ASPECT:IPFV	Mari kë̀ ku̠ dapö́k
Bribri0733	Maria dör kápi u'	TYPE:NEG, MODE:IMP, TENSE:IPFV_REC, ASPECT:IPFV	Mari kë̀ ku̠ dapö́k
Bribri0734	Maria dör kápi u'	TYPE:NEG, MODE:IMP, TENSE:IPFV_REC, ASPECT:IPFV, VOICE:MID	Mari kë̀ ku̠ dapö́k
Bribri0735	Maria dör kápi u'	MODE:EXH, TENSE:IPFV_REC, ASPECT:IPFV, PERSON:1_PL_INC	Mari kë̀ ku̠ dapö́k
Bribri0736	Maria dör kápi u'	MODE:DES, TENSE:IPFV_REC, ASPECT:IPFV	Mari kë̀ ku̠ dapö́k
Bribri0737	Maria dör kápi u'	TYPE:NEG, MODE:DES, TENSE:IPFV_REC, ASPECT:IPFV	Mari wa̠ Mapa u'pa'
Bribri0738	Maria dör kápi u'	MODE:ADVERS	Mari kë̀ ku̠ dapö́k
Bribri0739	Maria dör kápi u'	TENSE:IPFV_HAB, ASPECT:IPFV	Mari kë̀ ku̠ dapö́k
Bribri0740	Maria dör kápi u'	TYPE:NEG, TENSE:IPFV_HAB, ASPECT:IPFV	Mari kë̀ ku̠ dapö́k
Bribri0741	Maria dör kápi u'	TENSE:FUT_POT, ASPECT:IPFV	Mari kë̀ ku̠ dapö́k
Bribri0742	Maria dör kápi u'	TYPE:NEG, TENSE:FUT_POT, ASPECT:IPFV	Mari kë̀ ku̠ dapö́k
Bribri0743	Maria dör kápi u'	TENSE:FUT_CER, ASPECT:IPFV	Mari kë̀ ku̠ dapö́k
Bribri0744	Maria dör kápi u'	TYPE:NEG, TENSE:FUT_CER, ASPECT:IPFV	Sa àa  ki̠wa̠
Bribri0745	Maria dör kápi u'	VOICE:MID	Mari kë̀ ku̠ dapö́k
Bribri0746	Maria dör kápi u'	TYPE:NEG, VOICE:MID	Mari kë̀ ku̠ dapö́k
Bribri0747	Maria dör kápi u'	TENSE:PRF_REC, VOICE:MID	Mari kë̀ ku̠ dapö́k
Bribri0748	Maria dör kápi u'	TYPE:NEG, TENSE:PRF_REC, VOICE:MID	Mari kë̀ ku̠ dapö́k
Bribri0749	Maria dör kápi u'	TENSE:IPFV_REC, ASPECT:IPFV, VOICE:MID	Mari kë̀ ku̠ dapö́k
Bribri0750	Maria dör kápi u'	TYPE:NEG, TENSE:IPFV_REC, ASPECT:IPFV, VOICE:MID	Mari kë̀ ku̠ dapö́k
Bribri0751	Maria dör kápi u'	TENSE:IPFV_HAB, ASPECT:IPFV, VOICE:MID	Mari kë̀ ku̠ dapö́k
Bribri0752	Maria dör kápi u'	TYPE:NEG, TENSE:IPFV_HAB, ASPECT:IPFV, VOICE:MID	Mari kë̀ ku̠ dapö́k
Bribri0753	Maria dör kápi u'	TENSE:FUT_POT, ASPECT:IPFV, VOICE:MID	Mari kë̀ ku̠ dapö́k
Bribri0754	Maria dör kápi u'	TYPE:NEG, TENSE:FUT_POT, ASPECT:IPFV, VOICE:MID	Mari kë̀ ku̠ dapö́k
Bribri0755	Maria dör kápi u'	TENSE:FUT_CER, ASPECT:IPFV, VOICE:MID	Mari kë̀ ku̠ dapö́k
Bribri0756	Maria dör kápi u'	TYPE:NEG, TENSE:FUT_CER, ASPECT:IPFV, VOICE:MID	Mhìch wa̠ Mali ulpárule
Bribri0757	Maria dör kápi u'	TENSE:PAS_PLU	Mari kë̀ ku̠ dapö́k
Bribri0758	Maria dör kápi u'	TYPE:NEG, TENSE:PAS_PLU	Mari kë̀ ku̠ dapö́k
Bribri0759	Maria dör kápi u'	MODE:POT, TENSE:IPFV_REC, ASPECT:IPFV	Mari kë̀ ku̠ dapö́k
Bribri0760	Maria dör kápi u'	TYPE:NEG, MODE:POT, TENSE:IPFV_REC, ASPECT:IPFV	Ye' ts̠ è̠ba̠
Bribri0336	Ye' ka̠nè̠balë'	TENSE:IPFV_REC, ASPECT:IPFV, VOICE:MID, ABSNUM:NI, PERSON:NA	Ye' ts̠ è̠ba̠
Bribri0337	Ye' ka̠nè̠balë'	TYPE:NEG, TENSE:IPFV_REC, ASPECT:IPFV, VOICE:MID, ABSNUM:NI, PERSON:NA	Kë̀ ye' kë̀ wa̠ i yë̀ne̠
Bribri0932	Ye' tö i yë́	TYPE:NEG	Be' tö i ye' i yí́
Bribri0933	Ye' tö i yë́	PERSON:2_SI	Ye' tö i yë́r
Bribri0934	Ye' tö i yë́	TYPE:NEG, PERSON:2_SI	Ie' i yë̀ne̠
Bribri0935	Ye' tö i yë́	PERSON:3_SI	Ye' tö i yë́r
Bribri0936	Ye' tö i yë́	TYPE:NEG, PERSON:3_SI	Sa' tö i yëa'ma̠
Bribri0937	Ye' tö i yë́	PERSON:1_PL_EXC	Ye' tö i yë́r
Bribri0938	Ye' tö i yë́	TYPE:NEG, PERSON:1_PL_EXC	Se' ts yö̀ sö
Bribri0939	Ye' tö i yë́	PERSON:1_PL_INC	Ye' tö i yë́r
Bribri0940	Ye' tö i yë́	TYPE:NEG, PERSON:1_PL_INC	A' i yÁA̠
Bribri0941	Ye' tö i yë́	PERSON:2_PL	Ye' tö i yë́r
Bribri0942	Ye' tö i yë́	TYPE:NEG, PERSON:2_PL	Ie'pa ts i yë'
Bribri0943	Ye' tö i yë́	PERSON:3_PL	Ye' tö i yë́r
Bribri0944	Ye' tö i yë́	TYPE:NEG, PERSON:3_PL	Ye' tö i yéste̠
Bribri0945	Ye' tö i yë́	TENSE:PRF_REC	Ye' tö i yë́r
Bribri0946	Ye' tö i yë́	TENSE:IPFV_REC, ASPECT:IPFV	Ye' tö i yë́r
Bribri0947	Ye' tö i yë́	TENSE:IPFV_PROG, ASPECT:IPFV	Ye' tö i yë́r
Bribri0948	Ye' tö i yë́	TYPE:NEG, TENSE:IPFV_PROG, ASPECT:IPFV	Ye' bák i yák i yá́k
Bribri0949	Ye' tö i yë́	TENSE:PRF_PROG	Ye' tö i yë́r
Bribri0950	Ye' tö i yë́	TYPE:NEG, TENSE:PRF_PROG	Ye' tö i yë́r
Bribri0951	Ye' tö i yë́	MODE:IMP, TENSE:IPFV_REC, ASPECT:IPFV, PERSON:NA	Ye' tö i yë́r
Bribri0952	Ye' tö i yë́	TENSE:FUT_POT, ASPECT:IPFV	Ye' tö i yë́r
Bribri0953	Ye' tö i yë́	TENSE:IPFV_HAB, ASPECT:IPFV	Ye' tö i yë́r
Bribri0954	Ye' tö i yë́	VOICE:MID, ABSNUM:NI, PERSON:NA	Ye' tö i yë́r
Bribri0955	Ye' tö i yë́	TYPE:NEG, VOICE:MID, ABSNUM:NI, PERSON:NA	Ye' tö i yë́r
Bribri0956	Ye' tö i yë́	TENSE:IPFV_REC, ASPECT:IPFV, VOICE:MID, ABSNUM:NI, PERSON:NA	Ye' shka'mi̠
Bribri0424	Ye' tö shkame̠' yö'	ASPECT:INC	Kë̀ ye' shkàne̠
Bribri0425	Ye' tö shkame̠' yö'	TYPE:NEG	Ye' shké
Bribri0426	Ye' tö shkame̠' yö'	TENSE:PRF_REC	Ye' shkö̀
Bribri0427	Ye' tö shkame̠' yö'	TENSE:PRF_REC, ASPECT:INC	Ye' shkö̀
Bribri0428	Ye' tö shkame̠' yö'	TYPE:NEG, TENSE:PRF_REC	Ye' shkö̀
Bribri0429	Ye' tö shkame̠' yö'	TENSE:IPFV_REC, ASPECT:IPFV	Ye' shkö̀
Bribri0430	Ye' tö shkame̠' yö'	TYPE:NEG, TENSE:IPFV_REC, ASPECT:IPFV	Ye' shkö̀
Bribri0431	Ye' tö shkame̠' yö'	MODE:POT, TENSE:IPFV_REC, ASPECT:IPFV	Ye' shkö̀
Bribri0432	Ye' tö shkame̠' yö'	TYPE:NEG, MODE:POT, TENSE:IPFV_REC, ASPECT:IPFV	Ye' shkö̀
Bribri0433	Ye' tö shkame̠' yö'	TENSE:IPFV_PROG, ASPECT:IPFV	Ye' shkö̀
Bribri0434	Ye' tö shkame̠' yö'	TYPE:NEG, TENSE:IPFV_PROG, ASPECT:IPFV	Ye' bák shkö́k
Bribri0435	Ye' tö shkame̠' yö'	TENSE:PRF_PROG	Ye' shkö̀
Bribri0436	Ye' tö shkame̠' yö'	TYPE:NEG, TENSE:PRF_PROG	Ye' shkö̀
Bribri0437	Ye' tö shkame̠' yö'	MODE:IMP, TENSE:IPFV_REC, ASPECT:IPFV, PERSON:NA	Ye' shkö̀
Bribri0438	Ye' tö shkame̠' yö'	TYPE:NEG, MODE:IMP, TENSE:IPFV_REC, ASPECT:IPFV, PERSON:NA	Ye' shkö̀
Bribri0439	Ye' tö shkame̠' yö'	TYPE:NEG, MODE:IMP, TENSE:IPFV_REC, ASPECT:IPFV, VOICE:MID, PERSON:NA	Ye' shkö̀
Bribri0440	Ye' tö shkame̠' yö'	MODE:EXH, TENSE:IPFV_REC, ASPECT:IPFV, PERSON:1_PL_INC	Ye' shkö̀
Bribri0441	Ye' tö shkame̠' yö'	MODE:DES, TENSE:IPFV_REC, ASPECT:IPFV	Ye' shkö̀
Bribri0442	Ye' tö shkame̠' yö'	TYPE:NEG, MODE:DES, TENSE:IPFV_REC, ASPECT:IPFV	Ye' shka'
Bribri0443	Ye' tö shkame̠' yö'	MODE:ADVERS	Ye' shkö̀
Bribri0444	Ye' tö shkame̠' yö'	TENSE:IPFV_HAB, ASPECT:IPFV	Ye' shkö̀
Bribri0445	Ye' tö shkame̠' yö'	TYPE:NEG, TENSE:IPFV_HAB, ASPECT:IPFV	Ye' shkö̀
Bribri0446	Ye' tö shkame̠' yö'	TENSE:FUT_POT, ASPECT:IPFV	Ye' shkö̀
Bribri0447	Ye' tö shkame̠' yö'	TYPE:NEG, TENSE:FUT_POT, ASPECT:IPFV	Ye' shkö̀
Bribri0448	Ye' tö shkame̠' yö'	TENSE:FUT_CER, ASPECT:IPFV	Ye' shkö̀
Bribri0449	Ye' tö shkame̠' yö'	TYPE:NEG, TENSE:FUT_CER, ASPECT:IPFV	Ye' shkö̀
Bribri0450	Ye' tö shkame̠' yö'	VOICE:MID, PERSON:NA	Ye' shkö̀
Bribri0451	Ye' tö shkame̠' yö'	TYPE:NEG, VOICE:MID, PERSON:NA	Ye' shkö̀
Bribri0452	Ye' tö shkame̠' yö'	TENSE:PRF_REC, VOICE:MID, PERSON:NA	Ye' shkö̀
Bribri0453	Ye' tö shkame̠' yö'	TYPE:NEG, TENSE:PRF_REC, VOICE:MID, PERSON:NA	Ye' shkö̀
Bribri0454	Ye' tö shkame̠' yö'	TENSE:IPFV_REC, ASPECT:IPFV, VOICE:MID, PERSON:NA	Ye' shkö̀
Bribri0455	Ye' tö shkame̠' yö'	TYPE:NEG, TENSE:IPFV_REC, ASPECT:IPFV, VOICE:MID, PERSON:NA	Ye' shkö̀
Bribri0456	Ye' tö shkame̠' yö'	TENSE:IPFV_HAB, ASPECT:IPFV, VOICE:MID, PERSON:NA	Ye' shkö̀
Bribri0457	Ye' tö shkame̠' yö'	TYPE:NEG, TENSE:IPFV_HAB, ASPECT:IPFV, VOICE:MID, PERSON:NA	Ye' shkö̀
Bribri0458	Ye' tö shkame̠' yö'	TENSE:FUT_POT, ASPECT:IPFV, VOICE:MID, PERSON:NA	Ye' shkö̀
Bribri0459	Ye' tö shkame̠' yö'	TYPE:NEG, TENSE:FUT_POT, ASPECT:IPFV, VOICE:MID, PERSON:NA	Ye' shkö̀
Bribri0460	Ye' tö shkame̠' yö'	TENSE:FUT_CER, ASPECT:IPFV, VOICE:MID, PERSON:NA	Ye' shkö̀
Bribri0461	Ye' tö shkame̠' yö'	TYPE:NEG, TENSE:FUT_CER, ASPECT:IPFV, VOICE:MID, PERSON:NA	Ye' shkö̀
Bribri0462	Ye' tö shkame̠' yö'	TENSE:PAS_PLU, VOICE:MID	Ye' shkö̀
Bribri0463	Ye' tö shkame̠' yö'	TYPE:NEG, TENSE:PAS_PLU, VOICE:MID	Kë̀ ye' kë̀ ku̠ kàpì ye̠
Bribri0253	Ye' tö kápi ya'	TYPE:NEG	Ye' tö kàpi ye'
Bribri0254	Ye' tö kápi ya'	TENSE:IPFV_PROG, ASPECT:IPFV	Ye' tö kàpi ye'
Bribri0255	Ye' tö kápi ya'	TYPE:NEG, TENSE:IPFV_PROG, ASPECT:IPFV	Ye' bák ku'ba̠k ku̠'bak kàpa ye' ku̠
Bribri0256	Ye' tö kápi ya'	TENSE:PRF_PROG	Ye' tö kàpi ye'
Bribri0257	Ye' tö kápi ya'	TYPE:NEG, TENSE:PRF_PROG	Ye' tö kàpa yéstsa̠
Bribri0258	Ye' tö kápi ya'	TENSE:PRF_REC	Ye' tö kàpi ye'
Bribri0259	Ye' tö kápi ya'	TYPE:NEG, TENSE:PRF_REC	Ye' tö kàpi ye'
Bribri0260	Ye' tö kápi ya'	TENSE:IPFV_REC, ASPECT:IPFV	Ye' tö kàpi ye'
Bribri0261	Ye' tö kápi ya'	TYPE:NEG, TENSE:IPFV_REC, ASPECT:IPFV	Ye' tö kàpi ye'
Bribri0262	Ye' tö kápi ya'	TENSE:IPFV_HAB, ASPECT:IPFV	Ye' tö kàpi ye'
Bribri0263	Ye' tö kápi ya'	TYPE:NEG, TENSE:IPFV_HAB, ASPECT:IPFV	Ye' tö kàpi ye'
Bribri0264	Ye' tö kápi ya'	TENSE:FUT_CER, ASPECT:IPFV	Ye' tö kàpi ye'
Bribri0265	Ye' tö kápi ya'	TYPE:NEG, TENSE:FUT_CER, ASPECT:IPFV	Ye' tö kàpi ye'
Bribri0266	Ye' tö kápi ya'	VOICE:MID, PERSON:NA	Ye' tö kàpi ye'
Bribri0267	Ye' tö kápi ya'	TYPE:NEG, VOICE:MID, PERSON:NA	Ye' tö kàpi ye'
Bribri0268	Ye' tö kápi ya'	TENSE:PRF_REC, VOICE:MID, PERSON:NA	Ye' tö kàpi ye'
Bribri0269	Ye' tö kápi ya'	TYPE:NEG, TENSE:PRF_REC, VOICE:MID, PERSON:NA	Ye' tö kàpi ye'
Bribri0270	Ye' tö kápi ya'	TENSE:IPFV_REC, ASPECT:IPFV, VOICE:MID, PERSON:NA	Ye' tö kàpi ye'
Bribri0271	Ye' tö kápi ya'	TYPE:NEG, TENSE:IPFV_REC, ASPECT:IPFV, VOICE:MID, PERSON:NA	Ye' tö kàpi ye'
Bribri0272	Ye' tö kápi ya'	TENSE:IPFV_HAB, ASPECT:IPFV, VOICE:MID, PERSON:NA	Ye' tö kàpi ye'
Bribri0273	Ye' tö kápi ya'	TYPE:NEG, TENSE:IPFV_HAB, ASPECT:IPFV, VOICE:MID, PERSON:NA	Ye' tö kàpi ye'
Bribri0274	Ye' tö kápi ya'	MODE:IMP, TENSE:IPFV_REC, ASPECT:IPFV, PERSON:NA	Ye' tö kàpi ye'
Bribri0275	Ye' tö kápi ya'	TYPE:NEG, MODE:IMP, TENSE:IPFV_REC, ASPECT:IPFV, PERSON:NA	Ye' tö kàpi ye'
Bribri0276	Ye' tö kápi ya'	MODE:DES, TENSE:IPFV_REC, ASPECT:IPFV	Ye' tö kàpi ye'
Bribri0277	Ye' tö kápi ya'	MODE:DES, TENSE:IPFV_REC, ASPECT:IPFV, VOICE:MID, PERSON:NA	Ye' tö kàpi ye'
Bribri0278	Ye' tö kápi ya'	TENSE:FUT_POT, ASPECT:IPFV	Ye' tö kàpi ye'
Bribri0279	Ye' tö kápi ya'	TYPE:NEG, TENSE:FUT_POT, ASPECT:IPFV	Ye' tö kàpi ye'
Bribri0280	Ye' tö kápi ya'	TENSE:FUT_POT, ASPECT:IPFV, VOICE:MID, PERSON:NA	Ye' tö kàpi ye'
Bribri0281	Ye' tö kápi ya'	TYPE:NEG, TENSE:FUT_POT, ASPECT:IPFV, VOICE:MID, PERSON:NA	Ye' tö kàpi ye'
Bribri0282	Ye' tö kápi ya'	MODE:ADVERS, VOICE:MID, PERSON:NA	Ye' wa̠ kuli ye' tspá ye
Bribri0283	Ye' tö kápi ya'	TENSE:PAS_PLU	Ye' tö kàpi ye'
Bribri0284	Ye' tö kápi ya'	TYPE:NEG, TENSE:PAS_PLU	Kë̀ ie' uj
Bribri0989	Ye' úk	TYPE:NEG	Be' úk
Bribri0990	Ye' úk	PERSON:2_SI	Ye' úkö̀
Bribri0991	Ye' úk	TYPE:NEG, PERSON:2_SI	Ye' úkö̀
Bribri0992	Ye' úk	TENSE:IPFV_REC, ASPECT:IPFV	Ye' úkö̀
Bribri0993	Ye' úk	TENSE:IPFV_PROG, ASPECT:IPFV	Ye' úkö̀
Bribri0994	Ye' úk	TYPE:NEG, TENSE:IPFV_PROG, ASPECT:IPFV	Ye' bák úa
Bribri0995	Ye' úk	TENSE:PRF_PROG	Ye' úkö̀
Bribri0996	Ye' úk	TYPE:NEG, TENSE:PRF_PROG	Ye' úkö̀
Bribri0997	Ye' úk	MODE:IMP, TENSE:IPFV_REC, ASPECT:IPFV, PERSON:2_SI	Ye' úkö̀
Bribri0998	Ye' úk	TENSE:IPFV_HAB, ASPECT:IPFV	Ye' úkö̀
Bribri0999	Ye' úk	VOICE:MID, ABSNUM:NI, PERSON:NA	Ye' úkö̀
Bribri1000	Ye' úk	TYPE:NEG, VOICE:MID, ABSNUM:NI, PERSON:NA	Ye' úkö̀
Bribri1001	Ye' úk	TENSE:IPFV_REC, ASPECT:IPFV, VOICE:MID, ABSNUM:NI, PERSON:NA	Kë̀ kë̀ ku̠  te̠r kà̠u̠k a̠
Bribri0869	Ka̠no̠' te̠n ká̠u̠k a̠	TYPE:NEG	Ie' o̠' te̠ Kkà̠ŕ̠
Bribri0870	Ka̠no̠' te̠n ká̠u̠k a̠	TENSE:PRF_REM, ASPECT:PFV	Ie' o̠' te̠ Kkà̠ŕ̠
Bribri0871	Ka̠no̠' te̠n ká̠u̠k a̠	TYPE:NEG, TENSE:PRF_REM, ASPECT:PFV	Ie' të̀ ku̠ iëërke kàe
Bribri0872	Ka̠no̠' te̠n ká̠u̠k a̠	ABSNUM:PL	Ie' o̠' te̠ Kkà̠ŕ̠
Bribri0873	Ka̠no̠' te̠n ká̠u̠k a̠	TYPE:NEG, ABSNUM:PL	Ie' o̠' te̠ Kkà̠ŕ̠
Bribri0874	Ka̠no̠' te̠n ká̠u̠k a̠	TENSE:PRF_REM, ASPECT:PFV, ABSNUM:PL	Ie' o̠' te̠ Kkà̠ŕ̠
Bribri0875	Ka̠no̠' te̠n ká̠u̠k a̠	TYPE:NEG, TENSE:PRF_REM, ASPECT:PFV, ABSNUM:PL	Kë̀ ye' u̠n bë̀ne̠
Bribri0001	Ie' tso bua'	TYPE:NEG	Ie' tso bur
Bribri0002	Ie' tso bua'	TENSE:PRF_REM, ASPECT:PFV	Ie' tso bur
Bribri0003	Ie' tso bua'	TYPE:NEG, TENSE:PRF_REM, ASPECT:PFV	Ie' tso bur
Bribri0004	Ie' tso bua'	PERSON:1_SI	Ie' tso bur
Bribri0005	Ie' tso bua'	TYPE:NEG, PERSON:1_SI	Ie' tso bur
Bribri0006	Ie' tso bua'	TENSE:PRF_REM, ASPECT:PFV, PERSON:1_SI	Ie' tso bur
Bribri0007	Ie' tso bua'	TYPE:NEG, TENSE:PRF_REM, ASPECT:PFV, PERSON:1_SI	Be' tö be' bur
Bribri0008	Ie' tso bua'	PERSON:2_SI	Ie' tso bur
Bribri0009	Ie' tso bua'	TYPE:NEG, PERSON:2_SI	Ie' tso bur
Bribri0010	Ie' tso bua'	TENSE:PRF_REM, ASPECT:PFV, PERSON:2_SI	Ie' tso bur
Bribri0011	Ie' tso bua'	TYPE:NEG, TENSE:PRF_REM, ASPECT:PFV, PERSON:2_SI	Ie' tso bur
Bribri0012	Ie' tso bua'	ABSNUM:PL, PERSON:1_PL_EXC	Ie' tso bur
Bribri0013	Ie' tso bua'	TYPE:NEG, ABSNUM:PL, PERSON:1_PL_EXC	Ie' tso bur
Bribri0014	Ie' tso bua'	TENSE:PRF_REM, ASPECT:PFV, ABSNUM:PL, PERSON:1_PL_EXC	Ie' tso bur
Bribri0015	Ie' tso bua'	TYPE:NEG, TENSE:PRF_REM, ASPECT:PFV, ABSNUM:PL, PERSON:1_PL_EXC	Ie' tso bur
Bribri0016	Ie' tso bua'	ABSNUM:PL, PERSON:1_PL_INC	Ie' tso bur
Bribri0017	Ie' tso bua'	TYPE:NEG, ABSNUM:PL, PERSON:1_PL_INC	Ie' tso bur
Bribri0018	Ie' tso bua'	TENSE:PRF_REM, ASPECT:PFV, ABSNUM:PL, PERSON:1_PL_INC	Ie' tso bur
Bribri0019	Ie' tso bua'	TYPE:NEG, TENSE:PRF_REM, ASPECT:PFV, ABSNUM:PL, PERSON:1_PL_INC	Ie' tso bur
Bribri0020	Ie' tso bua'	ABSNUM:PL, PERSON:2_PL	Ie' tso bur
Bribri0021	Ie' tso bua'	TYPE:NEG, ABSNUM:PL, PERSON:2_PL	Ie' tso bur
Bribri0022	Ie' tso bua'	TENSE:PRF_REM, ASPECT:PFV, ABSNUM:PL, PERSON:2_PL	Ie' tso bur
Bribri0023	Ie' tso bua'	TYPE:NEG, TENSE:PRF_REM, ASPECT:PFV, ABSNUM:PL, PERSON:2_PL	Ie' tso bur
Bribri0024	Ie' tso bua'	ABSNUM:PL, PERSON:3_PL	Ie' tso bur
Bribri0025	Ie' tso bua'	TYPE:NEG, ABSNUM:PL, PERSON:3_PL	Ie' tso bur
Bribri0026	Ie' tso bua'	TENSE:PRF_REM, ASPECT:PFV, ABSNUM:PL, PERSON:3_PL	Ie' tso bur
Bribri0027	Ie' tso bua'	TYPE:NEG, TENSE:PRF_REM, ASPECT:PFV, ABSNUM:PL, PERSON:3_PL	Ye' ujë́rke
Bribri0464	Ye' tö uyë̀jkuö à̠ríts	TENSE:IPFV_PROG, ASPECT:IPFV, PERSON:3_SI	Ye' ujë́rke
Bribri0465	Ye' tö uyë̀jkuö à̠ríts	TENSE:IPFV_REC, ASPECT:IPFV	Ye' ujë́rke
Bribri0466	Ye' tö uyë̀jkuö à̠ríts	TYPE:NEG, TENSE:IPFV_REC, ASPECT:IPFV	Ye' ujë́rke
Bribri0467	Ye' tö uyë̀jkuö à̠ríts	MODE:POT, TENSE:IPFV_REC, ASPECT:IPFV, PERSON:3_SI	Ye' ujë́rke
Bribri0468	Ye' tö uyë̀jkuö à̠ríts	TYPE:NEG, MODE:POT, TENSE:IPFV_REC, ASPECT:IPFV, PERSON:3_SI	Kë̀ ye' tsirö́k
Bribri0388	Chìchi dör tsîr	ABSNUM:PL	Kë̀ kë̀ ku̠ uàl ulà ki̠
Bribri0848	Dù tkër kàl ulà ki̠	TYPE:NEG	Ie' tö  ààl ulà ki̠
Bribri0849	Dù tkër kàl ulà ki̠	TENSE:PRF_REM, ASPECT:PFV	Ie' tö  ààl ulà ki̠
Bribri0850	Dù tkër kàl ulà ki̠	TYPE:NEG, TENSE:PRF_REM, ASPECT:PFV	Ie' tö  kàl ulà ki̠
Bribri0851	Dù tkër kàl ulà ki̠	ABSNUM:PL	Ie' tö  ààl ulà ki̠
Bribri0852	Dù tkër kàl ulà ki̠	TYPE:NEG, ABSNUM:PL	Ie' tö  ààl ulà ki̠
Bribri0853	Dù tkër kàl ulà ki̠	TENSE:PRF_REM, ASPECT:PFV, ABSNUM:PL	Ie' tö  ààl ulà ki̠
Bribri0854	Dù tkër kàl ulà ki̠	TYPE:NEG, TENSE:PRF_REM, ASPECT:PFV, ABSNUM:PL	Ie' i̠
Bribri0028	Ye' i̠ni̠'	PERSON:3_SI	Be' i̠n ̠'
Bribri0029	Ye' i̠ni̠'	PERSON:2_SI	Ye' i̠n ̠
Bribri0030	Ye' i̠ni̠'	ABSNUM:PL, PERSON:1_PL_EXC	Ye' i̠n ̠
Bribri0031	Ye' i̠ni̠'	ABSNUM:PL, PERSON:1_PL_INC	Ye' i̠n ̠
Bribri0032	Ye' i̠ni̠'	ABSNUM:PL, PERSON:2_PL	Ye' i̠n ̠
Bribri0033	Ye' i̠ni̠'	ABSNUM:PL, PERSON:3_PL	Ye' i̠n ̠
Bribri0034	Ye' i̠ni̠'	TENSE:PRF_REC, PERSON:3_SI	Ye' s̠
Bribri0035	Ye' i̠ni̠'	TENSE:PRF_REC	Ye' i̠n ̠
Bribri0036	Ye' i̠ni̠'	TENSE:PRF_REC, PERSON:2_SI	Ye' i̠n ̠
Bribri0037	Ye' i̠ni̠'	TENSE:PRF_REC, ABSNUM:PL, PERSON:1_PL_EXC	Ye' i̠n ̠
Bribri0038	Ye' i̠ni̠'	TENSE:PRF_REC, ABSNUM:PL, PERSON:1_PL_INC	Ye' i̠n ̠
Bribri0039	Ye' i̠ni̠'	TENSE:PRF_REC, ABSNUM:PL, PERSON:2_PL	Ye' i̠n ̠
Bribri0040	Ye' i̠ni̠'	TENSE:PRF_REC, ABSNUM:PL, PERSON:3_PL	Ye' i̠n ̠
Bribri0041	Ye' i̠ni̠'	TENSE:IPFV_REC, ASPECT:IPFV, PERSON:3_SI	Ye' i̠n ̠
Bribri0042	Ye' i̠ni̠'	TENSE:IPFV_REC, ASPECT:IPFV	Ye' i̠n ̠
Bribri0043	Ye' i̠ni̠'	TENSE:IPFV_HAB, ASPECT:IPFV, PERSON:3_SI	Ye' i̠n ̠
Bribri0044	Ye' i̠ni̠'	TENSE:IPFV_HAB, ASPECT:IPFV	Ye' i̠n ̠
Bribri0045	Ye' i̠ni̠'	TYPE:NEG, TENSE:IPFV_HAB, ASPECT:IPFV	Ye' i̠n ̠
Bribri0046	Ye' i̠ni̠'	TENSE:IPFV_REC, ASPECT:IPFV, VOICE:MID, ABSNUM:NI, PERSON:NA	Ye' i̠n ̠
Bribri0047	Ye' i̠ni̠'	VOICE:MID, ABSNUM:NI, PERSON:NA	Ye' i̠n ̠
Bribri0048	Ye' i̠ni̠'	TYPE:NEG, VOICE:MID	Ye' i̠n ̠
Bribri0049	Ye' i̠ni̠'	TENSE:FUT_CER, ASPECT:IPFV	Ye' i̠n ̠
Bribri0050	Ye' i̠ni̠'	TYPE:NEG, TENSE:FUT_CER, ASPECT:IPFV	Ye' i̠n ̠
Bribri0051	Ye' i̠ni̠'	TENSE:IPFV_PROG, ASPECT:IPFV	Ye' i̠n ̠
Bribri0052	Ye' i̠ni̠'	TYPE:NEG, TENSE:IPFV_REC, ASPECT:IPFV	Ye' sínó̠
Bribri0053	Ye' i̠ni̠'	TENSE:PAS_PLU	Ye' i̠n ̠
Bribri0054	Ye' i̠ni̠'	TYPE:NEG, TENSE:PAS_PLU	Ye' i̠n ̠
Bribri0055	Ye' i̠ni̠'	TENSE:FUT_POT, ASPECT:IPFV	Ye' i̠n ̠
Bribri0056	Ye' i̠ni̠'	TYPE:NEG, TENSE:FUT_POT, ASPECT:IPFV	Ye' i̠n ̠
Bribri0057	Ye' i̠ni̠'	MODE:DES, TENSE:IPFV_REC, ASPECT:IPFV, PERSON:3_SI	Ye' i̠n ̠
Bribri0058	Ye' i̠ni̠'	MODE:EXH, TENSE:IPFV_REC, ASPECT:IPFV, ABSNUM:PL, PERSON:1_PL_INC	Ye' i̠n ̠
Bribri0059	Ye' i̠ni̠'	MODE:IMP, TENSE:IPFV_REC, ASPECT:IPFV, PERSON:2_SI	Ye' i̠n ̠
Bribri0060	Ye' i̠ni̠'	TYPE:NEG, MODE:IMP, TENSE:IPFV_REC, ASPECT:IPFV, PERSON:2_SI	Ye' i̠n ̠
Bribri0061	Ye' i̠ni̠'	MODE:POT, TENSE:IPFV_REC, ASPECT:IPFV, PERSON:3_SI	Ye' i̠n ̠
Bribri0062	Ye' i̠ni̠'	TYPE:NEG, MODE:POT, TENSE:IPFV_REC, ASPECT:IPFV, PERSON:3_SI	Kë̀ ku̠ të̀ ku̠ 'e̠
Bribri0883	Ie' tkër kula' ki̠	TYPE:NEG	Ie' tö  ku̠r ku̠
Bribri0884	Ie' tkër kula' ki̠	TENSE:PRF_REM, ASPECT:PFV	Ie' tö  ku̠r ku̠
Bribri0885	Ie' tkër kula' ki̠	TYPE:NEG, TENSE:PRF_REM, ASPECT:PFV	Ie' tö  ku̠r ku̠
Bribri0886	Ie' tkër kula' ki̠	ABSNUM:PL, PERSON:3_PL	Ie' tö  ku̠r ku̠
Bribri0887	Ie' tkër kula' ki̠	TYPE:NEG, ABSNUM:PL, PERSON:3_PL	Ie' tö  ku̠r ku̠
Bribri0888	Ie' tkër kula' ki̠	TENSE:PRF_REM, ASPECT:PFV, ABSNUM:PL, PERSON:3_PL	Ie' tö  ku̠r ku̠
Bribri0889	Ie' tkër kula' ki̠	TYPE:NEG, TENSE:PRF_REM, ASPECT:PFV, ABSNUM:PL, PERSON:3_PL	Ie' tskö̀
Bribri0141	Be' chka'	TENSE:IPFV_PROG, ASPECT:IPFV	Ie' tskö̀
Bribri0142	Be' chka'	TYPE:NEG, TENSE:IPFV_PROG, ASPECT:IPFV	Ie' tskö̀
Bribri0143	Be' chka'	MODE:IMP, TENSE:IPFV_REC, ASPECT:IPFV	Ie' tskö̀
Bribri0144	Be' chka'	TYPE:NEG, MODE:IMP, TENSE:IPFV_REC, ASPECT:IPFV	Ye' tsë̀ s stsö́k
Bribri0248	Ye' tö i stsë'	TENSE:IPFV_REC, ASPECT:IPFV, VOICE:MID, PERSON:3_SI	Ye' tsë̀ s stsö́k
Bribri0249	Ye' tö i stsë'	TENSE:IPFV_HAB, ASPECT:IPFV, VOICE:MID, PERSON:3_SI	Ye' tsë̀ s stsö́k
Bribri0250	Ye' tö i stsë'	TYPE:NEG, TENSE:IPFV_HAB, ASPECT:IPFV, VOICE:MID, PERSON:3_SI	Ye' tsë̀ s stsö́k
Bribri0251	Ye' tö i stsë'	TENSE:FUT_POT, ASPECT:IPFV, VOICE:MID, PERSON:3_SI	Ye' tsë̀ s stsö́k
Bribri0252	Ye' tö i stsë'	TYPE:NEG, TENSE:FUT_POT, ASPECT:IPFV, VOICE:MID, PERSON:3_SI	Ie' e̠' tkë'ra̠
Bribri0385	Ie' e̠' tkë'wa̠	ABSNUM:PL, PERSON:3_PL	Kë̀ chìchi kë̀ ku̠ të̀ ku̠ te̠r ië'te̠
Bribri0521	Kirë̀ tö tabè a̠me̠' ie' a̠	TYPE:NEG	Ie' tö ta̠mi̠'mi̠'mi̠
Bribri0522	Kirë̀ tö tabè a̠me̠' ie' a̠	ASPECT:INC	Ie' tö ta̠ a̠
Bribri0523	Kirë̀ tö tabè a̠me̠' ie' a̠	TENSE:PRF_REC	Ie' tö ta̠ a̠' ië' tsm a̠
Bribri0524	Kirë̀ tö tabè a̠me̠' ie' a̠	TYPE:NEG, TENSE:PRF_REC	Ie' tö ta̠ a̠' ië' tsm a̠
Bribri0525	Kirë̀ tö tabè a̠me̠' ie' a̠	TENSE:PRF_REC, ASPECT:INC	Ie' tö ta̠ a̠' ië' tsm a̠
Bribri0526	Kirë̀ tö tabè a̠me̠' ie' a̠	TENSE:IPFV_REC, ASPECT:IPFV	Ie' tö ta̠ a̠' ië' tsm a̠
Bribri0527	Kirë̀ tö tabè a̠me̠' ie' a̠	TYPE:NEG, TENSE:IPFV_REC, ASPECT:IPFV	Ie' tö ta̠ a̠' ië' tsm a̠
Bribri0528	Kirë̀ tö tabè a̠me̠' ie' a̠	TENSE:IPFV_PROG, ASPECT:IPFV	Ie' tö ta̠ a̠' ië' tsm a̠
Bribri0529	Kirë̀ tö tabè a̠me̠' ie' a̠	TYPE:NEG, TENSE:IPFV_PROG, ASPECT:IPFV	Ie' bák tsbö́k
Bribri0530	Kirë̀ tö tabè a̠me̠' ie' a̠	TENSE:PRF_PROG	Ie' tö ta̠ a̠' ië' tsm a̠
Bribri0531	Kirë̀ tö tabè a̠me̠' ie' a̠	TYPE:NEG, TENSE:PRF_PROG	Ie' tö ta̠ a̠' ië' tsm a̠
Bribri0532	Kirë̀ tö tabè a̠me̠' ie' a̠	MODE:IMP, TENSE:IPFV_REC, ASPECT:IPFV	Ie' tö ta̠ a̠' ië' tsm a̠
Bribri0533	Kirë̀ tö tabè a̠me̠' ie' a̠	TYPE:NEG, MODE:IMP, TENSE:IPFV_REC, ASPECT:IPFV	Ie' tö ta̠ a̠' ië' tsm a̠
Bribri0534	Kirë̀ tö tabè a̠me̠' ie' a̠	TYPE:NEG, MODE:IMP, TENSE:IPFV_REC, ASPECT:IPFV, VOICE:MID	Ie' tö ta̠ a̠' ië' tsm a̠
Bribri0535	Kirë̀ tö tabè a̠me̠' ie' a̠	MODE:EXH, TENSE:IPFV_REC, ASPECT:IPFV, PERSON:1_PL_INC	Ie' tö ta̠ a̠' ië' tsm a̠
Bribri0536	Kirë̀ tö tabè a̠me̠' ie' a̠	MODE:DES, TENSE:IPFV_REC, ASPECT:IPFV	Ie' tö ta̠ a̠' ië' tsm a̠
Bribri0537	Kirë̀ tö tabè a̠me̠' ie' a̠	TYPE:NEG, MODE:DES, TENSE:IPFV_REC, ASPECT:IPFV	Ie' wa̠ Ka  a̠wa̠' ia''a̠
Bribri0538	Kirë̀ tö tabè a̠me̠' ie' a̠	MODE:ADVERS	Ie' tö ta̠ a̠' ië' tsm a̠
Bribri0539	Kirë̀ tö tabè a̠me̠' ie' a̠	TENSE:IPFV_HAB, ASPECT:IPFV	Ie' tö ta̠ a̠' ië' tsm a̠
Bribri0540	Kirë̀ tö tabè a̠me̠' ie' a̠	TYPE:NEG, TENSE:IPFV_HAB, ASPECT:IPFV	Ie' tö ta̠ a̠' ië' tsm a̠
Bribri0541	Kirë̀ tö tabè a̠me̠' ie' a̠	TENSE:FUT_POT, ASPECT:IPFV	Ie' tö ta̠ a̠' ië' tsm a̠
Bribri0542	Kirë̀ tö tabè a̠me̠' ie' a̠	TYPE:NEG, TENSE:FUT_POT, ASPECT:IPFV	Ie' tö ta̠ a̠' ië' tsm a̠
Bribri0543	Kirë̀ tö tabè a̠me̠' ie' a̠	TENSE:FUT_CER, ASPECT:IPFV	Ie' tö ta̠ a̠' ië' tsm a̠
Bribri0544	Kirë̀ tö tabè a̠me̠' ie' a̠	TYPE:NEG, TENSE:FUT_CER, ASPECT:IPFV	Kàrta̠ kàbár
Bribri0545	Kirë̀ tö tabè a̠me̠' ie' a̠	VOICE:MID	Ie' tö ta̠ a̠' ië' tsm a̠
Bribri0546	Kirë̀ tö tabè a̠me̠' ie' a̠	TYPE:NEG, VOICE:MID	Ie' tö ta̠ a̠' ië' tsm a̠
Bribri0547	Kirë̀ tö tabè a̠me̠' ie' a̠	TENSE:PRF_REC, VOICE:MID	Ie' tö ta̠ a̠' ië' tsm a̠
Bribri0548	Kirë̀ tö tabè a̠me̠' ie' a̠	TYPE:NEG, TENSE:PRF_REC, VOICE:MID	Ie' tö ta̠ a̠' ië' tsm a̠
Bribri0549	Kirë̀ tö tabè a̠me̠' ie' a̠	TENSE:IPFV_REC, ASPECT:IPFV, VOICE:MID	Ie' tö ta̠ a̠' ië' tsm a̠
Bribri0550	Kirë̀ tö tabè a̠me̠' ie' a̠	TYPE:NEG, TENSE:IPFV_REC, ASPECT:IPFV, VOICE:MID	Ie' tö ta̠ a̠' ië' tsm a̠
Bribri0551	Kirë̀ tö tabè a̠me̠' ie' a̠	TENSE:IPFV_HAB, ASPECT:IPFV, VOICE:MID	Ie' tö ta̠ a̠' ië' tsm a̠
Bribri0552	Kirë̀ tö tabè a̠me̠' ie' a̠	TYPE:NEG, TENSE:IPFV_HAB, ASPECT:IPFV, VOICE:MID	Ie' tö ta̠ a̠' ië' tsm a̠
Bribri0553	Kirë̀ tö tabè a̠me̠' ie' a̠	TENSE:FUT_POT, ASPECT:IPFV, VOICE:MID	Ie' tö ta̠ a̠' ië' tsm a̠
Bribri0554	Kirë̀ tö tabè a̠me̠' ie' a̠	TYPE:NEG, TENSE:FUT_POT, ASPECT:IPFV, VOICE:MID	Ie' tö ta̠ a̠' ië' tsm a̠
Bribri0555	Kirë̀ tö tabè a̠me̠' ie' a̠	TENSE:FUT_CER, ASPECT:IPFV, VOICE:MID	Ie' tö ta̠ a̠' ië' tsm a̠
Bribri0556	Kirë̀ tö tabè a̠me̠' ie' a̠	TYPE:NEG, TENSE:FUT_CER, ASPECT:IPFV, VOICE:MID	Ie' tö ta̠ a̠' ië' tsm a̠
Bribri0557	Kirë̀ tö tabè a̠me̠' ie' a̠	TENSE:PAS_PLU, VOICE:MID	Ie' tö ta̠ a̠' ië' tsm a̠
Bribri0558	Kirë̀ tö tabè a̠me̠' ie' a̠	TYPE:NEG, TENSE:PAS_PLU, VOICE:MID	Ie' tö ta̠ a̠' ië' tsm a̠
Bribri0559	Kirë̀ tö tabè a̠me̠' ie' a̠	MODE:POT, TENSE:IPFV_REC, ASPECT:IPFV	Ie' tö ta̠ a̠' ië' tsm a̠
Bribri0560	Kirë̀ tö tabè a̠me̠' ie' a̠	TYPE:NEG, MODE:POT, TENSE:IPFV_REC, ASPECT:IPFV	Kë̀ ye' kë̀ wa̠ à̠ri sí bë̀ne̠
Bribri0392	Ye' tö uyë̀jkuö à̠ritsè bua'ë	TYPE:NEG	Ie' dapárke kàr bi̠
Bribri0389	Aláköl a̠wì̠ dör buáala	ABSNUM:PL	Alà daparke ku̠
Bribri0906	Alà mì̠ne̠ i ma̠u̠k	ABSNUM:PL	Alà kë̀ ku̠ i mí̠nè̠e ku̠
Bribri0907	Alà mì̠ne̠ i ma̠u̠k	TYPE:NEG	Alà dapö́k
Bribri0908	Alà mì̠ne̠ i ma̠u̠k	TYPE:NEG, ABSNUM:PL	Alà mö̀ me' tsma̠
Bribri0909	Alà mì̠ne̠ i ma̠u̠k	TENSE:PRF_REC	Alà dapö́k
Bribri0910	Alà mì̠ne̠ i ma̠u̠k	TENSE:PRF_REC, ABSNUM:PL	Alà dapö́k
Bribri0911	Alà mì̠ne̠ i ma̠u̠k	TENSE:IPFV_REC, ASPECT:IPFV	Alà dapö́k
Bribri0912	Alà mì̠ne̠ i ma̠u̠k	TENSE:IPFV_REC, ASPECT:IPFV, ABSNUM:PL	Alà dapö́k
Bribri0913	Alà mì̠ne̠ i ma̠u̠k	TENSE:IPFV_PROG, ASPECT:IPFV	Alà dapö́k
Bribri0914	Alà mì̠ne̠ i ma̠u̠k	TYPE:NEG, TENSE:IPFV_PROG, ASPECT:IPFV	Alà bák me̠ i ma̠k ku̠
Bribri0915	Alà mì̠ne̠ i ma̠u̠k	TENSE:PRF_PROG	Alà dapö́k
Bribri0916	Alà mì̠ne̠ i ma̠u̠k	TYPE:NEG, TENSE:PRF_PROG	Alà dapö́k
Bribri0917	Alà mì̠ne̠ i ma̠u̠k	TENSE:IPFV_PROG, ASPECT:IPFV, ABSNUM:PL	Alà dapö́k
Bribri0918	Alà mì̠ne̠ i ma̠u̠k	TYPE:NEG, TENSE:IPFV_PROG, ASPECT:IPFV, ABSNUM:PL	Alà dapö́k
Bribri0919	Alà mì̠ne̠ i ma̠u̠k	TENSE:PRF_PROG, ABSNUM:PL	Alà dapö́k
Bribri0920	Alà mì̠ne̠ i ma̠u̠k	TYPE:NEG, TENSE:PRF_PROG, ABSNUM:PL	Awì tsë̀na̠
Bribri0393	Awá tsë'	TENSE:PRF_REC	Ye' dör àrros ñó̠mi̠ ñè̠
Bribri0145	Ie' tö àrros ña̠'	ASPECT:INC	Kë̀ ye' dör àrros ñè̠ne̠ ñè̠
Bribri0146	Ie' tö àrros ña̠'	TYPE:NEG	Ye' dör àrros ñè̠
Bribri0147	Ie' tö àrros ña̠'	TENSE:IPFV_PROG, ASPECT:IPFV	Ye' dör àrros ñè̠
Bribri0148	Ie' tö àrros ña̠'	TYPE:NEG, TENSE:IPFV_PROG, ASPECT:IPFV	Ye' bák àrros ña̠ú̠k ñè̠
Bribri0149	Ie' tö àrros ña̠'	TENSE:PRF_PROG	Ye' dör àrros ñè̠
Bribri0150	Ie' tö àrros ña̠'	TYPE:NEG, TENSE:PRF_PROG	Ye' dör àrros ñè̠
Bribri0151	Ie' tö àrros ña̠'	TENSE:IPFV_REC, ASPECT:IPFV	Ye' dör àrros ñè̠
Bribri0152	Ie' tö àrros ña̠'	TYPE:NEG, TENSE:IPFV_REC, ASPECT:IPFV	Ye' dör àrros ñè̠
Bribri0153	Ie' tö àrros ña̠'	MODE:IMP, TENSE:IPFV_REC, ASPECT:IPFV, PERSON:NA	Ye' dör àrros ñè̠
Bribri0154	Ie' tö àrros ña̠'	TYPE:NEG, MODE:IMP, TENSE:IPFV_REC, ASPECT:IPFV, PERSON:NA	Ye' dör àrros ñè̠
Bribri0155	Ie' tö àrros ña̠'	TYPE:NEG, MODE:IMP, TENSE:IPFV_REC, ASPECT:IPFV, VOICE:MID, PERSON:NA	Ye' dör àrros ñè̠
Bribri0156	Ie' tö àrros ña̠'	MODE:EXH, TENSE:IPFV_REC, ASPECT:IPFV, PERSON:1_PL_INC	Ye' dör àrros ñè̠
Bribri0157	Ie' tö àrros ña̠'	MODE:DES, TENSE:IPFV_REC, ASPECT:IPFV	Ye' dör àrros ñè̠
Bribri0158	Ie' tö àrros ña̠'	TYPE:NEG, MODE:DES, TENSE:IPFV_REC, ASPECT:IPFV	Ye' wa̠ àrros ña̠wa̠' ñè̠
Bribri0159	Ie' tö àrros ña̠'	MODE:ADVERS	Ye' dör àrros ñé̠
Bribri0160	Ie' tö àrros ña̠'	TENSE:PRF_REC	Ye' dör àrros ñè̠
Bribri0161	Ie' tö àrros ña̠'	TENSE:PRF_REC, ASPECT:INC	Ye' dör àrros ñè̠
Bribri0162	Ie' tö àrros ña̠'	TYPE:NEG, TENSE:PRF_REC	Ye' dör àrros ñè̠
Bribri0163	Ie' tö àrros ña̠'	TENSE:IPFV_HAB, ASPECT:IPFV	Ye' dör àrros ñè̠
Bribri0164	Ie' tö àrros ña̠'	TYPE:NEG, TENSE:IPFV_HAB, ASPECT:IPFV	Ye' dör àrros ñè̠
Bribri0165	Ie' tö àrros ña̠'	TENSE:FUT_POT, ASPECT:IPFV	Ye' dör àrros ñè̠
Bribri0166	Ie' tö àrros ña̠'	TYPE:NEG, TENSE:FUT_POT, ASPECT:IPFV	Ye' dör àrros ñè̠
Bribri0167	Ie' tö àrros ña̠'	TENSE:FUT_CER, ASPECT:IPFV	Ye' dör àrros ñè̠
Bribri0168	Ie' tö àrros ña̠'	TYPE:NEG, TENSE:FUT_CER, ASPECT:IPFV	Ye' dör àrros ñè̠
Bribri0169	Ie' tö àrros ña̠'	TENSE:IPFV_REC, ASPECT:IPFV, VOICE:MID, PERSON:NA	Ye' dör àrros ñè̠
Bribri0170	Ie' tö àrros ña̠'	TYPE:NEG, TENSE:IPFV_REC, ASPECT:IPFV, VOICE:MID, PERSON:NA	Ye' dör àrros ñè̠
Bribri0171	Ie' tö àrros ña̠'	VOICE:MID, PERSON:NA	Ye' dör àrros ñè̠
Bribri0172	Ie' tö àrros ña̠'	TYPE:NEG, VOICE:MID, PERSON:NA	Ye' dör àrros ñè̠
Bribri0173	Ie' tö àrros ña̠'	TENSE:PRF_REC, VOICE:MID, PERSON:NA	Ye' dör àrros ñè̠
Bribri0174	Ie' tö àrros ña̠'	TYPE:NEG, TENSE:PRF_REC, VOICE:MID, PERSON:NA	Ye' dör àrros ñè̠
Bribri0175	Ie' tö àrros ña̠'	TENSE:IPFV_HAB, ASPECT:IPFV, VOICE:MID, PERSON:NA	Ye' dör àrros ñè̠
Bribri0176	Ie' tö àrros ña̠'	TYPE:NEG, TENSE:IPFV_HAB, ASPECT:IPFV, VOICE:MID, PERSON:NA	Ye' dör àrros ñè̠
Bribri0177	Ie' tö àrros ña̠'	TENSE:FUT_POT, ASPECT:IPFV, VOICE:MID, PERSON:NA	Ye' dör àrros ñè̠
Bribri0178	Ie' tö àrros ña̠'	TYPE:NEG, TENSE:FUT_POT, ASPECT:IPFV, VOICE:MID, PERSON:NA	Ye' dör àrros ñè̠
Bribri0179	Ie' tö àrros ña̠'	TENSE:FUT_CER, ASPECT:IPFV, VOICE:MID, PERSON:NA	Ye' dör àrros ñè̠
Bribri0180	Ie' tö àrros ña̠'	TYPE:NEG, TENSE:FUT_CER, ASPECT:IPFV, VOICE:MID, PERSON:NA	Ye' wa̠ àrros ñó̠rule ñè̠
Bribri0181	Ie' tö àrros ña̠'	TENSE:PAS_PLU	Ye' dör àrros ñè̠
Bribri0182	Ie' tö àrros ña̠'	TYPE:NEG, TENSE:PAS_PLU	Ye' dör àrros ñè̠
Bribri0183	Ie' tö àrros ña̠'	TENSE:PAS_PLU, VOICE:MID, PERSON:NA	Ye' dör àrros ñè̠
Bribri0184	Ie' tö àrros ña̠'	TYPE:NEG, TENSE:PAS_PLU, VOICE:MID, PERSON:NA	Ie' tso 
Bribri0288	Skuë̀ ta̠'	TENSE:PRF_REM, ASPECT:PFV	Kë̀ ie' uj̠mè̠ne̠
Bribri0097	Ye' tú̠ne̠'	TYPE:NEG	Ye' tö̀ té̠
Bribri0098	Ye' tú̠ne̠'	TENSE:PRF_REC	Ye' ts̠ e̠
Bribri0099	Ye' tú̠ne̠'	TYPE:NEG, TENSE:PRF_REC	Ye' ts̠ e̠
Bribri0100	Ye' tú̠ne̠'	TENSE:IPFV_REC, ASPECT:IPFV	Ye' ts̠ e̠
Bribri0101	Ye' tú̠ne̠'	TYPE:NEG, TENSE:IPFV_REC, ASPECT:IPFV	Ye' ts̠ e̠
Bribri0102	Ye' tú̠ne̠'	TENSE:IPFV_REC, ASPECT:IPFV, PERSON:3_SI	Ye' ts̠ e̠
Bribri0103	Ye' tú̠ne̠'	TENSE:IPFV_REC, ASPECT:IPFV, ABSNUM:PL, PERSON:3_PL	Ye' ts̠ e̠
Bribri0104	Ye' tú̠ne̠'	TYPE:NEG, TENSE:IPFV_REC, ASPECT:IPFV, PERSON:3_SI	Ye' ts̠ e̠
Bribri0105	Ye' tú̠ne̠'	TENSE:IPFV_PROG, ASPECT:IPFV	Ye' ts̠ e̠
Bribri0106	Ye' tú̠ne̠'	TYPE:NEG, TENSE:IPFV_PROG, ASPECT:IPFV	Ye' bák tś̠k
Bribri0107	Ye' tú̠ne̠'	TENSE:PRF_PROG	Ye' ts̠ e̠
Bribri0108	Ye' tú̠ne̠'	TYPE:NEG, TENSE:PRF_PROG	Ye' ts̠ e̠
Bribri0109	Ye' tú̠ne̠'	MODE:IMP, TENSE:IPFV_REC, ASPECT:IPFV, PERSON:2_SI	Ye' ts̠ e̠
Bribri0110	Ye' tú̠ne̠'	MODE:IMP, TENSE:IPFV_REC, ASPECT:IPFV, ABSNUM:PL, PERSON:2_PL	Ye' ts̠ e̠
Bribri0111	Ye' tú̠ne̠'	TYPE:NEG, MODE:IMP, TENSE:IPFV_REC, ASPECT:IPFV, PERSON:2_SI	Ye' ts̠ e̠
Bribri0112	Ye' tú̠ne̠'	TYPE:NEG, MODE:IMP, TENSE:IPFV_REC, ASPECT:IPFV, ABSNUM:PL, PERSON:2_PL	Ye' ts̠ e̠
Bribri0113	Ye' tú̠ne̠'	TENSE:IPFV_HAB, ASPECT:IPFV	Ye' ts̠ e̠
Bribri0114	Ye' tú̠ne̠'	TYPE:NEG, TENSE:IPFV_HAB, ASPECT:IPFV	Ye' ts̠ e̠
Bribri0115	Ye' tú̠ne̠'	TENSE:FUT_POT, ASPECT:IPFV	Ye' ts̠ e̠
Bribri0116	Ye' tú̠ne̠'	TYPE:NEG, TENSE:FUT_POT, ASPECT:IPFV	Ye' ts̠ e̠
Bribri0117	Ye' tú̠ne̠'	TENSE:FUT_CER, ASPECT:IPFV	Ye' ts̠ e̠
Bribri0118	Ye' tú̠ne̠'	TYPE:NEG, TENSE:FUT_CER, ASPECT:IPFV	Ye' ts̠ e̠
Bribri0119	Ye' tú̠ne̠'	VOICE:MID, ABSNUM:NI, PERSON:NA	Ye' ts̠ e̠
Bribri0120	Ye' tú̠ne̠'	TYPE:NEG, VOICE:MID, ABSNUM:NI, PERSON:NA	Ye' ts̠ e̠
Bribri0121	Ye' tú̠ne̠'	TENSE:PRF_REC, VOICE:MID, ABSNUM:NI, PERSON:NA	Ye' ts̠ e̠
Bribri0122	Ye' tú̠ne̠'	TYPE:NEG, TENSE:PRF_REC, VOICE:MID, ABSNUM:NI, PERSON:NA	Kë̀ ye' kë̀ wa̠ tö bë̀ ku̠ të̀ ku̠ tkë̀ne̠ da̠
Bribri0801	Ye' a̠mì̠ tö bö̀wö duké wö'ik	TYPE:NEG	Ye' tö bö' ua'mi̠mi̠
Bribri0802	Ye' a̠mì̠ tö bö̀wö duké wö'ik	ASPECT:INC	Ye' tö ì̠ tö bö' ök da̠
Bribri0803	Ye' a̠mì̠ tö bö̀wö duké wö'ik	TENSE:PRF_REC	Ye' tsmbö́k
Bribri0804	Ye' a̠mì̠ tö bö̀wö duké wö'ik	TYPE:NEG, TENSE:PRF_REC	Ye' tsmbö́k
Bribri0805	Ye' a̠mì̠ tö bö̀wö duké wö'ik	TENSE:PRF_REC, ASPECT:INC	Ye' tsmbö́k
Bribri0806	Ye' a̠mì̠ tö bö̀wö duké wö'ik	TENSE:IPFV_REC, ASPECT:IPFV	Ye' tsmbö́k
Bribri0807	Ye' a̠mì̠ tö bö̀wö duké wö'ik	TYPE:NEG, TENSE:IPFV_REC, ASPECT:IPFV	Ye' tsmbö́k
Bribri0808	Ye' a̠mì̠ tö bö̀wö duké wö'ik	TENSE:IPFV_PROG, ASPECT:IPFV	Ye' tsmbö́k
Bribri0809	Ye' a̠mì̠ tö bö̀wö duké wö'ik	TYPE:NEG, TENSE:IPFV_PROG, ASPECT:IPFV	Ye' bák bak bak bö́k
Bribri0810	Ye' a̠mì̠ tö bö̀wö duké wö'ik	TENSE:PRF_PROG	Ye' tsmbö́k
Bribri0811	Ye' a̠mì̠ tö bö̀wö duké wö'ik	TYPE:NEG, TENSE:PRF_PROG	Ye' tsmbö́k
Bribri0812	Ye' a̠mì̠ tö bö̀wö duké wö'ik	MODE:IMP, TENSE:IPFV_REC, ASPECT:IPFV	Ye' tsmbö́k
Bribri0813	Ye' a̠mì̠ tö bö̀wö duké wö'ik	TYPE:NEG, MODE:IMP, TENSE:IPFV_REC, ASPECT:IPFV	Ye' tsmbö́k
Bribri0814	Ye' a̠mì̠ tö bö̀wö duké wö'ik	TYPE:NEG, MODE:IMP, TENSE:IPFV_REC, ASPECT:IPFV, VOICE:MID	Ye' tsmbö́k
Bribri0815	Ye' a̠mì̠ tö bö̀wö duké wö'ik	MODE:EXH, TENSE:IPFV_REC, ASPECT:IPFV, PERSON:1_PL_INC	Ye' tsmbö́k
Bribri0816	Ye' a̠mì̠ tö bö̀wö duké wö'ik	MODE:DES, TENSE:IPFV_REC, ASPECT:IPFV	Ye' tsmbö́k
Bribri0817	Ye' a̠mì̠ tö bö̀wö duké wö'ik	TYPE:NEG, MODE:DES, TENSE:IPFV_REC, ASPECT:IPFV	Ye' wa̠ ö daka' ö' ka'
Bribri0818	Ye' a̠mì̠ tö bö̀wö duké wö'ik	MODE:ADVERS	Ye' tsmbö́k
Bribri0819	Ye' a̠mì̠ tö bö̀wö duké wö'ik	TENSE:IPFV_HAB, ASPECT:IPFV	Ye' tsmbö́k
Bribri0820	Ye' a̠mì̠ tö bö̀wö duké wö'ik	TYPE:NEG, TENSE:IPFV_HAB, ASPECT:IPFV	Ye' tsmbö́k
Bribri0821	Ye' a̠mì̠ tö bö̀wö duké wö'ik	TENSE:FUT_POT, ASPECT:IPFV	Ye' tsmbö́k
Bribri0822	Ye' a̠mì̠ tö bö̀wö duké wö'ik	TYPE:NEG, TENSE:FUT_POT, ASPECT:IPFV	Ye' tsmbö́k
Bribri0823	Ye' a̠mì̠ tö bö̀wö duké wö'ik	TENSE:FUT_CER, ASPECT:IPFV	Ye' tsmbö́k
Bribri0824	Ye' a̠mì̠ tö bö̀wö duké wö'ik	TYPE:NEG, TENSE:FUT_CER, ASPECT:IPFV	Sh bá̀ ö suàér
Bribri0825	Ye' a̠mì̠ tö bö̀wö duké wö'ik	VOICE:MID	Ye' tsmbö́k
Bribri0826	Ye' a̠mì̠ tö bö̀wö duké wö'ik	TYPE:NEG, VOICE:MID	Ye' tsmbö́k
Bribri0827	Ye' a̠mì̠ tö bö̀wö duké wö'ik	TENSE:PRF_REC, VOICE:MID	Ye' tsmbö́k
Bribri0828	Ye' a̠mì̠ tö bö̀wö duké wö'ik	TYPE:NEG, TENSE:PRF_REC, VOICE:MID	Ye' tsmbö́k
Bribri0829	Ye' a̠mì̠ tö bö̀wö duké wö'ik	TENSE:IPFV_REC, ASPECT:IPFV, VOICE:MID	Ye' tsmbö́k
Bribri0830	Ye' a̠mì̠ tö bö̀wö duké wö'ik	TYPE:NEG, TENSE:IPFV_REC, ASPECT:IPFV, VOICE:MID	Ye' tsmbö́k
Bribri0831	Ye' a̠mì̠ tö bö̀wö duké wö'ik	TENSE:IPFV_HAB, ASPECT:IPFV, VOICE:MID	Ye' tsmbö́k
Bribri0832	Ye' a̠mì̠ tö bö̀wö duké wö'ik	TYPE:NEG, TENSE:IPFV_HAB, ASPECT:IPFV, VOICE:MID	Ye' tsmbö́k
Bribri0833	Ye' a̠mì̠ tö bö̀wö duké wö'ik	TENSE:FUT_POT, ASPECT:IPFV, VOICE:MID	Ye' tsmbö́k
Bribri0834	Ye' a̠mì̠ tö bö̀wö duké wö'ik	TYPE:NEG, TENSE:FUT_POT, ASPECT:IPFV, VOICE:MID	Ye' tsmbö́k
Bribri0835	Ye' a̠mì̠ tö bö̀wö duké wö'ik	TENSE:FUT_CER, ASPECT:IPFV, VOICE:MID	Ye' tsmbö́k
Bribri0836	Ye' a̠mì̠ tö bö̀wö duké wö'ik	TYPE:NEG, TENSE:FUT_CER, ASPECT:IPFV, VOICE:MID	Ye' wa̠ ìí bár wa̠ ökule ñè̠
Bribri0837	Ye' a̠mì̠ tö bö̀wö duké wö'ik	TENSE:PAS_PLU	Ye' tsmbö́k
Bribri0838	Ye' a̠mì̠ tö bö̀wö duké wö'ik	TYPE:NEG, TENSE:PAS_PLU	Ye' tsmbö́k
Bribri0839	Ye' a̠mì̠ tö bö̀wö duké wö'ik	MODE:POT, TENSE:IPFV_REC, ASPECT:IPFV	Ye' tsmbö́k
Bribri0840	Ye' a̠mì̠ tö bö̀wö duké wö'ik	TYPE:NEG, MODE:POT, TENSE:IPFV_REC, ASPECT:IPFV	Kë̀ kë̀ ku̠ a̠ kë̀ne̠ kà̠
Bribri0855	Mó̠köl ar ka̠nò̠ a̠	TYPE:NEG	Ió̠k lr ki̠
Bribri0856	Mó̠köl ar ka̠nò̠ a̠	TENSE:PRF_REM, ASPECT:PFV	Ió̠k lr ki̠
Bribri0857	Mó̠köl ar ka̠nò̠ a̠	TYPE:NEG, TENSE:PRF_REM, ASPECT:PFV	Ie̠ ië'ta̠k dapö́k
Bribri0858	Mó̠köl ar ka̠nò̠ a̠	ABSNUM:PL	Ió̠k lr ki̠
Bribri0859	Mó̠köl ar ka̠nò̠ a̠	TYPE:NEG, ABSNUM:PL	Ió̠k lr ki̠
Bribri0860	Mó̠köl ar ka̠nò̠ a̠	TENSE:PRF_REM, ASPECT:PFV, ABSNUM:PL	Ió̠k lr ki̠
Bribri0861	Mó̠köl ar ka̠nò̠ a̠	TYPE:NEG, TENSE:PRF_REM, ASPECT:PFV, ABSNUM:PL	Kë̀ kë̀ ku̠  ̠ë̀ ku̠  ̠ë̀ne̠
Bribri0876	Si̠ni̠' tër í̠s ki̠	TYPE:NEG	Si̠n ̠ 'ta̠ ía̠
Bribri0877	Si̠ni̠' tër í̠s ki̠	TENSE:PRF_REM, ASPECT:PFV	Si̠n ̠ 'ta̠ ía̠
Bribri0878	Si̠ni̠' tër í̠s ki̠	TYPE:NEG, TENSE:PRF_REM, ASPECT:PFV	Ie' të̀ ku̠ dapárke kàs íi̠
Bribri0879	Si̠ni̠' tër í̠s ki̠	ABSNUM:PL	Si̠n ̠ 'ta̠ ía̠
Bribri0880	Si̠ni̠' tër í̠s ki̠	TYPE:NEG, ABSNUM:PL	Si̠n ̠ 'ta̠ ía̠
Bribri0881	Si̠ni̠' tër í̠s ki̠	TENSE:PRF_REM, ASPECT:PFV, ABSNUM:PL	Si̠n ̠ 'ta̠ ía̠
Bribri0882	Si̠ni̠' tër í̠s ki̠	TYPE:NEG, TENSE:PRF_REM, ASPECT:PFV, ABSNUM:PL	Ie' 
Bribri0418	I dé	ABSNUM:PL, PERSON:3_PL	Ie' bák s da̠
Bribri0419	I dé	TENSE:PRF_REM	Ie' 
Bribri0420	I dé	TENSE:IPFV_PROG, ASPECT:IPFV	Ie' 
Bribri0421	I dé	TYPE:NEG, TENSE:IPFV_PROG, ASPECT:IPFV	Ie' bák Ie' s dakö́k
Bribri0422	I dé	TENSE:PRF_PROG	Ie' 
Bribri0423	I dé	TYPE:NEG, TENSE:PRF_PROG	Ie' ̠  a̠'ta̠
Bribri0289	I̠nú̠köl ta̠'	TENSE:PRF_REC, ASPECT:PFV	Ie' ̠  a̠'ta̠
Bribri0290	I̠nú̠köl ta̠'	TENSE:PRF_REM, ASPECT:PFV	
