ID	Source	Change	Target
Bribri0561	Ye' tö àrros ali' ù̠ i' a̠	TYPE:NEG	Kë̀ ye' tö àrros tò̠ne̠ i  'iKku̠
Bribri0562	Ye' tö àrros ali' ù̠ i' a̠	ASPECT:INC	Ye' tö àrros a̠mi̠mi̠ ii ii'të'mi̠
Bribri0563	Ye' tö àrros ali' ù̠ i' a̠	TENSE:PRF_REC	Ye' tö àrros a̠ a̠ ié
Bribri0564	Ye' tö àrros ali' ù̠ i' a̠	TYPE:NEG, TENSE:PRF_REC	Ye' tö àros a̠ tso i̠'ta̠
Bribri0565	Ye' tö àrros ali' ù̠ i' a̠	TENSE:PRF_REC, ASPECT:INC	Ye' tö àros a̠ tso i̠'ta̠
Bribri0566	Ye' tö àrros ali' ù̠ i' a̠	TENSE:IPFV_REC, ASPECT:IPFV	Ye' tö àros a̠ tso i̠'ta̠
Bribri0567	Ye' tö àrros ali' ù̠ i' a̠	TYPE:NEG, TENSE:IPFV_REC, ASPECT:IPFV	Ye' tö àros a̠ tso i̠'ta̠
Bribri0568	Ye' tö àrros ali' ù̠ i' a̠	TENSE:IPFV_PROG, ASPECT:IPFV	Ye' tö àros a̠ tso i̠'ta̠
Bribri0569	Ye' tö àrros ali' ù̠ i' a̠	TYPE:NEG, TENSE:IPFV_PROG, ASPECT:IPFV	Ye' tö àros a̠ tso i̠'ta̠
Bribri0570	Ye' tö àrros ali' ù̠ i' a̠	TENSE:PRF_PROG	Ye' bák àrrs  tö́k
Bribri0571	Ye' tö àrros ali' ù̠ i' a̠	TYPE:NEG, TENSE:PRF_PROG	Ye' tö àros a̠ tso i̠'ta̠
Bribri0572	Ye' tö àrros ali' ù̠ i' a̠	MODE:IMP, TENSE:IPFV_REC, ASPECT:IPFV, PERSON:NA	Ye' tö àros a̠ tso i̠'ta̠
Bribri0573	Ye' tö àrros ali' ù̠ i' a̠	TYPE:NEG, MODE:IMP, TENSE:IPFV_REC, ASPECT:IPFV, PERSON:NA	Ye' tö àros a̠ tso i̠'ta̠
Bribri0574	Ye' tö àrros ali' ù̠ i' a̠	TYPE:NEG, MODE:IMP, TENSE:IPFV_REC, ASPECT:IPFV, VOICE:MID, PERSON:NA	Ye' tö àros a̠ tso i̠'ta̠
Bribri0575	Ye' tö àrros ali' ù̠ i' a̠	MODE:EXH, TENSE:IPFV_REC, ASPECT:IPFV, PERSON:1_PL_INC	Ye' tö àros a̠ tso i̠'ta̠
Bribri0576	Ye' tö àrros ali' ù̠ i' a̠	MODE:DES, TENSE:IPFV_REC, ASPECT:IPFV	Ye' tö àros a̠ tso i̠'ta̠
Bribri0577	Ye' tö àrros ali' ù̠ i' a̠	TYPE:NEG, MODE:DES, TENSE:IPFV_REC, ASPECT:IPFV	Ye' tö àros a̠ tso i̠'ta̠
Bribri0578	Ye' tö àrros ali' ù̠ i' a̠	MODE:ADVERS	Ye' wa̠ àros ta̠wa̠' ù
Bribri0579	Ye' tö àrros ali' ù̠ i' a̠	TENSE:IPFV_HAB, ASPECT:IPFV	Ye' tö àros a̠ tso i̠'ta̠
Bribri0580	Ye' tö àrros ali' ù̠ i' a̠	TYPE:NEG, TENSE:IPFV_HAB, ASPECT:IPFV	Ye' tö àros a̠ tso i̠'ta̠
Bribri0581	Ye' tö àrros ali' ù̠ i' a̠	TENSE:FUT_POT, ASPECT:IPFV	Ye' tö àros a̠ tso i̠'ta̠
Bribri0582	Ye' tö àrros ali' ù̠ i' a̠	TYPE:NEG, TENSE:FUT_POT, ASPECT:IPFV	Ye' tö àros a̠ tso i̠'ta̠
Bribri0583	Ye' tö àrros ali' ù̠ i' a̠	TENSE:FUT_CER, ASPECT:IPFV	Ye' tö àros a̠ tso i̠'ta̠
Bribri0584	Ye' tö àrros ali' ù̠ i' a̠	TYPE:NEG, TENSE:FUT_CER, ASPECT:IPFV	Ye' tö àros a̠ tso i̠'ta̠
Bribri0585	Ye' tö àrros ali' ù̠ i' a̠	VOICE:MID, PERSON:NA	Ye' tö àros a̠ tso i̠'ta̠
Bribri0586	Ye' tö àrros ali' ù̠ i' a̠	TYPE:NEG, VOICE:MID, PERSON:NA	Ye' tö àros a̠ tso i̠'ta̠
Bribri0587	Ye' tö àrros ali' ù̠ i' a̠	TENSE:PRF_REC, VOICE:MID, PERSON:NA	Ye' tö àros a̠ tso i̠'ta̠
Bribri0588	Ye' tö àrros ali' ù̠ i' a̠	TYPE:NEG, TENSE:PRF_REC, VOICE:MID, PERSON:NA	Ye' tö àros a̠ tso i̠'ta̠
Bribri0589	Ye' tö àrros ali' ù̠ i' a̠	TENSE:IPFV_REC, ASPECT:IPFV, VOICE:MID, PERSON:NA	Ye' tö àros a̠ tso i̠'ta̠
Bribri0590	Ye' tö àrros ali' ù̠ i' a̠	TYPE:NEG, TENSE:IPFV_REC, ASPECT:IPFV, VOICE:MID, PERSON:NA	Ye' tö àros a̠ tso i̠'ta̠
Bribri0591	Ye' tö àrros ali' ù̠ i' a̠	TENSE:IPFV_HAB, ASPECT:IPFV, VOICE:MID, PERSON:NA	Ye' tö àros a̠ tso i̠'ta̠
Bribri0592	Ye' tö àrros ali' ù̠ i' a̠	TYPE:NEG, TENSE:IPFV_HAB, ASPECT:IPFV, VOICE:MID, PERSON:NA	Ye' tö àros a̠ tso i̠'ta̠
Bribri0593	Ye' tö àrros ali' ù̠ i' a̠	TENSE:FUT_POT, ASPECT:IPFV, VOICE:MID, PERSON:NA	Ye' tö àros a̠ tso i̠'ta̠
Bribri0594	Ye' tö àrros ali' ù̠ i' a̠	TYPE:NEG, TENSE:FUT_POT, ASPECT:IPFV, VOICE:MID, PERSON:NA	Ye' tö àros a̠ tso i̠'ta̠
Bribri0595	Ye' tö àrros ali' ù̠ i' a̠	TENSE:FUT_CER, ASPECT:IPFV, VOICE:MID, PERSON:NA	Ye' tö àros a̠ tso i̠'ta̠
Bribri0596	Ye' tö àrros ali' ù̠ i' a̠	TYPE:NEG, TENSE:FUT_CER, ASPECT:IPFV, VOICE:MID, PERSON:NA	Ye' tö àros a̠ tso i̠'ta̠
Bribri0597	Ye' tö àrros ali' ù̠ i' a̠	TENSE:PAS_PLU	Ye' wa̠ àroo tó̠rule il iĺ́le
Bribri0598	Ye' tö àrros ali' ù̠ i' a̠	TYPE:NEG, TENSE:PAS_PLU	Ye' tö àros a̠ tso i̠'ta̠
Bribri0599	Ye' tö àrros ali' ù̠ i' a̠	MODE:POT, TENSE:IPFV_REC, ASPECT:IPFV	Ye' tö àros a̠ tso i̠'ta̠
Bribri0600	Ye' tö àrros ali' ù̠ i' a̠	TYPE:NEG, MODE:POT, TENSE:IPFV_REC, ASPECT:IPFV	Ye' tö àros a̠ tso i̠'ta̠
Bribri0416	I kiö́	ABSNUM:PL	Sa' ië'ta̠
Bribri0417	I tso'	ABSNUM:PL, PERSON:3_PL	I tso'tak kur
Bribri0721	Maria dör kápi u'	TYPE:NEG	Kë̀ ie' kë̀ wa̠ kë̀ wa̠ kë̀ wa̠
Bribri0722	Maria dör kápi u'	ASPECT:INC	Maria dör kimi̠mi̠
Bribri0723	Maria dör kápi u'	TENSE:PRF_REC	Maria dör ké
Bribri0724	Maria dör kápi u'	TYPE:NEG, TENSE:PRF_REC	Maria dör kimè̠
Bribri0725	Maria dör kápi u'	TENSE:PRF_REC, ASPECT:INC	Maria dör kimè̠
Bribri0726	Maria dör kápi u'	TENSE:IPFV_REC, ASPECT:IPFV	Maria dör kimè̠
Bribri0727	Maria dör kápi u'	TYPE:NEG, TENSE:IPFV_REC, ASPECT:IPFV	Maria dör kimè̠
Bribri0728	Maria dör kápi u'	TENSE:IPFV_PROG, ASPECT:IPFV	Maria dör kimè̠
Bribri0729	Maria dör kápi u'	TYPE:NEG, TENSE:IPFV_PROG, ASPECT:IPFV	Maria dör kimè̠
Bribri0730	Maria dör kápi u'	TENSE:PRF_PROG	Maria bák kuö́k
Bribri0731	Maria dör kápi u'	TYPE:NEG, TENSE:PRF_PROG	Maria dör kimè̠
Bribri0732	Maria dör kápi u'	MODE:IMP, TENSE:IPFV_REC, ASPECT:IPFV	Maria dör kimè̠
Bribri0733	Maria dör kápi u'	TYPE:NEG, MODE:IMP, TENSE:IPFV_REC, ASPECT:IPFV	Maria dör kimè̠
Bribri0734	Maria dör kápi u'	TYPE:NEG, MODE:IMP, TENSE:IPFV_REC, ASPECT:IPFV, VOICE:MID	Maria dör kimè̠
Bribri0735	Maria dör kápi u'	MODE:EXH, TENSE:IPFV_REC, ASPECT:IPFV, PERSON:1_PL_INC	Maria dör kimè̠
Bribri0736	Maria dör kápi u'	MODE:DES, TENSE:IPFV_REC, ASPECT:IPFV	Maria dör kimè̠
Bribri0737	Maria dör kápi u'	TYPE:NEG, MODE:DES, TENSE:IPFV_REC, ASPECT:IPFV	Maria dör kimè̠
Bribri0738	Maria dör kápi u'	MODE:ADVERS	Maria wa̠ ki' tspa
Bribri0739	Maria dör kápi u'	TENSE:IPFV_HAB, ASPECT:IPFV	Maria dör kimè̠
Bribri0740	Maria dör kápi u'	TYPE:NEG, TENSE:IPFV_HAB, ASPECT:IPFV	Maria dör kimè̠
Bribri0741	Maria dör kápi u'	TENSE:FUT_POT, ASPECT:IPFV	Maria dör kimè̠
Bribri0742	Maria dör kápi u'	TYPE:NEG, TENSE:FUT_POT, ASPECT:IPFV	Maria dör kimè̠
Bribri0743	Maria dör kápi u'	TENSE:FUT_CER, ASPECT:IPFV	Maria dör kimè̠
Bribri0744	Maria dör kápi u'	TYPE:NEG, TENSE:FUT_CER, ASPECT:IPFV	Maria dör kimè̠
Bribri0745	Maria dör kápi u'	VOICE:MID	Po'tak kö̀ne̠
Bribri0746	Maria dör kápi u'	TYPE:NEG, VOICE:MID	Maria dör kimè̠
Bribri0747	Maria dör kápi u'	TENSE:PRF_REC, VOICE:MID	Maria dör kimè̠
Bribri0748	Maria dör kápi u'	TYPE:NEG, TENSE:PRF_REC, VOICE:MID	Maria dör kimè̠
Bribri0749	Maria dör kápi u'	TENSE:IPFV_REC, ASPECT:IPFV, VOICE:MID	Maria dör kimè̠
Bribri0750	Maria dör kápi u'	TYPE:NEG, TENSE:IPFV_REC, ASPECT:IPFV, VOICE:MID	Maria dör kimè̠
Bribri0751	Maria dör kápi u'	TENSE:IPFV_HAB, ASPECT:IPFV, VOICE:MID	Maria dör kimè̠
Bribri0752	Maria dör kápi u'	TYPE:NEG, TENSE:IPFV_HAB, ASPECT:IPFV, VOICE:MID	Maria dör kimè̠
Bribri0753	Maria dör kápi u'	TENSE:FUT_POT, ASPECT:IPFV, VOICE:MID	Maria dör kimè̠
Bribri0754	Maria dör kápi u'	TYPE:NEG, TENSE:FUT_POT, ASPECT:IPFV, VOICE:MID	Maria dör kimè̠
Bribri0755	Maria dör kápi u'	TENSE:FUT_CER, ASPECT:IPFV, VOICE:MID	Maria dör kimè̠
Bribri0756	Maria dör kápi u'	TYPE:NEG, TENSE:FUT_CER, ASPECT:IPFV, VOICE:MID	Maria dör kimè̠
Bribri0757	Maria dör kápi u'	TENSE:PAS_PLU	Maria wa̠ kár ki̠
Bribri0758	Maria dör kápi u'	TYPE:NEG, TENSE:PAS_PLU	Maria dör kimè̠
Bribri0759	Maria dör kápi u'	MODE:POT, TENSE:IPFV_REC, ASPECT:IPFV	Maria dör kimè̠
Bribri0760	Maria dör kápi u'	TYPE:NEG, MODE:POT, TENSE:IPFV_REC, ASPECT:IPFV	Maria dör kimè̠
Bribri0336	Ye' ka̠nè̠balë'	TENSE:IPFV_REC, ASPECT:IPFV, VOICE:MID, ABSNUM:NI, PERSON:NA	Ye' kë̀ ku̠'bak èlbia
Bribri0337	Ye' ka̠nè̠balë'	TYPE:NEG, TENSE:IPFV_REC, ASPECT:IPFV, VOICE:MID, ABSNUM:NI, PERSON:NA	Ye' kë̀ ku̠'bak èlbia
Bribri0932	Ye' tö i yë́	TYPE:NEG	Ye' kë̀ wa̠ i ye̠
Bribri0933	Ye' tö i yë́	PERSON:2_SI	Be' tö i yë'ta̠
Bribri0934	Ye' tö i yë́	TYPE:NEG, PERSON:2_SI	Ye' tö i yè̠
Bribri0935	Ye' tö i yë́	PERSON:3_SI	Ie' tö i yë'te̠
Bribri0936	Ye' tö i yë́	TYPE:NEG, PERSON:3_SI	Ye' tö i yè̠
Bribri0937	Ye' tö i yë́	PERSON:1_PL_EXC	Sa' tö i yë'ta̠
Bribri0938	Ye' tö i yë́	TYPE:NEG, PERSON:1_PL_EXC	Ye' tö i yè̠
Bribri0939	Ye' tö i yë́	PERSON:1_PL_INC	Se' tsö i yö̀ sö
Bribri0940	Ye' tö i yë́	TYPE:NEG, PERSON:1_PL_INC	Ye' tö i yè̠
Bribri0941	Ye' tö i yë́	PERSON:2_PL	A' tö i yë'ta̠
Bribri0942	Ye' tö i yë́	TYPE:NEG, PERSON:2_PL	Ye' tö i yè̠
Bribri0943	Ye' tö i yë́	PERSON:3_PL	Ie'pa tö i yë'pa̠
Bribri0944	Ye' tö i yë́	TYPE:NEG, PERSON:3_PL	Ye' tö i yè̠
Bribri0945	Ye' tö i yë́	TENSE:PRF_REC	Ye' tö i yé
Bribri0946	Ye' tö i yë́	TENSE:IPFV_REC, ASPECT:IPFV	Ye' tö i yè̠
Bribri0947	Ye' tö i yë́	TENSE:IPFV_PROG, ASPECT:IPFV	Ye' tö i yè̠
Bribri0948	Ye' tö i yë́	TYPE:NEG, TENSE:IPFV_PROG, ASPECT:IPFV	Ye' tö i yè̠
Bribri0949	Ye' tö i yë́	TENSE:PRF_PROG	Ye' bák i yö́k
Bribri0950	Ye' tö i yë́	TYPE:NEG, TENSE:PRF_PROG	Ye' tö i yè̠
Bribri0951	Ye' tö i yë́	MODE:IMP, TENSE:IPFV_REC, ASPECT:IPFV, PERSON:NA	Ye' tö i yè̠
Bribri0952	Ye' tö i yë́	TENSE:FUT_POT, ASPECT:IPFV	Ye' tö i yè̠
Bribri0953	Ye' tö i yë́	TENSE:IPFV_HAB, ASPECT:IPFV	Ye' tö i yè̠
Bribri0954	Ye' tö i yë́	VOICE:MID, ABSNUM:NI, PERSON:NA	Ye' tö i yè̠
Bribri0955	Ye' tö i yë́	TYPE:NEG, VOICE:MID, ABSNUM:NI, PERSON:NA	Ye' tö i yè̠
Bribri0956	Ye' tö i yë́	TENSE:IPFV_REC, ASPECT:IPFV, VOICE:MID, ABSNUM:NI, PERSON:NA	Ye' tö i yè̠
Bribri0424	Ye' tö shkame̠' yö'	ASPECT:INC	Ye' tö shkami̠mi̠
Bribri0425	Ye' tö shkame̠' yö'	TYPE:NEG	Kë̀ ye' tö̀ wa̠ me̠
Bribri0426	Ye' tö shkame̠' yö'	TENSE:PRF_REC	Ye' tö shkémé̠
Bribri0427	Ye' tö shkame̠' yö'	TENSE:PRF_REC, ASPECT:INC	Ye' tö shkö́k
Bribri0428	Ye' tö shkame̠' yö'	TYPE:NEG, TENSE:PRF_REC	Ye' tö shkö́k
Bribri0429	Ye' tö shkame̠' yö'	TENSE:IPFV_REC, ASPECT:IPFV	Ye' tö shkö́k
Bribri0430	Ye' tö shkame̠' yö'	TYPE:NEG, TENSE:IPFV_REC, ASPECT:IPFV	Ye' tö shkö́k
Bribri0431	Ye' tö shkame̠' yö'	MODE:POT, TENSE:IPFV_REC, ASPECT:IPFV	Ye' tö shkö́k
Bribri0432	Ye' tö shkame̠' yö'	TYPE:NEG, MODE:POT, TENSE:IPFV_REC, ASPECT:IPFV	Ye' tö shkö́k
Bribri0433	Ye' tö shkame̠' yö'	TENSE:IPFV_PROG, ASPECT:IPFV	Ye' tö shkö́k
Bribri0434	Ye' tö shkame̠' yö'	TYPE:NEG, TENSE:IPFV_PROG, ASPECT:IPFV	Ye' tö shkö́k
Bribri0435	Ye' tö shkame̠' yö'	TENSE:PRF_PROG	Ye' bák shkö́k
Bribri0436	Ye' tö shkame̠' yö'	TYPE:NEG, TENSE:PRF_PROG	Ye' tö shkö́k
Bribri0437	Ye' tö shkame̠' yö'	MODE:IMP, TENSE:IPFV_REC, ASPECT:IPFV, PERSON:NA	Ye' tö shkö́k
Bribri0438	Ye' tö shkame̠' yö'	TYPE:NEG, MODE:IMP, TENSE:IPFV_REC, ASPECT:IPFV, PERSON:NA	Ye' tö shkö́k
Bribri0439	Ye' tö shkame̠' yö'	TYPE:NEG, MODE:IMP, TENSE:IPFV_REC, ASPECT:IPFV, VOICE:MID, PERSON:NA	Ye' tö shkö́k
Bribri0440	Ye' tö shkame̠' yö'	MODE:EXH, TENSE:IPFV_REC, ASPECT:IPFV, PERSON:1_PL_INC	Ye' tö shkö́k
Bribri0441	Ye' tö shkame̠' yö'	MODE:DES, TENSE:IPFV_REC, ASPECT:IPFV	Ye' tö shkö́k
Bribri0442	Ye' tö shkame̠' yö'	TYPE:NEG, MODE:DES, TENSE:IPFV_REC, ASPECT:IPFV	Ye' tö shkö́k
Bribri0443	Ye' tö shkame̠' yö'	MODE:ADVERS	Ye' wa̠ shka̠
Bribri0444	Ye' tö shkame̠' yö'	TENSE:IPFV_HAB, ASPECT:IPFV	Ye' tö shkö́k
Bribri0445	Ye' tö shkame̠' yö'	TYPE:NEG, TENSE:IPFV_HAB, ASPECT:IPFV	Ye' tö shkö́k
Bribri0446	Ye' tö shkame̠' yö'	TENSE:FUT_POT, ASPECT:IPFV	Ye' tö shkö́k
Bribri0447	Ye' tö shkame̠' yö'	TYPE:NEG, TENSE:FUT_POT, ASPECT:IPFV	Ye' tö shkö́k
Bribri0448	Ye' tö shkame̠' yö'	TENSE:FUT_CER, ASPECT:IPFV	Ye' tö shkö́k
Bribri0449	Ye' tö shkame̠' yö'	TYPE:NEG, TENSE:FUT_CER, ASPECT:IPFV	Ye' tö shkö́k
Bribri0450	Ye' tö shkame̠' yö'	VOICE:MID, PERSON:NA	Ye' tö shkö́k
Bribri0451	Ye' tö shkame̠' yö'	TYPE:NEG, VOICE:MID, PERSON:NA	Ye' tö shkö́k
Bribri0452	Ye' tö shkame̠' yö'	TENSE:PRF_REC, VOICE:MID, PERSON:NA	Ye' tö shkö́k
Bribri0453	Ye' tö shkame̠' yö'	TYPE:NEG, TENSE:PRF_REC, VOICE:MID, PERSON:NA	Ye' tö shkö́k
Bribri0454	Ye' tö shkame̠' yö'	TENSE:IPFV_REC, ASPECT:IPFV, VOICE:MID, PERSON:NA	Ye' tö shkö́k
Bribri0455	Ye' tö shkame̠' yö'	TYPE:NEG, TENSE:IPFV_REC, ASPECT:IPFV, VOICE:MID, PERSON:NA	Ye' tö shkö́k
Bribri0456	Ye' tö shkame̠' yö'	TENSE:IPFV_HAB, ASPECT:IPFV, VOICE:MID, PERSON:NA	Ye' tö shkö́k
Bribri0457	Ye' tö shkame̠' yö'	TYPE:NEG, TENSE:IPFV_HAB, ASPECT:IPFV, VOICE:MID, PERSON:NA	Ye' tö shkö́k
Bribri0458	Ye' tö shkame̠' yö'	TENSE:FUT_POT, ASPECT:IPFV, VOICE:MID, PERSON:NA	Ye' tö shkö́k
Bribri0459	Ye' tö shkame̠' yö'	TYPE:NEG, TENSE:FUT_POT, ASPECT:IPFV, VOICE:MID, PERSON:NA	Ye' tö shkö́k
Bribri0460	Ye' tö shkame̠' yö'	TENSE:FUT_CER, ASPECT:IPFV, VOICE:MID, PERSON:NA	Ye' tö shkö́k
Bribri0461	Ye' tö shkame̠' yö'	TYPE:NEG, TENSE:FUT_CER, ASPECT:IPFV, VOICE:MID, PERSON:NA	Ye' tö shkö́k
Bribri0462	Ye' tö shkame̠' yö'	TENSE:PAS_PLU, VOICE:MID	Ye' tö shkö́k
Bribri0463	Ye' tö shkame̠' yö'	TYPE:NEG, TENSE:PAS_PLU, VOICE:MID	Ye' tö shkö́k
Bribri0253	Ye' tö kápi ya'	TYPE:NEG	Kë̀ ye' tö̀ wa̠ kàpa̠
Bribri0254	Ye' tö kápi ya'	TENSE:IPFV_PROG, ASPECT:IPFV	Ye' tö kàpa yè̠
Bribri0255	Ye' tö kápi ya'	TYPE:NEG, TENSE:IPFV_PROG, ASPECT:IPFV	Ye' tö kàpa yè̠
Bribri0256	Ye' tö kápi ya'	TENSE:PRF_PROG	Ye' bák kuö́k
Bribri0257	Ye' tö kápi ya'	TYPE:NEG, TENSE:PRF_PROG	Ye' tö kàpa yè̠
Bribri0258	Ye' tö kápi ya'	TENSE:PRF_REC	Ye' tö ká'éa̠
Bribri0259	Ye' tö kápi ya'	TYPE:NEG, TENSE:PRF_REC	Ye' tö kàpa yè̠
Bribri0260	Ye' tö kápi ya'	TENSE:IPFV_REC, ASPECT:IPFV	Ye' tö kàpa yè̠
Bribri0261	Ye' tö kápi ya'	TYPE:NEG, TENSE:IPFV_REC, ASPECT:IPFV	Ye' tö kàpa yè̠
Bribri0262	Ye' tö kápi ya'	TENSE:IPFV_HAB, ASPECT:IPFV	Ye' tö kàpa yè̠
Bribri0263	Ye' tö kápi ya'	TYPE:NEG, TENSE:IPFV_HAB, ASPECT:IPFV	Ye' tö kàpa yè̠
Bribri0264	Ye' tö kápi ya'	TENSE:FUT_CER, ASPECT:IPFV	Ye' tö kàpa yè̠
Bribri0265	Ye' tö kápi ya'	TYPE:NEG, TENSE:FUT_CER, ASPECT:IPFV	Ye' tö kàpa yè̠
Bribri0266	Ye' tö kápi ya'	VOICE:MID, PERSON:NA	Ye' tö kàpa yè̠
Bribri0267	Ye' tö kápi ya'	TYPE:NEG, VOICE:MID, PERSON:NA	Ye' tö kàpa yè̠
Bribri0268	Ye' tö kápi ya'	TENSE:PRF_REC, VOICE:MID, PERSON:NA	Ye' tö kàpa yè̠
Bribri0269	Ye' tö kápi ya'	TYPE:NEG, TENSE:PRF_REC, VOICE:MID, PERSON:NA	Ye' tö kàpa yè̠
Bribri0270	Ye' tö kápi ya'	TENSE:IPFV_REC, ASPECT:IPFV, VOICE:MID, PERSON:NA	Ye' tö kàpa yè̠
Bribri0271	Ye' tö kápi ya'	TYPE:NEG, TENSE:IPFV_REC, ASPECT:IPFV, VOICE:MID, PERSON:NA	Ye' tö kàpa yè̠
Bribri0272	Ye' tö kápi ya'	TENSE:IPFV_HAB, ASPECT:IPFV, VOICE:MID, PERSON:NA	Ye' tö kàpa yè̠
Bribri0273	Ye' tö kápi ya'	TYPE:NEG, TENSE:IPFV_HAB, ASPECT:IPFV, VOICE:MID, PERSON:NA	Ye' tö kàpa yè̠
Bribri0274	Ye' tö kápi ya'	MODE:IMP, TENSE:IPFV_REC, ASPECT:IPFV, PERSON:NA	Ye' tö kàpa yè̠
Bribri0275	Ye' tö kápi ya'	TYPE:NEG, MODE:IMP, TENSE:IPFV_REC, ASPECT:IPFV, PERSON:NA	Ye' tö kàpa yè̠
Bribri0276	Ye' tö kápi ya'	MODE:DES, TENSE:IPFV_REC, ASPECT:IPFV	Ye' tö kàpa yè̠
Bribri0277	Ye' tö kápi ya'	MODE:DES, TENSE:IPFV_REC, ASPECT:IPFV, VOICE:MID, PERSON:NA	Ye' tö kàpa yè̠
Bribri0278	Ye' tö kápi ya'	TENSE:FUT_POT, ASPECT:IPFV	Ye' tö kàpa yè̠
Bribri0279	Ye' tö kápi ya'	TYPE:NEG, TENSE:FUT_POT, ASPECT:IPFV	Ye' tö kàpa yè̠
Bribri0280	Ye' tö kápi ya'	TENSE:FUT_POT, ASPECT:IPFV, VOICE:MID, PERSON:NA	Ye' tö kàpa yè̠
Bribri0281	Ye' tö kápi ya'	TYPE:NEG, TENSE:FUT_POT, ASPECT:IPFV, VOICE:MID, PERSON:NA	Ye' tö kàpa yè̠
Bribri0282	Ye' tö kápi ya'	MODE:ADVERS, VOICE:MID, PERSON:NA	Ye' tö kàpa yè̠
Bribri0283	Ye' tö kápi ya'	TENSE:PAS_PLU	Ye' wa̠ kárule ye
Bribri0284	Ye' tö kápi ya'	TYPE:NEG, TENSE:PAS_PLU	Ye' tö kàpa yè̠
Bribri0989	Ye' úk	TYPE:NEG	Kë̀ ie' úkàne̠
Bribri0990	Ye' úk	PERSON:2_SI	Be' úk
Bribri0991	Ye' úk	TYPE:NEG, PERSON:2_SI	Ye' ujkö̀r
Bribri0992	Ye' úk	TENSE:IPFV_REC, ASPECT:IPFV	Ye' ujkö̀r
Bribri0993	Ye' úk	TENSE:IPFV_PROG, ASPECT:IPFV	Ye' ujkö̀r
Bribri0994	Ye' úk	TYPE:NEG, TENSE:IPFV_PROG, ASPECT:IPFV	Ye' ujkö̀r
Bribri0995	Ye' úk	TENSE:PRF_PROG	Ye' bák úkö́k
Bribri0996	Ye' úk	TYPE:NEG, TENSE:PRF_PROG	Ye' ujkö̀r
Bribri0997	Ye' úk	MODE:IMP, TENSE:IPFV_REC, ASPECT:IPFV, PERSON:2_SI	Ye' ujkö̀r
Bribri0998	Ye' úk	TENSE:IPFV_HAB, ASPECT:IPFV	Ye' ujkö̀r
Bribri0999	Ye' úk	VOICE:MID, ABSNUM:NI, PERSON:NA	Ye' ujkö̀r
Bribri1000	Ye' úk	TYPE:NEG, VOICE:MID, ABSNUM:NI, PERSON:NA	Ye' ujkö̀r
Bribri1001	Ye' úk	TENSE:IPFV_REC, ASPECT:IPFV, VOICE:MID, ABSNUM:NI, PERSON:NA	Ye' ujkö̀r
Bribri0869	Ka̠no̠' te̠n ká̠u̠k a̠	TYPE:NEG	Kë̀ ne' oe' kë̀ wa̠  e̠ne̠
Bribri0870	Ka̠no̠' te̠n ká̠u̠k a̠	TENSE:PRF_REM, ASPECT:PFV	Ka̠no̠' tsá kiö́k
Bribri0871	Ka̠no̠' te̠n ká̠u̠k a̠	TYPE:NEG, TENSE:PRF_REM, ASPECT:PFV	Ka̠no̠' tsá kiö́k
Bribri0872	Ka̠no̠' te̠n ká̠u̠k a̠	ABSNUM:PL	Kë' da' tsá ki'ule
Bribri0873	Ka̠no̠' te̠n ká̠u̠k a̠	TYPE:NEG, ABSNUM:PL	Ka̠no̠' tsá kiö́k
Bribri0874	Ka̠no̠' te̠n ká̠u̠k a̠	TENSE:PRF_REM, ASPECT:PFV, ABSNUM:PL	Ka̠no̠' tsá kiö́k
Bribri0875	Ka̠no̠' te̠n ká̠u̠k a̠	TYPE:NEG, TENSE:PRF_REM, ASPECT:PFV, ABSNUM:PL	Ka̠no̠' tsá kiö́k
Bribri0001	Ie' tso bua'	TYPE:NEG	Kë̀ ye' tso be̠ne̠
Bribri0002	Ie' tso bua'	TENSE:PRF_REM, ASPECT:PFV	Ie' tso biö́k
Bribri0003	Ie' tso bua'	TYPE:NEG, TENSE:PRF_REM, ASPECT:PFV	Ie' tso biö́k
Bribri0004	Ie' tso bua'	PERSON:1_SI	Ie' tso biö́k
Bribri0005	Ie' tso bua'	TYPE:NEG, PERSON:1_SI	Ie' tso biö́k
Bribri0006	Ie' tso bua'	TENSE:PRF_REM, ASPECT:PFV, PERSON:1_SI	Ie' tso biö́k
Bribri0007	Ie' tso bua'	TYPE:NEG, TENSE:PRF_REM, ASPECT:PFV, PERSON:1_SI	Ie' tso biö́k
Bribri0008	Ie' tso bua'	PERSON:2_SI	Ie' tso bi'ku̠
Bribri0009	Ie' tso bua'	TYPE:NEG, PERSON:2_SI	Ie' tso biö́k
Bribri0010	Ie' tso bua'	TENSE:PRF_REM, ASPECT:PFV, PERSON:2_SI	Ie' tso biö́k
Bribri0011	Ie' tso bua'	TYPE:NEG, TENSE:PRF_REM, ASPECT:PFV, PERSON:2_SI	Ie' tso biö́k
Bribri0012	Ie' tso bua'	ABSNUM:PL, PERSON:1_PL_EXC	Ie' tso biö́k
Bribri0013	Ie' tso bua'	TYPE:NEG, ABSNUM:PL, PERSON:1_PL_EXC	Ie' tso biö́k
Bribri0014	Ie' tso bua'	TENSE:PRF_REM, ASPECT:PFV, ABSNUM:PL, PERSON:1_PL_EXC	Ie' tso biö́k
Bribri0015	Ie' tso bua'	TYPE:NEG, TENSE:PRF_REM, ASPECT:PFV, ABSNUM:PL, PERSON:1_PL_EXC	Ie' tso biö́k
Bribri0016	Ie' tso bua'	ABSNUM:PL, PERSON:1_PL_INC	Ie' tso biö́k
Bribri0017	Ie' tso bua'	TYPE:NEG, ABSNUM:PL, PERSON:1_PL_INC	Ie' tso biö́k
Bribri0018	Ie' tso bua'	TENSE:PRF_REM, ASPECT:PFV, ABSNUM:PL, PERSON:1_PL_INC	Ie' tso biö́k
Bribri0019	Ie' tso bua'	TYPE:NEG, TENSE:PRF_REM, ASPECT:PFV, ABSNUM:PL, PERSON:1_PL_INC	Ie' tso biö́k
Bribri0020	Ie' tso bua'	ABSNUM:PL, PERSON:2_PL	Ie' tso biö́k
Bribri0021	Ie' tso bua'	TYPE:NEG, ABSNUM:PL, PERSON:2_PL	Ie' tso biö́k
Bribri0022	Ie' tso bua'	TENSE:PRF_REM, ASPECT:PFV, ABSNUM:PL, PERSON:2_PL	Ie' tso biö́k
Bribri0023	Ie' tso bua'	TYPE:NEG, TENSE:PRF_REM, ASPECT:PFV, ABSNUM:PL, PERSON:2_PL	Ie' tso biö́k
Bribri0024	Ie' tso bua'	ABSNUM:PL, PERSON:3_PL	Ie' tso biö́k
Bribri0025	Ie' tso bua'	TYPE:NEG, ABSNUM:PL, PERSON:3_PL	Ie' tso biö́k
Bribri0026	Ie' tso bua'	TENSE:PRF_REM, ASPECT:PFV, ABSNUM:PL, PERSON:3_PL	Ie' tso biö́k
Bribri0027	Ie' tso bua'	TYPE:NEG, TENSE:PRF_REM, ASPECT:PFV, ABSNUM:PL, PERSON:3_PL	Ie' tso biö́k
Bribri0464	Ye' tö uyë̀jkuö à̠ríts	TENSE:IPFV_PROG, ASPECT:IPFV, PERSON:3_SI	Ye' tö uöë j̠'tak kuö́k
Bribri0465	Ye' tö uyë̀jkuö à̠ríts	TENSE:IPFV_REC, ASPECT:IPFV	Ye' tö uöë j̠'tak kuö́k
Bribri0466	Ye' tö uyë̀jkuö à̠ríts	TYPE:NEG, TENSE:IPFV_REC, ASPECT:IPFV	Ye' tö uöë j̠'tak kuö́k
Bribri0467	Ye' tö uyë̀jkuö à̠ríts	MODE:POT, TENSE:IPFV_REC, ASPECT:IPFV, PERSON:3_SI	Ye' tö uöë j̠'tak kuö́k
Bribri0468	Ye' tö uyë̀jkuö à̠ríts	TYPE:NEG, MODE:POT, TENSE:IPFV_REC, ASPECT:IPFV, PERSON:3_SI	Ye' tö uöë j̠'tak kuö́k
Bribri0388	Chìchi dör tsîr	ABSNUM:PL	Po' dö' tsr të'rte
Bribri0848	Dù tkër kàl ulà ki̠	TYPE:NEG	Dù kë̀ wa̠ kàl ulà ki̠
Bribri0849	Dù tkër kàl ulà ki̠	TENSE:PRF_REM, ASPECT:PFV	Dù tkë̀ ku̠ kàl ulà ki̠
Bribri0850	Dù tkër kàl ulà ki̠	TYPE:NEG, TENSE:PRF_REM, ASPECT:PFV	Dù tkë̀ ku̠ kàl ulà ki̠
Bribri0851	Dù tkër kàl ulà ki̠	ABSNUM:PL	Dù' dapárke kàl ulà ki̠
Bribri0852	Dù tkër kàl ulà ki̠	TYPE:NEG, ABSNUM:PL	Dù tkë̀ ku̠ kàl ulà ki̠
Bribri0853	Dù tkër kàl ulà ki̠	TENSE:PRF_REM, ASPECT:PFV, ABSNUM:PL	Dù tkë̀ ku̠ kàl ulà ki̠
Bribri0854	Dù tkër kàl ulà ki̠	TYPE:NEG, TENSE:PRF_REM, ASPECT:PFV, ABSNUM:PL	Dù tkë̀ ku̠ kàl ulà ki̠
Bribri0028	Ye' i̠ni̠'	PERSON:3_SI	Ie' i̠'i̠
Bribri0029	Ye' i̠ni̠'	PERSON:2_SI	Be' i̠'i̠'ta̠
Bribri0030	Ye' i̠ni̠'	ABSNUM:PL, PERSON:1_PL_EXC	Ye' i̠' ̠mè̠
Bribri0031	Ye' i̠ni̠'	ABSNUM:PL, PERSON:1_PL_INC	Ye' i̠' ̠mè̠
Bribri0032	Ye' i̠ni̠'	ABSNUM:PL, PERSON:2_PL	Ye' i̠' ̠mè̠
Bribri0033	Ye' i̠ni̠'	ABSNUM:PL, PERSON:3_PL	Ye' i̠' ̠mè̠
Bribri0034	Ye' i̠ni̠'	TENSE:PRF_REC, PERSON:3_SI	Ye' i̠' ̠mè̠
Bribri0035	Ye' i̠ni̠'	TENSE:PRF_REC	Ye' i̠ i̠'ta̠
Bribri0036	Ye' i̠ni̠'	TENSE:PRF_REC, PERSON:2_SI	Ye' i̠' ̠mè̠
Bribri0037	Ye' i̠ni̠'	TENSE:PRF_REC, ABSNUM:PL, PERSON:1_PL_EXC	Ye' i̠' ̠mè̠
Bribri0038	Ye' i̠ni̠'	TENSE:PRF_REC, ABSNUM:PL, PERSON:1_PL_INC	Ye' i̠' ̠mè̠
Bribri0039	Ye' i̠ni̠'	TENSE:PRF_REC, ABSNUM:PL, PERSON:2_PL	Ye' i̠' ̠mè̠
Bribri0040	Ye' i̠ni̠'	TENSE:PRF_REC, ABSNUM:PL, PERSON:3_PL	Ye' i̠' ̠mè̠
Bribri0041	Ye' i̠ni̠'	TENSE:IPFV_REC, ASPECT:IPFV, PERSON:3_SI	Ye' i̠' ̠mè̠
Bribri0042	Ye' i̠ni̠'	TENSE:IPFV_REC, ASPECT:IPFV	Ye' i̠' ̠mè̠
Bribri0043	Ye' i̠ni̠'	TENSE:IPFV_HAB, ASPECT:IPFV, PERSON:3_SI	Ye' i̠' ̠mè̠
Bribri0044	Ye' i̠ni̠'	TENSE:IPFV_HAB, ASPECT:IPFV	Ye' i̠' ̠mè̠
Bribri0045	Ye' i̠ni̠'	TYPE:NEG, TENSE:IPFV_HAB, ASPECT:IPFV	Ye' i̠' ̠mè̠
Bribri0046	Ye' i̠ni̠'	TENSE:IPFV_REC, ASPECT:IPFV, VOICE:MID, ABSNUM:NI, PERSON:NA	Ye' i̠' ̠mè̠
Bribri0047	Ye' i̠ni̠'	VOICE:MID, ABSNUM:NI, PERSON:NA	Ye' i̠' ̠mè̠
Bribri0048	Ye' i̠ni̠'	TYPE:NEG, VOICE:MID	Ye' i̠' ̠mè̠
Bribri0049	Ye' i̠ni̠'	TENSE:FUT_CER, ASPECT:IPFV	Ye' i̠' ̠mè̠
Bribri0050	Ye' i̠ni̠'	TYPE:NEG, TENSE:FUT_CER, ASPECT:IPFV	Ye' i̠' ̠mè̠
Bribri0051	Ye' i̠ni̠'	TENSE:IPFV_PROG, ASPECT:IPFV	Ye' i̠' ̠mè̠
Bribri0052	Ye' i̠ni̠'	TYPE:NEG, TENSE:IPFV_REC, ASPECT:IPFV	Ye' i̠' ̠mè̠
Bribri0053	Ye' i̠ni̠'	TENSE:PAS_PLU	Ye' wa̠ i̠ria̠
Bribri0054	Ye' i̠ni̠'	TYPE:NEG, TENSE:PAS_PLU	Ye' i̠' ̠mè̠
Bribri0055	Ye' i̠ni̠'	TENSE:FUT_POT, ASPECT:IPFV	Ye' i̠' ̠mè̠
Bribri0056	Ye' i̠ni̠'	TYPE:NEG, TENSE:FUT_POT, ASPECT:IPFV	Ye' i̠' ̠mè̠
Bribri0057	Ye' i̠ni̠'	MODE:DES, TENSE:IPFV_REC, ASPECT:IPFV, PERSON:3_SI	Ye' i̠' ̠mè̠
Bribri0058	Ye' i̠ni̠'	MODE:EXH, TENSE:IPFV_REC, ASPECT:IPFV, ABSNUM:PL, PERSON:1_PL_INC	Ye' i̠' ̠mè̠
Bribri0059	Ye' i̠ni̠'	MODE:IMP, TENSE:IPFV_REC, ASPECT:IPFV, PERSON:2_SI	Ye' i̠' ̠mè̠
Bribri0060	Ye' i̠ni̠'	TYPE:NEG, MODE:IMP, TENSE:IPFV_REC, ASPECT:IPFV, PERSON:2_SI	Ye' i̠' ̠mè̠
Bribri0061	Ye' i̠ni̠'	MODE:POT, TENSE:IPFV_REC, ASPECT:IPFV, PERSON:3_SI	Ye' i̠' ̠mè̠
Bribri0062	Ye' i̠ni̠'	TYPE:NEG, MODE:POT, TENSE:IPFV_REC, ASPECT:IPFV, PERSON:3_SI	Ye' i̠' ̠mè̠
Bribri0883	Ie' tkër kula' ki̠	TYPE:NEG	Kë̀ ye' tö̀ wa̠ kàlku̠
Bribri0884	Ie' tkër kula' ki̠	TENSE:PRF_REM, ASPECT:PFV	Ie' tö  ulur 'i̠
Bribri0885	Ie' tkër kula' ki̠	TYPE:NEG, TENSE:PRF_REM, ASPECT:PFV	Ie' tö  ulur 'i̠
Bribri0886	Ie' tkër kula' ki̠	ABSNUM:PL, PERSON:3_PL	Ie' tö  ulur 'i̠
Bribri0887	Ie' tkër kula' ki̠	TYPE:NEG, ABSNUM:PL, PERSON:3_PL	Ie' tö  ulur 'i̠
Bribri0888	Ie' tkër kula' ki̠	TENSE:PRF_REM, ASPECT:PFV, ABSNUM:PL, PERSON:3_PL	Ie' tö  ulur 'i̠
Bribri0889	Ie' tkër kula' ki̠	TYPE:NEG, TENSE:PRF_REM, ASPECT:PFV, ABSNUM:PL, PERSON:3_PL	Ie' tö  ulur 'i̠
Bribri0141	Be' chka'	TENSE:IPFV_PROG, ASPECT:IPFV	Be' chkö̀râ
Bribri0142	Be' chka'	TYPE:NEG, TENSE:IPFV_PROG, ASPECT:IPFV	Be' chkö̀râ
Bribri0143	Be' chka'	MODE:IMP, TENSE:IPFV_REC, ASPECT:IPFV	Be' chkö̀râ
Bribri0144	Be' chka'	TYPE:NEG, MODE:IMP, TENSE:IPFV_REC, ASPECT:IPFV	Be' chkö̀râ
Bribri0248	Ye' tö i stsë'	TENSE:IPFV_REC, ASPECT:IPFV, VOICE:MID, PERSON:3_SI	Ye' tö i së'te̠
Bribri0249	Ye' tö i stsë'	TENSE:IPFV_HAB, ASPECT:IPFV, VOICE:MID, PERSON:3_SI	Ye' tö i së'te̠
Bribri0250	Ye' tö i stsë'	TYPE:NEG, TENSE:IPFV_HAB, ASPECT:IPFV, VOICE:MID, PERSON:3_SI	Ye' tö i së'te̠
Bribri0251	Ye' tö i stsë'	TENSE:FUT_POT, ASPECT:IPFV, VOICE:MID, PERSON:3_SI	Ye' tö i së'te̠
Bribri0252	Ye' tö i stsë'	TYPE:NEG, TENSE:FUT_POT, ASPECT:IPFV, VOICE:MID, PERSON:3_SI	Ye' tö i së'te̠
Bribri0385	Ie' e̠' tkë'wa̠	ABSNUM:PL, PERSON:3_PL	Ie' e̠' tkë'ra
Bribri0521	Kirë̀ tö tabè a̠me̠' ie' a̠	TYPE:NEG	Kë̀ ëe' wa̠ ta̠  a̠  a̠ e̠
Bribri0522	Kirë̀ tö tabè a̠me̠' ie' a̠	ASPECT:INC	Kirë̀ tö ta'  amémi̠mi̠
Bribri0523	Kirë̀ tö tabè a̠me̠' ie' a̠	TENSE:PRF_REC	Kirë̀ tö tabé a̠é ̠é
Bribri0524	Kirë̀ tö tabè a̠me̠' ie' a̠	TYPE:NEG, TENSE:PRF_REC	Kirë̀ tö ta' tse  ië'ta̠
Bribri0525	Kirë̀ tö tabè a̠me̠' ie' a̠	TENSE:PRF_REC, ASPECT:INC	Kirë̀ tö ta' tse  ië'ta̠
Bribri0526	Kirë̀ tö tabè a̠me̠' ie' a̠	TENSE:IPFV_REC, ASPECT:IPFV	Kirë̀ tö ta' tse  ië'ta̠
Bribri0527	Kirë̀ tö tabè a̠me̠' ie' a̠	TYPE:NEG, TENSE:IPFV_REC, ASPECT:IPFV	Kirë̀ tö ta' tse  ië'ta̠
Bribri0528	Kirë̀ tö tabè a̠me̠' ie' a̠	TENSE:IPFV_PROG, ASPECT:IPFV	Kirë̀ tö ta' tse  ië'ta̠
Bribri0529	Kirë̀ tö tabè a̠me̠' ie' a̠	TYPE:NEG, TENSE:IPFV_PROG, ASPECT:IPFV	Kirë̀ tö ta' tse  ië'ta̠
Bribri0530	Kirë̀ tö tabè a̠me̠' ie' a̠	TENSE:PRF_PROG	Kirë' bák tö́k  iö́k
Bribri0531	Kirë̀ tö tabè a̠me̠' ie' a̠	TYPE:NEG, TENSE:PRF_PROG	Kirë̀ tö ta' tse  ië'ta̠
Bribri0532	Kirë̀ tö tabè a̠me̠' ie' a̠	MODE:IMP, TENSE:IPFV_REC, ASPECT:IPFV	Kirë̀ tö ta' tse  ië'ta̠
Bribri0533	Kirë̀ tö tabè a̠me̠' ie' a̠	TYPE:NEG, MODE:IMP, TENSE:IPFV_REC, ASPECT:IPFV	Kirë̀ tö ta' tse  ië'ta̠
Bribri0534	Kirë̀ tö tabè a̠me̠' ie' a̠	TYPE:NEG, MODE:IMP, TENSE:IPFV_REC, ASPECT:IPFV, VOICE:MID	Kirë̀ tö ta' tse  ië'ta̠
Bribri0535	Kirë̀ tö tabè a̠me̠' ie' a̠	MODE:EXH, TENSE:IPFV_REC, ASPECT:IPFV, PERSON:1_PL_INC	Kirë̀ tö ta' tse  ië'ta̠
Bribri0536	Kirë̀ tö tabè a̠me̠' ie' a̠	MODE:DES, TENSE:IPFV_REC, ASPECT:IPFV	Kirë̀ tö ta' tse  ië'ta̠
Bribri0537	Kirë̀ tö tabè a̠me̠' ie' a̠	TYPE:NEG, MODE:DES, TENSE:IPFV_REC, ASPECT:IPFV	Kirë̀ tö ta' tse  ië'ta̠
Bribri0538	Kirë̀ tö tabè a̠me̠' ie' a̠	MODE:ADVERS	Kirë' wa̠  a'  a̠ e' ta̠
Bribri0539	Kirë̀ tö tabè a̠me̠' ie' a̠	TENSE:IPFV_HAB, ASPECT:IPFV	Kirë̀ tö ta' tse  ië'ta̠
Bribri0540	Kirë̀ tö tabè a̠me̠' ie' a̠	TYPE:NEG, TENSE:IPFV_HAB, ASPECT:IPFV	Kirë̀ tö ta' tse  ië'ta̠
Bribri0541	Kirë̀ tö tabè a̠me̠' ie' a̠	TENSE:FUT_POT, ASPECT:IPFV	Kirë̀ tö ta' tse  ië'ta̠
Bribri0542	Kirë̀ tö tabè a̠me̠' ie' a̠	TYPE:NEG, TENSE:FUT_POT, ASPECT:IPFV	Kirë̀ tö ta' tse  ië'ta̠
Bribri0543	Kirë̀ tö tabè a̠me̠' ie' a̠	TENSE:FUT_CER, ASPECT:IPFV	Kirë̀ tö ta' tse  ië'ta̠
Bribri0544	Kirë̀ tö tabè a̠me̠' ie' a̠	TYPE:NEG, TENSE:FUT_CER, ASPECT:IPFV	Kirë̀ tö ta' tse  ië'ta̠
Bribri0545	Kirë̀ tö tabè a̠me̠' ie' a̠	VOICE:MID	Po'tak kö̀ne̠
Bribri0546	Kirë̀ tö tabè a̠me̠' ie' a̠	TYPE:NEG, VOICE:MID	Kirë̀ tö ta' tse  ië'ta̠
Bribri0547	Kirë̀ tö tabè a̠me̠' ie' a̠	TENSE:PRF_REC, VOICE:MID	Kirë̀ tö ta' tse  ië'ta̠
Bribri0548	Kirë̀ tö tabè a̠me̠' ie' a̠	TYPE:NEG, TENSE:PRF_REC, VOICE:MID	Kirë̀ tö ta' tse  ië'ta̠
Bribri0549	Kirë̀ tö tabè a̠me̠' ie' a̠	TENSE:IPFV_REC, ASPECT:IPFV, VOICE:MID	Kirë̀ tö ta' tse  ië'ta̠
Bribri0550	Kirë̀ tö tabè a̠me̠' ie' a̠	TYPE:NEG, TENSE:IPFV_REC, ASPECT:IPFV, VOICE:MID	Kirë̀ tö ta' tse  ië'ta̠
Bribri0551	Kirë̀ tö tabè a̠me̠' ie' a̠	TENSE:IPFV_HAB, ASPECT:IPFV, VOICE:MID	Kirë̀ tö ta' tse  ië'ta̠
Bribri0552	Kirë̀ tö tabè a̠me̠' ie' a̠	TYPE:NEG, TENSE:IPFV_HAB, ASPECT:IPFV, VOICE:MID	Kirë̀ tö ta' tse  ië'ta̠
Bribri0553	Kirë̀ tö tabè a̠me̠' ie' a̠	TENSE:FUT_POT, ASPECT:IPFV, VOICE:MID	Kirë̀ tö ta' tse  ië'ta̠
Bribri0554	Kirë̀ tö tabè a̠me̠' ie' a̠	TYPE:NEG, TENSE:FUT_POT, ASPECT:IPFV, VOICE:MID	Kirë̀ tö ta' tse  ië'ta̠
Bribri0555	Kirë̀ tö tabè a̠me̠' ie' a̠	TENSE:FUT_CER, ASPECT:IPFV, VOICE:MID	Kirë̀ tö ta' tse  ië'ta̠
Bribri0556	Kirë̀ tö tabè a̠me̠' ie' a̠	TYPE:NEG, TENSE:FUT_CER, ASPECT:IPFV, VOICE:MID	Kirë̀ tö ta' tse  ië'ta̠
Bribri0557	Kirë̀ tö tabè a̠me̠' ie' a̠	TENSE:PAS_PLU, VOICE:MID	Kirë̀ tö ta' tse  ië'ta̠
Bribri0558	Kirë̀ tö tabè a̠me̠' ie' a̠	TYPE:NEG, TENSE:PAS_PLU, VOICE:MID	Kirë̀ tö ta' tse  ië'ta̠
Bribri0559	Kirë̀ tö tabè a̠me̠' ie' a̠	MODE:POT, TENSE:IPFV_REC, ASPECT:IPFV	Kirë̀ tö ta' tse  ië'ta̠
Bribri0560	Kirë̀ tö tabè a̠me̠' ie' a̠	TYPE:NEG, MODE:POT, TENSE:IPFV_REC, ASPECT:IPFV	Kirë̀ tö ta' tse  ië'ta̠
Bribri0392	Ye' tö uyë̀jkuö à̠ritsè bua'ë	TYPE:NEG	Ye' kë̀ wa̠ uö uö̀ wa̠ è̠ ie bi̠
Bribri0389	Aláköl a̠wì̠ dör buáala	ABSNUM:PL	Alákë' tö ìö'ta̠wa̠
Bribri0906	Alà mì̠ne̠ i ma̠u̠k	ABSNUM:PL	Alà dapármi të'r
Bribri0907	Alà mì̠ne̠ i ma̠u̠k	TYPE:NEG	Al  kë̀ wa̠ i mìne̠
Bribri0908	Alà mì̠ne̠ i ma̠u̠k	TYPE:NEG, ABSNUM:PL	Alà mö̀ e̠ i mi̠
Bribri0909	Alà mì̠ne̠ i ma̠u̠k	TENSE:PRF_REC	Alà mì̠ne̠ i mé̠
Bribri0910	Alà mì̠ne̠ i ma̠u̠k	TENSE:PRF_REC, ABSNUM:PL	Alà mö̀ e̠ i mi̠
Bribri0911	Alà mì̠ne̠ i ma̠u̠k	TENSE:IPFV_REC, ASPECT:IPFV	Alà mö̀ e̠ i mi̠
Bribri0912	Alà mì̠ne̠ i ma̠u̠k	TENSE:IPFV_REC, ASPECT:IPFV, ABSNUM:PL	Alà mö̀ e̠ i mi̠
Bribri0913	Alà mì̠ne̠ i ma̠u̠k	TENSE:IPFV_PROG, ASPECT:IPFV	Alà mö̀ e̠ i mi̠
Bribri0914	Alà mì̠ne̠ i ma̠u̠k	TYPE:NEG, TENSE:IPFV_PROG, ASPECT:IPFV	Alà mö̀ e̠ i mi̠
Bribri0915	Alà mì̠ne̠ i ma̠u̠k	TENSE:PRF_PROG	Alà bák e mí̠k
Bribri0916	Alà mì̠ne̠ i ma̠u̠k	TYPE:NEG, TENSE:PRF_PROG	Alà mö̀ e̠ i mi̠
Bribri0917	Alà mì̠ne̠ i ma̠u̠k	TENSE:IPFV_PROG, ASPECT:IPFV, ABSNUM:PL	Alà mö̀ e̠ i mi̠
Bribri0918	Alà mì̠ne̠ i ma̠u̠k	TYPE:NEG, TENSE:IPFV_PROG, ASPECT:IPFV, ABSNUM:PL	Alà mö̀ e̠ i mi̠
Bribri0919	Alà mì̠ne̠ i ma̠u̠k	TENSE:PRF_PROG, ABSNUM:PL	Alà mö̀ e̠ i mi̠
Bribri0920	Alà mì̠ne̠ i ma̠u̠k	TYPE:NEG, TENSE:PRF_PROG, ABSNUM:PL	Alà mö̀ e̠ i mi̠
Bribri0393	Awá tsë'	TENSE:PRF_REC	Awá tsë̀
Bribri0145	Ie' tö àrros ña̠'	ASPECT:INC	Ie' tö àrros tó̠mi̠ ñè̠
Bribri0146	Ie' tö àrros ña̠'	TYPE:NEG	Ie' kë̀ wa̠ àrros tò̠ne̠ ñè̠
Bribri0147	Ie' tö àrros ña̠'	TENSE:IPFV_PROG, ASPECT:IPFV	Ie' bö àrros ta̠wè̠k ñè̠
Bribri0148	Ie' tö àrros ña̠'	TYPE:NEG, TENSE:IPFV_PROG, ASPECT:IPFV	Ie' bö àrros ta̠wè̠k ñè̠
Bribri0149	Ie' tö àrros ña̠'	TENSE:PRF_PROG	Ie' bák àrros ta̠ú̠k ñè̠
Bribri0150	Ie' tö àrros ña̠'	TYPE:NEG, TENSE:PRF_PROG	Ie' bö àrros ta̠wè̠k ñè̠
Bribri0151	Ie' tö àrros ña̠'	TENSE:IPFV_REC, ASPECT:IPFV	Ie' bö àrros ta̠wè̠k ñè̠
Bribri0152	Ie' tö àrros ña̠'	TYPE:NEG, TENSE:IPFV_REC, ASPECT:IPFV	Ie' bö àrros ta̠wè̠k ñè̠
Bribri0153	Ie' tö àrros ña̠'	MODE:IMP, TENSE:IPFV_REC, ASPECT:IPFV, PERSON:NA	Ie' bö àrros ta̠wè̠k ñè̠
Bribri0154	Ie' tö àrros ña̠'	TYPE:NEG, MODE:IMP, TENSE:IPFV_REC, ASPECT:IPFV, PERSON:NA	Ie' bö àrros ta̠wè̠k ñè̠
Bribri0155	Ie' tö àrros ña̠'	TYPE:NEG, MODE:IMP, TENSE:IPFV_REC, ASPECT:IPFV, VOICE:MID, PERSON:NA	Ie' bö àrros ta̠wè̠k ñè̠
Bribri0156	Ie' tö àrros ña̠'	MODE:EXH, TENSE:IPFV_REC, ASPECT:IPFV, PERSON:1_PL_INC	Ie' bö àrros ta̠wè̠k ñè̠
Bribri0157	Ie' tö àrros ña̠'	MODE:DES, TENSE:IPFV_REC, ASPECT:IPFV	Ie' bö àrros ta̠wè̠k ñè̠
Bribri0158	Ie' tö àrros ña̠'	TYPE:NEG, MODE:DES, TENSE:IPFV_REC, ASPECT:IPFV	Ie' bö àrros ta̠wè̠k ñè̠
Bribri0159	Ie' tö àrros ña̠'	MODE:ADVERS	Ie' wa̠ àrros ta̠wa̠' ñè̠
Bribri0160	Ie' tö àrros ña̠'	TENSE:PRF_REC	Ie' tö àrros ña̠wa̠ ñè̠
Bribri0161	Ie' tö àrros ña̠'	TENSE:PRF_REC, ASPECT:INC	Ie' bö àrros ta̠wè̠k ñè̠
Bribri0162	Ie' tö àrros ña̠'	TYPE:NEG, TENSE:PRF_REC	Ie' bö àrros ta̠wè̠k ñè̠
Bribri0163	Ie' tö àrros ña̠'	TENSE:IPFV_HAB, ASPECT:IPFV	Ie' bö àrros ta̠wè̠k ñè̠
Bribri0164	Ie' tö àrros ña̠'	TYPE:NEG, TENSE:IPFV_HAB, ASPECT:IPFV	Ie' bö àrros ta̠wè̠k ñè̠
Bribri0165	Ie' tö àrros ña̠'	TENSE:FUT_POT, ASPECT:IPFV	Ie' bö àrros ta̠wè̠k ñè̠
Bribri0166	Ie' tö àrros ña̠'	TYPE:NEG, TENSE:FUT_POT, ASPECT:IPFV	Ie' bö àrros ta̠wè̠k ñè̠
Bribri0167	Ie' tö àrros ña̠'	TENSE:FUT_CER, ASPECT:IPFV	Ie' bö àrros ta̠wè̠k ñè̠
Bribri0168	Ie' tö àrros ña̠'	TYPE:NEG, TENSE:FUT_CER, ASPECT:IPFV	Ie' bö àrros ta̠wè̠k ñè̠
Bribri0169	Ie' tö àrros ña̠'	TENSE:IPFV_REC, ASPECT:IPFV, VOICE:MID, PERSON:NA	Ie' bö àrros ta̠wè̠k ñè̠
Bribri0170	Ie' tö àrros ña̠'	TYPE:NEG, TENSE:IPFV_REC, ASPECT:IPFV, VOICE:MID, PERSON:NA	Ie' bö àrros ta̠wè̠k ñè̠
Bribri0171	Ie' tö àrros ña̠'	VOICE:MID, PERSON:NA	Ie' bö àrros ta̠wè̠k ñè̠
Bribri0172	Ie' tö àrros ña̠'	TYPE:NEG, VOICE:MID, PERSON:NA	Ie' bö àrros ta̠wè̠k ñè̠
Bribri0173	Ie' tö àrros ña̠'	TENSE:PRF_REC, VOICE:MID, PERSON:NA	Ie' bö àrros ta̠wè̠k ñè̠
Bribri0174	Ie' tö àrros ña̠'	TYPE:NEG, TENSE:PRF_REC, VOICE:MID, PERSON:NA	Ie' bö àrros ta̠wè̠k ñè̠
Bribri0175	Ie' tö àrros ña̠'	TENSE:IPFV_HAB, ASPECT:IPFV, VOICE:MID, PERSON:NA	Ie' bö àrros ta̠wè̠k ñè̠
Bribri0176	Ie' tö àrros ña̠'	TYPE:NEG, TENSE:IPFV_HAB, ASPECT:IPFV, VOICE:MID, PERSON:NA	Ie' bö àrros ta̠wè̠k ñè̠
Bribri0177	Ie' tö àrros ña̠'	TENSE:FUT_POT, ASPECT:IPFV, VOICE:MID, PERSON:NA	Ie' bö àrros ta̠wè̠k ñè̠
Bribri0178	Ie' tö àrros ña̠'	TYPE:NEG, TENSE:FUT_POT, ASPECT:IPFV, VOICE:MID, PERSON:NA	Ie' bö àrros ta̠wè̠k ñè̠
Bribri0179	Ie' tö àrros ña̠'	TENSE:FUT_CER, ASPECT:IPFV, VOICE:MID, PERSON:NA	Ie' bö àrros ta̠wè̠k ñè̠
Bribri0180	Ie' tö àrros ña̠'	TYPE:NEG, TENSE:FUT_CER, ASPECT:IPFV, VOICE:MID, PERSON:NA	Ie' bö àrros ta̠wè̠k ñè̠
Bribri0181	Ie' tö àrros ña̠'	TENSE:PAS_PLU	Ie' wa̠ àrros ñó̠rule ñè̠
Bribri0182	Ie' tö àrros ña̠'	TYPE:NEG, TENSE:PAS_PLU	Ie' bö àrros ta̠wè̠k ñè̠
Bribri0183	Ie' tö àrros ña̠'	TENSE:PAS_PLU, VOICE:MID, PERSON:NA	Ie' bö àrros ta̠wè̠k ñè̠
Bribri0184	Ie' tö àrros ña̠'	TYPE:NEG, TENSE:PAS_PLU, VOICE:MID, PERSON:NA	Ie' bö àrros ta̠wè̠k ñè̠
Bribri0288	Skuë̀ ta̠'	TENSE:PRF_REM, ASPECT:PFV	Skuë' ta̠ ta'te̠
Bribri0097	Ye' tú̠ne̠'	TYPE:NEG	Ye' kë̀ wa̠ e̠ne̠
Bribri0098	Ye' tú̠ne̠'	TENSE:PRF_REC	Ye' ts̠ e̠
Bribri0099	Ye' tú̠ne̠'	TYPE:NEG, TENSE:PRF_REC	Ye' tso nè̠
Bribri0100	Ye' tú̠ne̠'	TENSE:IPFV_REC, ASPECT:IPFV	Ye' tso nè̠
Bribri0101	Ye' tú̠ne̠'	TYPE:NEG, TENSE:IPFV_REC, ASPECT:IPFV	Ye' tso nè̠
Bribri0102	Ye' tú̠ne̠'	TENSE:IPFV_REC, ASPECT:IPFV, PERSON:3_SI	Ye' tso nè̠
Bribri0103	Ye' tú̠ne̠'	TENSE:IPFV_REC, ASPECT:IPFV, ABSNUM:PL, PERSON:3_PL	Ye' tso nè̠
Bribri0104	Ye' tú̠ne̠'	TYPE:NEG, TENSE:IPFV_REC, ASPECT:IPFV, PERSON:3_SI	Ye' tso nè̠
Bribri0105	Ye' tú̠ne̠'	TENSE:IPFV_PROG, ASPECT:IPFV	Ye' tso nè̠
Bribri0106	Ye' tú̠ne̠'	TYPE:NEG, TENSE:IPFV_PROG, ASPECT:IPFV	Ye' tso nè̠
Bribri0107	Ye' tú̠ne̠'	TENSE:PRF_PROG	Ye' bák ts̠ e̠
Bribri0108	Ye' tú̠ne̠'	TYPE:NEG, TENSE:PRF_PROG	Ye' tso nè̠
Bribri0109	Ye' tú̠ne̠'	MODE:IMP, TENSE:IPFV_REC, ASPECT:IPFV, PERSON:2_SI	Ye' tso nè̠
Bribri0110	Ye' tú̠ne̠'	MODE:IMP, TENSE:IPFV_REC, ASPECT:IPFV, ABSNUM:PL, PERSON:2_PL	Ye' tso nè̠
Bribri0111	Ye' tú̠ne̠'	TYPE:NEG, MODE:IMP, TENSE:IPFV_REC, ASPECT:IPFV, PERSON:2_SI	Ye' tso nè̠
Bribri0112	Ye' tú̠ne̠'	TYPE:NEG, MODE:IMP, TENSE:IPFV_REC, ASPECT:IPFV, ABSNUM:PL, PERSON:2_PL	Ye' tso nè̠
Bribri0113	Ye' tú̠ne̠'	TENSE:IPFV_HAB, ASPECT:IPFV	Ye' tso nè̠
Bribri0114	Ye' tú̠ne̠'	TYPE:NEG, TENSE:IPFV_HAB, ASPECT:IPFV	Ye' tso nè̠
Bribri0115	Ye' tú̠ne̠'	TENSE:FUT_POT, ASPECT:IPFV	Ye' tso nè̠
Bribri0116	Ye' tú̠ne̠'	TYPE:NEG, TENSE:FUT_POT, ASPECT:IPFV	Ye' tso nè̠
Bribri0117	Ye' tú̠ne̠'	TENSE:FUT_CER, ASPECT:IPFV	Ye' tso nè̠
Bribri0118	Ye' tú̠ne̠'	TYPE:NEG, TENSE:FUT_CER, ASPECT:IPFV	Ye' tso nè̠
Bribri0119	Ye' tú̠ne̠'	VOICE:MID, ABSNUM:NI, PERSON:NA	Ye' tso nè̠
Bribri0120	Ye' tú̠ne̠'	TYPE:NEG, VOICE:MID, ABSNUM:NI, PERSON:NA	Ye' tso nè̠
Bribri0121	Ye' tú̠ne̠'	TENSE:PRF_REC, VOICE:MID, ABSNUM:NI, PERSON:NA	Ye' tso nè̠
Bribri0122	Ye' tú̠ne̠'	TYPE:NEG, TENSE:PRF_REC, VOICE:MID, ABSNUM:NI, PERSON:NA	Ye' tso nè̠
Bribri0801	Ye' a̠mì̠ tö bö̀wö duké wö'ik	TYPE:NEG	Kë̀ ye' a̠ ìö be' uö be̠ ök  ulul  ök
Bribri0802	Ye' a̠mì̠ tö bö̀wö duké wö'ik	ASPECT:INC	Ye' a̠'ì̠ tö bö' uémi̠mi̠mi̠
Bribri0803	Ye' a̠mì̠ tö bö̀wö duké wö'ik	TENSE:PRF_REC	Ye' a̠mì̠ tö böé öé daééé
Bribri0804	Ye' a̠mì̠ tö bö̀wö duké wö'ik	TYPE:NEG, TENSE:PRF_REC	Ye' a̠ ìö bö' ua̠ ul  ulul uli wiè
Bribri0805	Ye' a̠mì̠ tö bö̀wö duké wö'ik	TENSE:PRF_REC, ASPECT:INC	Ye' a̠ ìö bö' ua̠ ul  ulul uli wiè
Bribri0806	Ye' a̠mì̠ tö bö̀wö duké wö'ik	TENSE:IPFV_REC, ASPECT:IPFV	Ye' a̠ ìö bö' ua̠ ul  ulul uli wiè
Bribri0807	Ye' a̠mì̠ tö bö̀wö duké wö'ik	TYPE:NEG, TENSE:IPFV_REC, ASPECT:IPFV	Ye' a̠ ìö bö' ua̠ ul  ulul uli wiè
Bribri0808	Ye' a̠mì̠ tö bö̀wö duké wö'ik	TENSE:IPFV_PROG, ASPECT:IPFV	Ye' a̠ ìö bö' ua̠ ul  ulul uli wiè
Bribri0809	Ye' a̠mì̠ tö bö̀wö duké wö'ik	TYPE:NEG, TENSE:IPFV_PROG, ASPECT:IPFV	Ye' a̠ ìö bö' ua̠ ul  ulul uli wiè
Bribri0810	Ye' a̠mì̠ tö bö̀wö duké wö'ik	TENSE:PRF_PROG	Ye' bák ìö́ uö́k
Bribri0811	Ye' a̠mì̠ tö bö̀wö duké wö'ik	TYPE:NEG, TENSE:PRF_PROG	Ye' a̠ ìö bö' ua̠ ul  ulul uli wiè
Bribri0812	Ye' a̠mì̠ tö bö̀wö duké wö'ik	MODE:IMP, TENSE:IPFV_REC, ASPECT:IPFV	Ye' a̠ ìö bö' ua̠ ul  ulul uli wiè
Bribri0813	Ye' a̠mì̠ tö bö̀wö duké wö'ik	TYPE:NEG, MODE:IMP, TENSE:IPFV_REC, ASPECT:IPFV	Ye' a̠ ìö bö' ua̠ ul  ulul uli wiè
Bribri0814	Ye' a̠mì̠ tö bö̀wö duké wö'ik	TYPE:NEG, MODE:IMP, TENSE:IPFV_REC, ASPECT:IPFV, VOICE:MID	Ye' a̠ ìö bö' ua̠ ul  ulul uli wiè
Bribri0815	Ye' a̠mì̠ tö bö̀wö duké wö'ik	MODE:EXH, TENSE:IPFV_REC, ASPECT:IPFV, PERSON:1_PL_INC	Ye' a̠ ìö bö' ua̠ ul  ulul uli wiè
Bribri0816	Ye' a̠mì̠ tö bö̀wö duké wö'ik	MODE:DES, TENSE:IPFV_REC, ASPECT:IPFV	Ye' a̠ ìö bö' ua̠ ul  ulul uli wiè
Bribri0817	Ye' a̠mì̠ tö bö̀wö duké wö'ik	TYPE:NEG, MODE:DES, TENSE:IPFV_REC, ASPECT:IPFV	Ye' a̠ ìö bö' ua̠ ul  ulul uli wiè
Bribri0818	Ye' a̠mì̠ tö bö̀wö duké wö'ik	MODE:ADVERS	Ye' a̠ ì̠ ta' ua' ua' ua' ta̠
Bribri0819	Ye' a̠mì̠ tö bö̀wö duké wö'ik	TENSE:IPFV_HAB, ASPECT:IPFV	Ye' a̠ ìö bö' ua̠ ul  ulul uli wiè
Bribri0820	Ye' a̠mì̠ tö bö̀wö duké wö'ik	TYPE:NEG, TENSE:IPFV_HAB, ASPECT:IPFV	Ye' a̠ ìö bö' ua̠ ul  ulul uli wiè
Bribri0821	Ye' a̠mì̠ tö bö̀wö duké wö'ik	TENSE:FUT_POT, ASPECT:IPFV	Ye' a̠ ìö bö' ua̠ ul  ulul uli wiè
Bribri0822	Ye' a̠mì̠ tö bö̀wö duké wö'ik	TYPE:NEG, TENSE:FUT_POT, ASPECT:IPFV	Ye' a̠ ìö bö' ua̠ ul  ulul uli wiè
Bribri0823	Ye' a̠mì̠ tö bö̀wö duké wö'ik	TENSE:FUT_CER, ASPECT:IPFV	Ye' a̠ ìö bö' ua̠ ul  ulul uli wiè
Bribri0824	Ye' a̠mì̠ tö bö̀wö duké wö'ik	TYPE:NEG, TENSE:FUT_CER, ASPECT:IPFV	Ye' a̠ ìö bö' ua̠ ul  ulul uli wiè
Bribri0825	Ye' a̠mì̠ tö bö̀wö duké wö'ik	VOICE:MID	Sa'tak kö̀ne̠
Bribri0826	Ye' a̠mì̠ tö bö̀wö duké wö'ik	TYPE:NEG, VOICE:MID	Ye' a̠ ìö bö' ua̠ ul  ulul uli wiè
Bribri0827	Ye' a̠mì̠ tö bö̀wö duké wö'ik	TENSE:PRF_REC, VOICE:MID	Ye' a̠ ìö bö' ua̠ ul  ulul uli wiè
Bribri0828	Ye' a̠mì̠ tö bö̀wö duké wö'ik	TYPE:NEG, TENSE:PRF_REC, VOICE:MID	Ye' a̠ ìö bö' ua̠ ul  ulul uli wiè
Bribri0829	Ye' a̠mì̠ tö bö̀wö duké wö'ik	TENSE:IPFV_REC, ASPECT:IPFV, VOICE:MID	Ye' a̠ ìö bö' ua̠ ul  ulul uli wiè
Bribri0830	Ye' a̠mì̠ tö bö̀wö duké wö'ik	TYPE:NEG, TENSE:IPFV_REC, ASPECT:IPFV, VOICE:MID	Ye' a̠ ìö bö' ua̠ ul  ulul uli wiè
Bribri0831	Ye' a̠mì̠ tö bö̀wö duké wö'ik	TENSE:IPFV_HAB, ASPECT:IPFV, VOICE:MID	Ye' a̠ ìö bö' ua̠ ul  ulul uli wiè
Bribri0832	Ye' a̠mì̠ tö bö̀wö duké wö'ik	TYPE:NEG, TENSE:IPFV_HAB, ASPECT:IPFV, VOICE:MID	Ye' a̠ ìö bö' ua̠ ul  ulul uli wiè
Bribri0833	Ye' a̠mì̠ tö bö̀wö duké wö'ik	TENSE:FUT_POT, ASPECT:IPFV, VOICE:MID	Ye' a̠ ìö bö' ua̠ ul  ulul uli wiè
Bribri0834	Ye' a̠mì̠ tö bö̀wö duké wö'ik	TYPE:NEG, TENSE:FUT_POT, ASPECT:IPFV, VOICE:MID	Ye' a̠ ìö bö' ua̠ ul  ulul uli wiè
Bribri0835	Ye' a̠mì̠ tö bö̀wö duké wö'ik	TENSE:FUT_CER, ASPECT:IPFV, VOICE:MID	Ye' a̠ ìö bö' ua̠ ul  ulul uli wiè
Bribri0836	Ye' a̠mì̠ tö bö̀wö duké wö'ik	TYPE:NEG, TENSE:FUT_CER, ASPECT:IPFV, VOICE:MID	Ye' a̠ ìö bö' ua̠ ul  ulul uli wiè
Bribri0837	Ye' a̠mì̠ tö bö̀wö duké wö'ik	TENSE:PAS_PLU	Ye' a̠wa̠ ìö bö́ ulé́lé́le
Bribri0838	Ye' a̠mì̠ tö bö̀wö duké wö'ik	TYPE:NEG, TENSE:PAS_PLU	Ye' a̠ ìö bö' ua̠ ul  ulul uli wiè
Bribri0839	Ye' a̠mì̠ tö bö̀wö duké wö'ik	MODE:POT, TENSE:IPFV_REC, ASPECT:IPFV	Ye' a̠ ìö bö' ua̠ ul  ulul uli wiè
Bribri0840	Ye' a̠mì̠ tö bö̀wö duké wö'ik	TYPE:NEG, MODE:POT, TENSE:IPFV_REC, ASPECT:IPFV	Ye' a̠ ìö bö' ua̠ ul  ulul uli wiè
Bribri0855	Mó̠köl ar ka̠nò̠ a̠	TYPE:NEG	Kë̀ ke' öe ku̠ ku̠ ku̠
Bribri0856	Mó̠köl ar ka̠nò̠ a̠	TENSE:PRF_REM, ASPECT:PFV	Mó̠kö  rr ki̠'ta̠
Bribri0857	Mó̠köl ar ka̠nò̠ a̠	TYPE:NEG, TENSE:PRF_REM, ASPECT:PFV	Mó̠kö  rr ki̠'ta̠
Bribri0858	Mó̠köl ar ka̠nò̠ a̠	ABSNUM:PL	Mó̠kë' ts̠ òië'ule
Bribri0859	Mó̠köl ar ka̠nò̠ a̠	TYPE:NEG, ABSNUM:PL	Mó̠kö  rr ki̠'ta̠
Bribri0860	Mó̠köl ar ka̠nò̠ a̠	TENSE:PRF_REM, ASPECT:PFV, ABSNUM:PL	Mó̠kö  rr ki̠'ta̠
Bribri0861	Mó̠köl ar ka̠nò̠ a̠	TYPE:NEG, TENSE:PRF_REM, ASPECT:PFV, ABSNUM:PL	Mó̠kö  rr ki̠'ta̠
Bribri0876	Si̠ni̠' tër í̠s ki̠	TYPE:NEG	Kë̀ ne' ië' tsr íë̀ne̠
Bribri0877	Si̠ni̠' tër í̠s ki̠	TENSE:PRF_REM, ASPECT:PFV	Si̠ni̠' tsr íièmi̠
Bribri0878	Si̠ni̠' tër í̠s ki̠	TYPE:NEG, TENSE:PRF_REM, ASPECT:PFV	Si̠ni̠' tsr íièmi̠
Bribri0879	Si̠ni̠' tër í̠s ki̠	ABSNUM:PL	Sa̠ i̠' të' íë'te̠n íi
Bribri0880	Si̠ni̠' tër í̠s ki̠	TYPE:NEG, ABSNUM:PL	Si̠ni̠' tsr íièmi̠
Bribri0881	Si̠ni̠' tër í̠s ki̠	TENSE:PRF_REM, ASPECT:PFV, ABSNUM:PL	Si̠ni̠' tsr íièmi̠
Bribri0882	Si̠ni̠' tër í̠s ki̠	TYPE:NEG, TENSE:PRF_REM, ASPECT:PFV, ABSNUM:PL	Si̠ni̠' tsr íièmi̠
Bribri0418	I dé	ABSNUM:PL, PERSON:3_PL	I dé
Bribri0419	I dé	TENSE:PRF_REM	Y da̠'bak é̠ne̠
Bribri0420	I dé	TENSE:IPFV_PROG, ASPECT:IPFV	I dé
Bribri0421	I dé	TYPE:NEG, TENSE:IPFV_PROG, ASPECT:IPFV	I dé
Bribri0422	I dé	TENSE:PRF_PROG	I daká'bak éö́k
Bribri0423	I dé	TYPE:NEG, TENSE:PRF_PROG	I dé
Bribri0289	I̠nú̠köl ta̠'	TENSE:PRF_REC, ASPECT:PFV	I̠nú̠ ö̀ tso tö́k
Bribri0290	I̠nú̠köl ta̠'	TENSE:PRF_REM, ASPECT:PFV	I̠nú̠ ö̀ tso tö́k
