ID	Source	Change	Target
ID	Source	Change	Ye' kë̀ wa̠ àrros ali' ù̠ i' a̠
Bribri0561	Ye' tö àrros ali' ù̠ i' a̠	TYPE:NEG	Ye' tö àrros ali' ù̠ i' a̠
Bribri0562	Ye' tö àrros ali' ù̠ i' a̠	ASPECT:INC	Ye' tö àrros ali' ù̠ i' a̠
Bribri0563	Ye' tö àrros ali' ù̠ i' a̠	TENSE:PRF_REC	Ye' tö àrros ali' ù̠ i' a̠
Bribri0564	Ye' tö àrros ali' ù̠ i' a̠	TYPE:NEG, TENSE:PRF_REC	Ye' tö àrros ali' ù̠ i' a̠
Bribri0565	Ye' tö àrros ali' ù̠ i' a̠	TENSE:PRF_REC, ASPECT:INC	Ye' tö àrros ali' ù̠ i' a̠
Bribri0566	Ye' tö àrros ali' ù̠ i' a̠	TENSE:IPFV_REC, ASPECT:IPFV	Ye' tö àrros ali' ù̠ i' a̠
Bribri0567	Ye' tö àrros ali' ù̠ i' a̠	TYPE:NEG, TENSE:IPFV_REC, ASPECT:IPFV	Ye' tö àrros ali' ù̠ i' a̠
Bribri0568	Ye' tö àrros ali' ù̠ i' a̠	TENSE:IPFV_PROG, ASPECT:IPFV	Ye' tö àrros ali' ù̠ i' a̠
Bribri0569	Ye' tö àrros ali' ù̠ i' a̠	TYPE:NEG, TENSE:IPFV_PROG, ASPECT:IPFV	Ye' bák àrros ali' a̠ i' bák i u̠' i̠' a̠ i' bák i̠ i' bák i̠ i' bák i̠ i' bák i' a̠
Bribri0570	Ye' tö àrros ali' ù̠ i' a̠	TENSE:PRF_PROG	Ye' tö àrros ali' ù̠ i' a̠
Bribri0571	Ye' tö àrros ali' ù̠ i' a̠	TYPE:NEG, TENSE:PRF_PROG	Ye' tö àrros ali' ù̠ i' a̠
Bribri0572	Ye' tö àrros ali' ù̠ i' a̠	MODE:IMP, TENSE:IPFV_REC, ASPECT:IPFV, PERSON:NA	Ye' tö àrros ali' ù̠ i' a̠
Bribri0573	Ye' tö àrros ali' ù̠ i' a̠	TYPE:NEG, MODE:IMP, TENSE:IPFV_REC, ASPECT:IPFV, PERSON:NA	Ye' tö àrros ali' ù̠ i' a̠
Bribri0574	Ye' tö àrros ali' ù̠ i' a̠	TYPE:NEG, MODE:IMP, TENSE:IPFV_REC, ASPECT:IPFV, VOICE:MID, PERSON:NA	Ye' tö àrros ali' ù̠ i' a̠
Bribri0575	Ye' tö àrros ali' ù̠ i' a̠	MODE:EXH, TENSE:IPFV_REC, ASPECT:IPFV, PERSON:1_PL_INC	Ye' tö àrros ali' ù̠ i' a̠
Bribri0576	Ye' tö àrros ali' ù̠ i' a̠	MODE:DES, TENSE:IPFV_REC, ASPECT:IPFV	Ye' tö àrros ali' ù̠ i' a̠
Bribri0577	Ye' tö àrros ali' ù̠ i' a̠	TYPE:NEG, MODE:DES, TENSE:IPFV_REC, ASPECT:IPFV	Ye' wa̠ àrros ali' a̠ i' a̠
Bribri0578	Ye' tö àrros ali' ù̠ i' a̠	MODE:ADVERS	Ye' tö àrros ali' ù̠ i' a̠
Bribri0579	Ye' tö àrros ali' ù̠ i' a̠	TENSE:IPFV_HAB, ASPECT:IPFV	Ye' tö àrros ali' ù̠ i' a̠
Bribri0580	Ye' tö àrros ali' ù̠ i' a̠	TYPE:NEG, TENSE:IPFV_HAB, ASPECT:IPFV	Ye' tö àrros ali' ù̠ i' a̠
Bribri0581	Ye' tö àrros ali' ù̠ i' a̠	TENSE:FUT_POT, ASPECT:IPFV	Ye' tö àrros ali' ù̠ i' a̠
Bribri0582	Ye' tö àrros ali' ù̠ i' a̠	TYPE:NEG, TENSE:FUT_POT, ASPECT:IPFV	Ye' tö àrros ali' ù̠ i' a̠
Bribri0583	Ye' tö àrros ali' ù̠ i' a̠	TENSE:FUT_CER, ASPECT:IPFV	Ye' tö àrros ali' ù̠ i' a̠
Bribri0584	Ye' tö àrros ali' ù̠ i' a̠	TYPE:NEG, TENSE:FUT_CER, ASPECT:IPFV	Ye' tö àrros ali' ù̠ i' a̠
Bribri0585	Ye' tö àrros ali' ù̠ i' a̠	VOICE:MID, PERSON:NA	Ye' tö àrros ali' ù̠ i' a̠
Bribri0586	Ye' tö àrros ali' ù̠ i' a̠	TYPE:NEG, VOICE:MID, PERSON:NA	Ye' tö àrros ali' ù̠ i' a̠
Bribri0587	Ye' tö àrros ali' ù̠ i' a̠	TENSE:PRF_REC, VOICE:MID, PERSON:NA	Ye' tö àrros ali' ù̠ i' a̠
Bribri0588	Ye' tö àrros ali' ù̠ i' a̠	TYPE:NEG, TENSE:PRF_REC, VOICE:MID, PERSON:NA	Ye' tö àrros ali' ù̠ i' a̠
Bribri0589	Ye' tö àrros ali' ù̠ i' a̠	TENSE:IPFV_REC, ASPECT:IPFV, VOICE:MID, PERSON:NA	Ye' tö àrros ali' ù̠ i' a̠
Bribri0590	Ye' tö àrros ali' ù̠ i' a̠	TYPE:NEG, TENSE:IPFV_REC, ASPECT:IPFV, VOICE:MID, PERSON:NA	Ye' tö àrros ali' ù̠ i' a̠
Bribri0591	Ye' tö àrros ali' ù̠ i' a̠	TENSE:IPFV_HAB, ASPECT:IPFV, VOICE:MID, PERSON:NA	Ye' tö àrros ali' ù̠ i' a̠
Bribri0592	Ye' tö àrros ali' ù̠ i' a̠	TYPE:NEG, TENSE:IPFV_HAB, ASPECT:IPFV, VOICE:MID, PERSON:NA	Ye' tö àrros ali' ù̠ i' a̠
Bribri0593	Ye' tö àrros ali' ù̠ i' a̠	TENSE:FUT_POT, ASPECT:IPFV, VOICE:MID, PERSON:NA	Ye' tö àrros ali' ù̠ i' a̠
Bribri0594	Ye' tö àrros ali' ù̠ i' a̠	TYPE:NEG, TENSE:FUT_POT, ASPECT:IPFV, VOICE:MID, PERSON:NA	Ye' tö àrros ali' ù̠ i' a̠
Bribri0595	Ye' tö àrros ali' ù̠ i' a̠	TENSE:FUT_CER, ASPECT:IPFV, VOICE:MID, PERSON:NA	Ye' tö àrros ali' ù̠ i' a̠
Bribri0596	Ye' tö àrros ali' ù̠ i' a̠	TYPE:NEG, TENSE:FUT_CER, ASPECT:IPFV, VOICE:MID, PERSON:NA	Ye' tö àrros ali' ù̠ i' a̠
Bribri0597	Ye' tö àrros ali' ù̠ i' a̠	TENSE:PAS_PLU	Ye' tö àrros ali' ù̠ i' a̠
Bribri0598	Ye' tö àrros ali' ù̠ i' a̠	TYPE:NEG, TENSE:PAS_PLU	Ye' tö àrros ali' ù̠ i' a̠
Bribri0599	Ye' tö àrros ali' ù̠ i' a̠	MODE:POT, TENSE:IPFV_REC, ASPECT:IPFV	Ye' tö àrros ali' ù̠ i' a̠
Bribri0600	Ye' tö àrros ali' ù̠ i' a̠	TYPE:NEG, MODE:POT, TENSE:IPFV_REC, ASPECT:IPFV	I kiö́
Bribri0416	I kiö́	ABSNUM:PL	I tso'
Bribri0417	I tso'	ABSNUM:PL, PERSON:3_PL	Ma̠rir dör kápi u̠
Bribri0721	Maria dör kápi u'	TYPE:NEG	Mariira dör kápi u'mi̠ u'mi̠
Bribri0722	Maria dör kápi u'	ASPECT:INC	Mariir dör kápi u'
Bribri0723	Maria dör kápi u'	TENSE:PRF_REC	Mariira dör kápi u'
Bribri0724	Maria dör kápi u'	TYPE:NEG, TENSE:PRF_REC	Mariira dör kápi u'
Bribri0725	Maria dör kápi u'	TENSE:PRF_REC, ASPECT:INC	Mariira dör kápi u'
Bribri0726	Maria dör kápi u'	TENSE:IPFV_REC, ASPECT:IPFV	Mariira dör kápi u'
Bribri0727	Maria dör kápi u'	TYPE:NEG, TENSE:IPFV_REC, ASPECT:IPFV	Mariira dör kápi u'
Bribri0728	Maria dör kápi u'	TENSE:IPFV_PROG, ASPECT:IPFV	Mariira dör kápi u'
Bribri0729	Maria dör kápi u'	TYPE:NEG, TENSE:IPFV_PROG, ASPECT:IPFV	Marri a̠ káki ulpa
Bribri0730	Maria dör kápi u'	TENSE:PRF_PROG	Mariira dör kápi u'
Bribri0731	Maria dör kápi u'	TYPE:NEG, TENSE:PRF_PROG	Mariira dör kápi u'
Bribri0732	Maria dör kápi u'	MODE:IMP, TENSE:IPFV_REC, ASPECT:IPFV	Mariira dör kápi u'
Bribri0733	Maria dör kápi u'	TYPE:NEG, MODE:IMP, TENSE:IPFV_REC, ASPECT:IPFV	Mariira dör kápi u'
Bribri0734	Maria dör kápi u'	TYPE:NEG, MODE:IMP, TENSE:IPFV_REC, ASPECT:IPFV, VOICE:MID	Mariira dör kápi u'
Bribri0735	Maria dör kápi u'	MODE:EXH, TENSE:IPFV_REC, ASPECT:IPFV, PERSON:1_PL_INC	Mariira dör kápi u'
Bribri0736	Maria dör kápi u'	MODE:DES, TENSE:IPFV_REC, ASPECT:IPFV	Mariira dör kápi u'
Bribri0737	Maria dör kápi u'	TYPE:NEG, MODE:DES, TENSE:IPFV_REC, ASPECT:IPFV	Marria dör kápi u'
Bribri0738	Maria dör kápi u'	MODE:ADVERS	Mariira dör kápi u'
Bribri0739	Maria dör kápi u'	TENSE:IPFV_HAB, ASPECT:IPFV	Mariira dör kápi u'
Bribri0740	Maria dör kápi u'	TYPE:NEG, TENSE:IPFV_HAB, ASPECT:IPFV	Mariira dör kápi u'
Bribri0741	Maria dör kápi u'	TENSE:FUT_POT, ASPECT:IPFV	Mariira dör kápi u'
Bribri0742	Maria dör kápi u'	TYPE:NEG, TENSE:FUT_POT, ASPECT:IPFV	Mariira dör kápi u'
Bribri0743	Maria dör kápi u'	TENSE:FUT_CER, ASPECT:IPFV	Mariira dör kápi u'
Bribri0744	Maria dör kápi u'	TYPE:NEG, TENSE:FUT_CER, ASPECT:IPFV	Marri a̠ kápi ulàne̠
Bribri0745	Maria dör kápi u'	VOICE:MID	Mariira dör kápi u'
Bribri0746	Maria dör kápi u'	TYPE:NEG, VOICE:MID	Mariira dör kápi u'
Bribri0747	Maria dör kápi u'	TENSE:PRF_REC, VOICE:MID	Mariira dör kápi u'
Bribri0748	Maria dör kápi u'	TYPE:NEG, TENSE:PRF_REC, VOICE:MID	Mariira dör kápi u'
Bribri0749	Maria dör kápi u'	TENSE:IPFV_REC, ASPECT:IPFV, VOICE:MID	Mariira dör kápi u'
Bribri0750	Maria dör kápi u'	TYPE:NEG, TENSE:IPFV_REC, ASPECT:IPFV, VOICE:MID	Mariira dör kápi u'
Bribri0751	Maria dör kápi u'	TENSE:IPFV_HAB, ASPECT:IPFV, VOICE:MID	Mariira dör kápi u'
Bribri0752	Maria dör kápi u'	TYPE:NEG, TENSE:IPFV_HAB, ASPECT:IPFV, VOICE:MID	Mariira dör kápi u'
Bribri0753	Maria dör kápi u'	TENSE:FUT_POT, ASPECT:IPFV, VOICE:MID	Mariira dör kápi u'
Bribri0754	Maria dör kápi u'	TYPE:NEG, TENSE:FUT_POT, ASPECT:IPFV, VOICE:MID	Mariira dör kápi u'
Bribri0755	Maria dör kápi u'	TENSE:FUT_CER, ASPECT:IPFV, VOICE:MID	Mariira dör kápi u'
Bribri0756	Maria dör kápi u'	TYPE:NEG, TENSE:FUT_CER, ASPECT:IPFV, VOICE:MID	Marria dör kápi u'rule u'
Bribri0757	Maria dör kápi u'	TENSE:PAS_PLU	Mariira dör kápi u'
Bribri0758	Maria dör kápi u'	TYPE:NEG, TENSE:PAS_PLU	Mariira dör kápi u'
Bribri0759	Maria dör kápi u'	MODE:POT, TENSE:IPFV_REC, ASPECT:IPFV	Mariira dör kápi u'
Bribri0760	Maria dör kápi u'	TYPE:NEG, MODE:POT, TENSE:IPFV_REC, ASPECT:IPFV	Ye' ka̠nè̠balë'
Bribri0336	Ye' ka̠nè̠balë'	TENSE:IPFV_REC, ASPECT:IPFV, VOICE:MID, ABSNUM:NI, PERSON:NA	Ye' ka̠nè̠balë'
Bribri0337	Ye' ka̠nè̠balë'	TYPE:NEG, TENSE:IPFV_REC, ASPECT:IPFV, VOICE:MID, ABSNUM:NI, PERSON:NA	Ye' kë̀ wa̠ i yë́ne̠ yë́ne̠
Bribri0932	Ye' tö i yë́	TYPE:NEG	Ye' tö i yë́
Bribri0933	Ye' tö i yë́	PERSON:2_SI	Ye' tö i yë́
Bribri0934	Ye' tö i yë́	TYPE:NEG, PERSON:2_SI	Ie' tö i yë́
Bribri0935	Ye' tö i yë́	PERSON:3_SI	Ye' tö i yë́
Bribri0936	Ye' tö i yë́	TYPE:NEG, PERSON:3_SI	Ie'pa tö i yë́
Bribri0937	Ye' tö i yë́	PERSON:1_PL_EXC	Ye' tö i yë́
Bribri0938	Ye' tö i yë́	TYPE:NEG, PERSON:1_PL_EXC	I yë́r
Bribri0939	Ye' tö i yë́	PERSON:1_PL_INC	Ye' tö i yë́
Bribri0940	Ye' tö i yë́	TYPE:NEG, PERSON:1_PL_INC	Ye' tö i yë́
Bribri0941	Ye' tö i yë́	PERSON:2_PL	Ye' tö i yë́
Bribri0942	Ye' tö i yë́	TYPE:NEG, PERSON:2_PL	Ie'pa tö i yë́
Bribri0943	Ye' tö i yë́	PERSON:3_PL	Ye' tö i yë́
Bribri0944	Ye' tö i yë́	TYPE:NEG, PERSON:3_PL	Ye' tö i yé́
Bribri0945	Ye' tö i yë́	TENSE:PRF_REC	Ye' tö i yë́
Bribri0946	Ye' tö i yë́	TENSE:IPFV_REC, ASPECT:IPFV	Ye' tö i yë́
Bribri0947	Ye' tö i yë́	TENSE:IPFV_PROG, ASPECT:IPFV	Ye' tö i yë́
Bribri0948	Ye' tö i yë́	TYPE:NEG, TENSE:IPFV_PROG, ASPECT:IPFV	Ye' bák i yö́k
Bribri0949	Ye' tö i yë́	TENSE:PRF_PROG	Ye' tö i yë́
Bribri0950	Ye' tö i yë́	TYPE:NEG, TENSE:PRF_PROG	Ye' tö i yë́
Bribri0951	Ye' tö i yë́	MODE:IMP, TENSE:IPFV_REC, ASPECT:IPFV, PERSON:NA	Ye' tö i yë́
Bribri0952	Ye' tö i yë́	TENSE:FUT_POT, ASPECT:IPFV	Ye' tö i yë́
Bribri0953	Ye' tö i yë́	TENSE:IPFV_HAB, ASPECT:IPFV	Ye' tö i yë́
Bribri0954	Ye' tö i yë́	VOICE:MID, ABSNUM:NI, PERSON:NA	Ye' tö i yë́
Bribri0955	Ye' tö i yë́	TYPE:NEG, VOICE:MID, ABSNUM:NI, PERSON:NA	Ye' tö i yë́
Bribri0956	Ye' tö i yë́	TENSE:IPFV_REC, ASPECT:IPFV, VOICE:MID, ABSNUM:NI, PERSON:NA	Ye' tö shkami̠' yö'mi̠
Bribri0424	Ye' tö shkame̠' yö'	ASPECT:INC	Ye' kë̀ shka̠me̠' yö̀ne̠' yö'k
Bribri0425	Ye' tö shkame̠' yö'	TYPE:NEG	Ye' tö shkame̠' yö'
Bribri0426	Ye' tö shkame̠' yö'	TENSE:PRF_REC	Ye' tö shkami̠' yö'
Bribri0427	Ye' tö shkame̠' yö'	TENSE:PRF_REC, ASPECT:INC	Ye' tö shkami̠' yö'
Bribri0428	Ye' tö shkame̠' yö'	TYPE:NEG, TENSE:PRF_REC	Ye' tö shkami̠' yö'
Bribri0429	Ye' tö shkame̠' yö'	TENSE:IPFV_REC, ASPECT:IPFV	Ye' tö shkami̠' yö'
Bribri0430	Ye' tö shkame̠' yö'	TYPE:NEG, TENSE:IPFV_REC, ASPECT:IPFV	Ye' tö shkami̠' yö'
Bribri0431	Ye' tö shkame̠' yö'	MODE:POT, TENSE:IPFV_REC, ASPECT:IPFV	Ye' tö shkami̠' yö'
Bribri0432	Ye' tö shkame̠' yö'	TYPE:NEG, MODE:POT, TENSE:IPFV_REC, ASPECT:IPFV	Ye' tö shkami̠' yö'
Bribri0433	Ye' tö shkame̠' yö'	TENSE:IPFV_PROG, ASPECT:IPFV	Ye' tö shkami̠' yö'
Bribri0434	Ye' tö shkame̠' yö'	TYPE:NEG, TENSE:IPFV_PROG, ASPECT:IPFV	Ye' bák shka̠me̠' bö́k
Bribri0435	Ye' tö shkame̠' yö'	TENSE:PRF_PROG	Ye' tö shkami̠' yö'
Bribri0436	Ye' tö shkame̠' yö'	TYPE:NEG, TENSE:PRF_PROG	Ye' tö shkami̠' yö'
Bribri0437	Ye' tö shkame̠' yö'	MODE:IMP, TENSE:IPFV_REC, ASPECT:IPFV, PERSON:NA	Ye' tö shkami̠' yö'
Bribri0438	Ye' tö shkame̠' yö'	TYPE:NEG, MODE:IMP, TENSE:IPFV_REC, ASPECT:IPFV, PERSON:NA	Ye' tö shkami̠' yö'
Bribri0439	Ye' tö shkame̠' yö'	TYPE:NEG, MODE:IMP, TENSE:IPFV_REC, ASPECT:IPFV, VOICE:MID, PERSON:NA	Ye' tö shkami̠' yö'
Bribri0440	Ye' tö shkame̠' yö'	MODE:EXH, TENSE:IPFV_REC, ASPECT:IPFV, PERSON:1_PL_INC	Ye' tö shkami̠' yö'
Bribri0441	Ye' tö shkame̠' yö'	MODE:DES, TENSE:IPFV_REC, ASPECT:IPFV	Ye' tö shkami̠' yö'
Bribri0442	Ye' tö shkame̠' yö'	TYPE:NEG, MODE:DES, TENSE:IPFV_REC, ASPECT:IPFV	Ye' tö shka̠me̠' yua'
Bribri0443	Ye' tö shkame̠' yö'	MODE:ADVERS	Ye' tö shkami̠' yö'
Bribri0444	Ye' tö shkame̠' yö'	TENSE:IPFV_HAB, ASPECT:IPFV	Ye' tö shkami̠' yö'
Bribri0445	Ye' tö shkame̠' yö'	TYPE:NEG, TENSE:IPFV_HAB, ASPECT:IPFV	Ye' tö shkami̠' yö'
Bribri0446	Ye' tö shkame̠' yö'	TENSE:FUT_POT, ASPECT:IPFV	Ye' tö shkami̠' yö'
Bribri0447	Ye' tö shkame̠' yö'	TYPE:NEG, TENSE:FUT_POT, ASPECT:IPFV	Ye' tö shkami̠' yö'
Bribri0448	Ye' tö shkame̠' yö'	TENSE:FUT_CER, ASPECT:IPFV	Ye' tö shkami̠' yö'
Bribri0449	Ye' tö shkame̠' yö'	TYPE:NEG, TENSE:FUT_CER, ASPECT:IPFV	Ye' tö shkami̠' yö'
Bribri0450	Ye' tö shkame̠' yö'	VOICE:MID, PERSON:NA	Ye' tö shkami̠' yö'
Bribri0451	Ye' tö shkame̠' yö'	TYPE:NEG, VOICE:MID, PERSON:NA	Ye' tö shkami̠' yö'
Bribri0452	Ye' tö shkame̠' yö'	TENSE:PRF_REC, VOICE:MID, PERSON:NA	Ye' tö shkami̠' yö'
Bribri0453	Ye' tö shkame̠' yö'	TYPE:NEG, TENSE:PRF_REC, VOICE:MID, PERSON:NA	Ye' tö shkami̠' yö'
Bribri0454	Ye' tö shkame̠' yö'	TENSE:IPFV_REC, ASPECT:IPFV, VOICE:MID, PERSON:NA	Ye' tö shkami̠' yö'
Bribri0455	Ye' tö shkame̠' yö'	TYPE:NEG, TENSE:IPFV_REC, ASPECT:IPFV, VOICE:MID, PERSON:NA	Ye' tö shkami̠' yö'
Bribri0456	Ye' tö shkame̠' yö'	TENSE:IPFV_HAB, ASPECT:IPFV, VOICE:MID, PERSON:NA	Ye' tö shkami̠' yö'
Bribri0457	Ye' tö shkame̠' yö'	TYPE:NEG, TENSE:IPFV_HAB, ASPECT:IPFV, VOICE:MID, PERSON:NA	Ye' tö shkami̠' yö'
Bribri0458	Ye' tö shkame̠' yö'	TENSE:FUT_POT, ASPECT:IPFV, VOICE:MID, PERSON:NA	Ye' tö shkami̠' yö'
Bribri0459	Ye' tö shkame̠' yö'	TYPE:NEG, TENSE:FUT_POT, ASPECT:IPFV, VOICE:MID, PERSON:NA	Ye' tö shkami̠' yö'
Bribri0460	Ye' tö shkame̠' yö'	TENSE:FUT_CER, ASPECT:IPFV, VOICE:MID, PERSON:NA	Ye' tö shkami̠' yö'
Bribri0461	Ye' tö shkame̠' yö'	TYPE:NEG, TENSE:FUT_CER, ASPECT:IPFV, VOICE:MID, PERSON:NA	Ye' tö shkami̠' yö'
Bribri0462	Ye' tö shkame̠' yö'	TENSE:PAS_PLU, VOICE:MID	Ye' tö shkami̠' yö'
Bribri0463	Ye' tö shkame̠' yö'	TYPE:NEG, TENSE:PAS_PLU, VOICE:MID	Ye' kë̀ wa̠ kápi ya'
Bribri0253	Ye' tö kápi ya'	TYPE:NEG	Ye' tö kápi ya'
Bribri0254	Ye' tö kápi ya'	TENSE:IPFV_PROG, ASPECT:IPFV	Ye' tö kápi ya'
Bribri0255	Ye' tö kápi ya'	TYPE:NEG, TENSE:IPFV_PROG, ASPECT:IPFV	Ye' bák ká̠ i ya'
Bribri0256	Ye' tö kápi ya'	TENSE:PRF_PROG	Ye' tö kápi ya'
Bribri0257	Ye' tö kápi ya'	TYPE:NEG, TENSE:PRF_PROG	Ye' tö kápi yé
Bribri0258	Ye' tö kápi ya'	TENSE:PRF_REC	Ye' tö kápi ya'
Bribri0259	Ye' tö kápi ya'	TYPE:NEG, TENSE:PRF_REC	Ye' tö kápi ya'
Bribri0260	Ye' tö kápi ya'	TENSE:IPFV_REC, ASPECT:IPFV	Ye' tö kápi ya'
Bribri0261	Ye' tö kápi ya'	TYPE:NEG, TENSE:IPFV_REC, ASPECT:IPFV	Ye' tö kápi ya'
Bribri0262	Ye' tö kápi ya'	TENSE:IPFV_HAB, ASPECT:IPFV	Ye' tö kápi ya'
Bribri0263	Ye' tö kápi ya'	TYPE:NEG, TENSE:IPFV_HAB, ASPECT:IPFV	Ye' tö kápi ya'
Bribri0264	Ye' tö kápi ya'	TENSE:FUT_CER, ASPECT:IPFV	Ye' tö kápi ya'
Bribri0265	Ye' tö kápi ya'	TYPE:NEG, TENSE:FUT_CER, ASPECT:IPFV	Ye' tö kápi ya'
Bribri0266	Ye' tö kápi ya'	VOICE:MID, PERSON:NA	Ye' tö kápi ya'
Bribri0267	Ye' tö kápi ya'	TYPE:NEG, VOICE:MID, PERSON:NA	Ye' tö kápi ya'
Bribri0268	Ye' tö kápi ya'	TENSE:PRF_REC, VOICE:MID, PERSON:NA	Ye' tö kápi ya'
Bribri0269	Ye' tö kápi ya'	TYPE:NEG, TENSE:PRF_REC, VOICE:MID, PERSON:NA	Ye' tö kápi ya'
Bribri0270	Ye' tö kápi ya'	TENSE:IPFV_REC, ASPECT:IPFV, VOICE:MID, PERSON:NA	Ye' tö kápi ya'
Bribri0271	Ye' tö kápi ya'	TYPE:NEG, TENSE:IPFV_REC, ASPECT:IPFV, VOICE:MID, PERSON:NA	Ye' tö kápi ya'
Bribri0272	Ye' tö kápi ya'	TENSE:IPFV_HAB, ASPECT:IPFV, VOICE:MID, PERSON:NA	Ye' tö kápi ya'
Bribri0273	Ye' tö kápi ya'	TYPE:NEG, TENSE:IPFV_HAB, ASPECT:IPFV, VOICE:MID, PERSON:NA	Ye' tö kápi ya'
Bribri0274	Ye' tö kápi ya'	MODE:IMP, TENSE:IPFV_REC, ASPECT:IPFV, PERSON:NA	Ye' tö kápi ya'
Bribri0275	Ye' tö kápi ya'	TYPE:NEG, MODE:IMP, TENSE:IPFV_REC, ASPECT:IPFV, PERSON:NA	Ye' tö kápi ya'
Bribri0276	Ye' tö kápi ya'	MODE:DES, TENSE:IPFV_REC, ASPECT:IPFV	Ye' tö kápi ya'
Bribri0277	Ye' tö kápi ya'	MODE:DES, TENSE:IPFV_REC, ASPECT:IPFV, VOICE:MID, PERSON:NA	Ye' tö kápi ya'
Bribri0278	Ye' tö kápi ya'	TENSE:FUT_POT, ASPECT:IPFV	Ye' tö kápi ya'
Bribri0279	Ye' tö kápi ya'	TYPE:NEG, TENSE:FUT_POT, ASPECT:IPFV	Ye' tö kápi ya'
Bribri0280	Ye' tö kápi ya'	TENSE:FUT_POT, ASPECT:IPFV, VOICE:MID, PERSON:NA	Ye' tö kápi ya'
Bribri0281	Ye' tö kápi ya'	TYPE:NEG, TENSE:FUT_POT, ASPECT:IPFV, VOICE:MID, PERSON:NA	Ye' tö kápi ya'
Bribri0282	Ye' tö kápi ya'	MODE:ADVERS, VOICE:MID, PERSON:NA	Ye' tö kápi ya'rule
Bribri0283	Ye' tö kápi ya'	TENSE:PAS_PLU	Ye' tö kápi ya'
Bribri0284	Ye' tö kápi ya'	TYPE:NEG, TENSE:PAS_PLU	Ye' kë̀ ku̠ dawö̀ne̠
Bribri0989	Ye' úk	TYPE:NEG	Be' úk
Bribri0990	Ye' úk	PERSON:2_SI	Ye' úkna̠ úk
Bribri0991	Ye' úk	TYPE:NEG, PERSON:2_SI	Ye' úkna̠ úk
Bribri0992	Ye' úk	TENSE:IPFV_REC, ASPECT:IPFV	Ye' úkna̠ úk
Bribri0993	Ye' úk	TENSE:IPFV_PROG, ASPECT:IPFV	Ye' úkna̠ úk
Bribri0994	Ye' úk	TYPE:NEG, TENSE:IPFV_PROG, ASPECT:IPFV	Ye' bák ukö́k
Bribri0995	Ye' úk	TENSE:PRF_PROG	Ye' úkna̠ úk
Bribri0996	Ye' úk	TYPE:NEG, TENSE:PRF_PROG	Ye' úkna̠ úk
Bribri0997	Ye' úk	MODE:IMP, TENSE:IPFV_REC, ASPECT:IPFV, PERSON:2_SI	Ye' úkna̠ úk
Bribri0998	Ye' úk	TENSE:IPFV_HAB, ASPECT:IPFV	Ye' úkna̠ úk
Bribri0999	Ye' úk	VOICE:MID, ABSNUM:NI, PERSON:NA	Ye' úkna̠ úk
Bribri1000	Ye' úk	TYPE:NEG, VOICE:MID, ABSNUM:NI, PERSON:NA	Ye' úkna̠ úk
Bribri1001	Ye' úk	TENSE:IPFV_REC, ASPECT:IPFV, VOICE:MID, ABSNUM:NI, PERSON:NA	Ka̠no̠' te̠n ká̠u̠k kë̀ ká̠u̠k a̠
Bribri0869	Ka̠no̠' te̠n ká̠u̠k a̠	TYPE:NEG	Ka̠no̠' te̠n ta̠n ká̠u̠k a̠
Bribri0870	Ka̠no̠' te̠n ká̠u̠k a̠	TENSE:PRF_REM, ASPECT:PFV	Ka̠no̠' te̠n ta̠n ká̠u̠k a̠
Bribri0871	Ka̠no̠' te̠n ká̠u̠k a̠	TYPE:NEG, TENSE:PRF_REM, ASPECT:PFV	Ka̠no̠' te̠n ká̠u̠k a̠
Bribri0872	Ka̠no̠' te̠n ká̠u̠k a̠	ABSNUM:PL	Ka̠no̠' te̠n ta̠n ká̠u̠k a̠
Bribri0873	Ka̠no̠' te̠n ká̠u̠k a̠	TYPE:NEG, ABSNUM:PL	Ka̠no̠' te̠n ta̠n ká̠u̠k a̠
Bribri0874	Ka̠no̠' te̠n ká̠u̠k a̠	TENSE:PRF_REM, ASPECT:PFV, ABSNUM:PL	Ka̠no̠' te̠n ta̠n ká̠u̠k a̠
Bribri0875	Ka̠no̠' te̠n ká̠u̠k a̠	TYPE:NEG, TENSE:PRF_REM, ASPECT:PFV, ABSNUM:PL	Ie' kë̀ tso bua'ne̠
Bribri0001	Ie' tso bua'	TYPE:NEG	Ie' tso bua'
Bribri0002	Ie' tso bua'	TENSE:PRF_REM, ASPECT:PFV	Ie' tso bua'
Bribri0003	Ie' tso bua'	TYPE:NEG, TENSE:PRF_REM, ASPECT:PFV	Ie' tso bua'
Bribri0004	Ie' tso bua'	PERSON:1_SI	Ie' tso bua'
Bribri0005	Ie' tso bua'	TYPE:NEG, PERSON:1_SI	Ie' tso bua'
Bribri0006	Ie' tso bua'	TENSE:PRF_REM, ASPECT:PFV, PERSON:1_SI	Ie' tso bua'
Bribri0007	Ie' tso bua'	TYPE:NEG, TENSE:PRF_REM, ASPECT:PFV, PERSON:1_SI	Ie' tso bua'
Bribri0008	Ie' tso bua'	PERSON:2_SI	Ie' tso bua'
Bribri0009	Ie' tso bua'	TYPE:NEG, PERSON:2_SI	Ie' tso bua'
Bribri0010	Ie' tso bua'	TENSE:PRF_REM, ASPECT:PFV, PERSON:2_SI	Ie' tso bua'
Bribri0011	Ie' tso bua'	TYPE:NEG, TENSE:PRF_REM, ASPECT:PFV, PERSON:2_SI	Ie' tso bua'
Bribri0012	Ie' tso bua'	ABSNUM:PL, PERSON:1_PL_EXC	Ie' tso bua'
Bribri0013	Ie' tso bua'	TYPE:NEG, ABSNUM:PL, PERSON:1_PL_EXC	Ie' tso bua'
Bribri0014	Ie' tso bua'	TENSE:PRF_REM, ASPECT:PFV, ABSNUM:PL, PERSON:1_PL_EXC	Ie' tso bua'
Bribri0015	Ie' tso bua'	TYPE:NEG, TENSE:PRF_REM, ASPECT:PFV, ABSNUM:PL, PERSON:1_PL_EXC	Ie' tso bua'
Bribri0016	Ie' tso bua'	ABSNUM:PL, PERSON:1_PL_INC	Ie' tso bua'
Bribri0017	Ie' tso bua'	TYPE:NEG, ABSNUM:PL, PERSON:1_PL_INC	Ie' tso bua'
Bribri0018	Ie' tso bua'	TENSE:PRF_REM, ASPECT:PFV, ABSNUM:PL, PERSON:1_PL_INC	Ie' tso bua'
Bribri0019	Ie' tso bua'	TYPE:NEG, TENSE:PRF_REM, ASPECT:PFV, ABSNUM:PL, PERSON:1_PL_INC	Ie' tso bua'
Bribri0020	Ie' tso bua'	ABSNUM:PL, PERSON:2_PL	Ie' tso bua'
Bribri0021	Ie' tso bua'	TYPE:NEG, ABSNUM:PL, PERSON:2_PL	Ie' tso bua'
Bribri0022	Ie' tso bua'	TENSE:PRF_REM, ASPECT:PFV, ABSNUM:PL, PERSON:2_PL	Ie' tso bua'
Bribri0023	Ie' tso bua'	TYPE:NEG, TENSE:PRF_REM, ASPECT:PFV, ABSNUM:PL, PERSON:2_PL	Ie' tso bua'
Bribri0024	Ie' tso bua'	ABSNUM:PL, PERSON:3_PL	Ie' tso bua'
Bribri0025	Ie' tso bua'	TYPE:NEG, ABSNUM:PL, PERSON:3_PL	Ie' tso bua'
Bribri0026	Ie' tso bua'	TENSE:PRF_REM, ASPECT:PFV, ABSNUM:PL, PERSON:3_PL	Ie' tso bua'
Bribri0027	Ie' tso bua'	TYPE:NEG, TENSE:PRF_REM, ASPECT:PFV, ABSNUM:PL, PERSON:3_PL	Ye' tö ujkë̀jkuö à̠ríts
Bribri0464	Ye' tö uyë̀jkuö à̠ríts	TENSE:IPFV_PROG, ASPECT:IPFV, PERSON:3_SI	Ye' tö ujkë̀jkuö à̠ríts
Bribri0465	Ye' tö uyë̀jkuö à̠ríts	TENSE:IPFV_REC, ASPECT:IPFV	Ye' tö ujkë̀jkuö à̠ríts
Bribri0466	Ye' tö uyë̀jkuö à̠ríts	TYPE:NEG, TENSE:IPFV_REC, ASPECT:IPFV	Ye' tö ujkë̀jkuö à̠ríts
Bribri0467	Ye' tö uyë̀jkuö à̠ríts	MODE:POT, TENSE:IPFV_REC, ASPECT:IPFV, PERSON:3_SI	Ye' tö ujkë̀jkuö à̠ríts
Bribri0468	Ye' tö uyë̀jkuö à̠ríts	TYPE:NEG, MODE:POT, TENSE:IPFV_REC, ASPECT:IPFV, PERSON:3_SI	Po'ta tsör
Bribri0388	Chìchi dör tsîr	ABSNUM:PL	Dù kë̀ ku̠ kàl ulà ki̠
Bribri0848	Dù tkër kàl ulà ki̠	TYPE:NEG	Dù tkër kàl ulà ki̠
Bribri0849	Dù tkër kàl ulà ki̠	TENSE:PRF_REM, ASPECT:PFV	Dù tkër kàl ulà ki̠
Bribri0850	Dù tkër kàl ulà ki̠	TYPE:NEG, TENSE:PRF_REM, ASPECT:PFV	Dù tkër kàl ulà ki̠
Bribri0851	Dù tkër kàl ulà ki̠	ABSNUM:PL	Dù tkër kàl ulà ki̠
Bribri0852	Dù tkër kàl ulà ki̠	TYPE:NEG, ABSNUM:PL	Dù tkër kàl ulà ki̠
Bribri0853	Dù tkër kàl ulà ki̠	TENSE:PRF_REM, ASPECT:PFV, ABSNUM:PL	Dù tkër kàl ulà ki̠
Bribri0854	Dù tkër kàl ulà ki̠	TYPE:NEG, TENSE:PRF_REM, ASPECT:PFV, ABSNUM:PL	Ie' i̠ni̠'
Bribri0028	Ye' i̠ni̠'	PERSON:3_SI	Ye' i̠ni̠'
Bribri0029	Ye' i̠ni̠'	PERSON:2_SI	Ye' i̠ni̠'
Bribri0030	Ye' i̠ni̠'	ABSNUM:PL, PERSON:1_PL_EXC	Ye' i̠ni̠'
Bribri0031	Ye' i̠ni̠'	ABSNUM:PL, PERSON:1_PL_INC	Ye' i̠ni̠'
Bribri0032	Ye' i̠ni̠'	ABSNUM:PL, PERSON:2_PL	Ye' i̠ni̠'
Bribri0033	Ye' i̠ni̠'	ABSNUM:PL, PERSON:3_PL	Ye' i̠ni̠'
Bribri0034	Ye' i̠ni̠'	TENSE:PRF_REC, PERSON:3_SI	Ye' i̠ni̠'
Bribri0035	Ye' i̠ni̠'	TENSE:PRF_REC	Ye' i̠ni̠'
Bribri0036	Ye' i̠ni̠'	TENSE:PRF_REC, PERSON:2_SI	Ye' i̠ni̠'
Bribri0037	Ye' i̠ni̠'	TENSE:PRF_REC, ABSNUM:PL, PERSON:1_PL_EXC	Ye' i̠ni̠'
Bribri0038	Ye' i̠ni̠'	TENSE:PRF_REC, ABSNUM:PL, PERSON:1_PL_INC	Ye' i̠ni̠'
Bribri0039	Ye' i̠ni̠'	TENSE:PRF_REC, ABSNUM:PL, PERSON:2_PL	Ye' i̠ni̠'
Bribri0040	Ye' i̠ni̠'	TENSE:PRF_REC, ABSNUM:PL, PERSON:3_PL	Ye' i̠ni̠'
Bribri0041	Ye' i̠ni̠'	TENSE:IPFV_REC, ASPECT:IPFV, PERSON:3_SI	Ye' i̠ni̠'
Bribri0042	Ye' i̠ni̠'	TENSE:IPFV_REC, ASPECT:IPFV	Ye' i̠ni̠'
Bribri0043	Ye' i̠ni̠'	TENSE:IPFV_HAB, ASPECT:IPFV, PERSON:3_SI	Ye' i̠ni̠'
Bribri0044	Ye' i̠ni̠'	TENSE:IPFV_HAB, ASPECT:IPFV	Ye' i̠ni̠'
Bribri0045	Ye' i̠ni̠'	TYPE:NEG, TENSE:IPFV_HAB, ASPECT:IPFV	Ye' i̠ni̠'
Bribri0046	Ye' i̠ni̠'	TENSE:IPFV_REC, ASPECT:IPFV, VOICE:MID, ABSNUM:NI, PERSON:NA	Ye' i̠ni̠'
Bribri0047	Ye' i̠ni̠'	VOICE:MID, ABSNUM:NI, PERSON:NA	Ye' i̠ni̠'
Bribri0048	Ye' i̠ni̠'	TYPE:NEG, VOICE:MID	Ye' i̠ni̠'
Bribri0049	Ye' i̠ni̠'	TENSE:FUT_CER, ASPECT:IPFV	Ye' i̠ni̠'
Bribri0050	Ye' i̠ni̠'	TYPE:NEG, TENSE:FUT_CER, ASPECT:IPFV	Ye' i̠ni̠'
Bribri0051	Ye' i̠ni̠'	TENSE:IPFV_PROG, ASPECT:IPFV	Ye' i̠ni̠'
Bribri0052	Ye' i̠ni̠'	TYPE:NEG, TENSE:IPFV_REC, ASPECT:IPFV	Ye' i̠ni̠rule
Bribri0053	Ye' i̠ni̠'	TENSE:PAS_PLU	Ye' i̠ni̠'
Bribri0054	Ye' i̠ni̠'	TYPE:NEG, TENSE:PAS_PLU	Ye' i̠ni̠'
Bribri0055	Ye' i̠ni̠'	TENSE:FUT_POT, ASPECT:IPFV	Ye' i̠ni̠'
Bribri0056	Ye' i̠ni̠'	TYPE:NEG, TENSE:FUT_POT, ASPECT:IPFV	Ye' i̠ni̠'
Bribri0057	Ye' i̠ni̠'	MODE:DES, TENSE:IPFV_REC, ASPECT:IPFV, PERSON:3_SI	Ye' i̠ni̠'
Bribri0058	Ye' i̠ni̠'	MODE:EXH, TENSE:IPFV_REC, ASPECT:IPFV, ABSNUM:PL, PERSON:1_PL_INC	Ye' i̠ni̠'
Bribri0059	Ye' i̠ni̠'	MODE:IMP, TENSE:IPFV_REC, ASPECT:IPFV, PERSON:2_SI	Ye' i̠ni̠'
Bribri0060	Ye' i̠ni̠'	TYPE:NEG, MODE:IMP, TENSE:IPFV_REC, ASPECT:IPFV, PERSON:2_SI	Ye' i̠ni̠'
Bribri0061	Ye' i̠ni̠'	MODE:POT, TENSE:IPFV_REC, ASPECT:IPFV, PERSON:3_SI	Ye' i̠ni̠'
Bribri0062	Ye' i̠ni̠'	TYPE:NEG, MODE:POT, TENSE:IPFV_REC, ASPECT:IPFV, PERSON:3_SI	Ie' kë̀ ku̠ kula' ki̠
Bribri0883	Ie' tkër kula' ki̠	TYPE:NEG	Ie' tkër kula' ki̠
Bribri0884	Ie' tkër kula' ki̠	TENSE:PRF_REM, ASPECT:PFV	Ie' tkër kula' ki̠
Bribri0885	Ie' tkër kula' ki̠	TYPE:NEG, TENSE:PRF_REM, ASPECT:PFV	Ie' tkër kula' ki̠
Bribri0886	Ie' tkër kula' ki̠	ABSNUM:PL, PERSON:3_PL	Ie' tkër kula' ki̠
Bribri0887	Ie' tkër kula' ki̠	TYPE:NEG, ABSNUM:PL, PERSON:3_PL	Ie' tkër kula' ki̠
Bribri0888	Ie' tkër kula' ki̠	TENSE:PRF_REM, ASPECT:PFV, ABSNUM:PL, PERSON:3_PL	Ie' tkër kula' ki̠
Bribri0889	Ie' tkër kula' ki̠	TYPE:NEG, TENSE:PRF_REM, ASPECT:PFV, ABSNUM:PL, PERSON:3_PL	Be' chka'
Bribri0141	Be' chka'	TENSE:IPFV_PROG, ASPECT:IPFV	Be' chka'
Bribri0142	Be' chka'	TYPE:NEG, TENSE:IPFV_PROG, ASPECT:IPFV	Be' chka'
Bribri0143	Be' chka'	MODE:IMP, TENSE:IPFV_REC, ASPECT:IPFV	Be' chka'
Bribri0144	Be' chka'	TYPE:NEG, MODE:IMP, TENSE:IPFV_REC, ASPECT:IPFV	Ye' tö i stsë'
Bribri0248	Ye' tö i stsë'	TENSE:IPFV_REC, ASPECT:IPFV, VOICE:MID, PERSON:3_SI	Ye' tö i stsë'
Bribri0249	Ye' tö i stsë'	TENSE:IPFV_HAB, ASPECT:IPFV, VOICE:MID, PERSON:3_SI	Ye' tö i stsë'
Bribri0250	Ye' tö i stsë'	TYPE:NEG, TENSE:IPFV_HAB, ASPECT:IPFV, VOICE:MID, PERSON:3_SI	Ye' tö i stsë'
Bribri0251	Ye' tö i stsë'	TENSE:FUT_POT, ASPECT:IPFV, VOICE:MID, PERSON:3_SI	Ye' tö i stsë'
Bribri0252	Ye' tö i stsë'	TYPE:NEG, TENSE:FUT_POT, ASPECT:IPFV, VOICE:MID, PERSON:3_SI	Ie' e̠' tkë'wa̠
Bribri0385	Ie' e̠' tkë'wa̠	ABSNUM:PL, PERSON:3_PL	Kirë̀ tö tabè tabè a̠me̠' ie' a̠
Bribri0521	Kirë̀ tö tabè a̠me̠' ie' a̠	TYPE:NEG	Kirë̀ tö tabè a̠mè̠e' ie' a̠
Bribri0522	Kirë̀ tö tabè a̠me̠' ie' a̠	ASPECT:INC	Kirë̀ tö tabè a̠mè̠e̠ ie' a̠
Bribri0523	Kirë̀ tö tabè a̠me̠' ie' a̠	TENSE:PRF_REC	Kirë̀ tö tabè a̠ è̠me̠' ie' a̠
Bribri0524	Kirë̀ tö tabè a̠me̠' ie' a̠	TYPE:NEG, TENSE:PRF_REC	Kirë̀ tö tabè a̠ è̠me̠' ie' a̠
Bribri0525	Kirë̀ tö tabè a̠me̠' ie' a̠	TENSE:PRF_REC, ASPECT:INC	Kirë̀ tö tabè a̠ è̠me̠' ie' a̠
Bribri0526	Kirë̀ tö tabè a̠me̠' ie' a̠	TENSE:IPFV_REC, ASPECT:IPFV	Kirë̀ tö tabè a̠ è̠me̠' ie' a̠
Bribri0527	Kirë̀ tö tabè a̠me̠' ie' a̠	TYPE:NEG, TENSE:IPFV_REC, ASPECT:IPFV	Kirë̀ tö tabè a̠ è̠me̠' ie' a̠
Bribri0528	Kirë̀ tö tabè a̠me̠' ie' a̠	TENSE:IPFV_PROG, ASPECT:IPFV	Kirë̀ tö tabè a̠ è̠me̠' ie' a̠
Bribri0529	Kirë̀ tö tabè a̠me̠' ie' a̠	TYPE:NEG, TENSE:IPFV_PROG, ASPECT:IPFV	Kirë̀ tö tabè tabè a̠me̠' ie' a̠
Bribri0530	Kirë̀ tö tabè a̠me̠' ie' a̠	TENSE:PRF_PROG	Kirë̀ tö tabè a̠ è̠me̠' ie' a̠
Bribri0531	Kirë̀ tö tabè a̠me̠' ie' a̠	TYPE:NEG, TENSE:PRF_PROG	Kirë̀ tö tabè a̠ è̠me̠' ie' a̠
Bribri0532	Kirë̀ tö tabè a̠me̠' ie' a̠	MODE:IMP, TENSE:IPFV_REC, ASPECT:IPFV	Kirë̀ tö tabè a̠ è̠me̠' ie' a̠
Bribri0533	Kirë̀ tö tabè a̠me̠' ie' a̠	TYPE:NEG, MODE:IMP, TENSE:IPFV_REC, ASPECT:IPFV	Kirë̀ tö tabè a̠ è̠me̠' ie' a̠
Bribri0534	Kirë̀ tö tabè a̠me̠' ie' a̠	TYPE:NEG, MODE:IMP, TENSE:IPFV_REC, ASPECT:IPFV, VOICE:MID	Kirë̀ tö tabè a̠ è̠me̠' ie' a̠
Bribri0535	Kirë̀ tö tabè a̠me̠' ie' a̠	MODE:EXH, TENSE:IPFV_REC, ASPECT:IPFV, PERSON:1_PL_INC	Kirë̀ tö tabè a̠ è̠me̠' ie' a̠
Bribri0536	Kirë̀ tö tabè a̠me̠' ie' a̠	MODE:DES, TENSE:IPFV_REC, ASPECT:IPFV	Kirë̀ tö tabè a̠ è̠me̠' ie' a̠
Bribri0537	Kirë̀ tö tabè a̠me̠' ie' a̠	TYPE:NEG, MODE:DES, TENSE:IPFV_REC, ASPECT:IPFV	Kirë̀ tö tabè tabè a̠me̠' ie' a̠
Bribri0538	Kirë̀ tö tabè a̠me̠' ie' a̠	MODE:ADVERS	Kirë̀ tö tabè a̠ è̠me̠' ie' a̠
Bribri0539	Kirë̀ tö tabè a̠me̠' ie' a̠	TENSE:IPFV_HAB, ASPECT:IPFV	Kirë̀ tö tabè a̠ è̠me̠' ie' a̠
Bribri0540	Kirë̀ tö tabè a̠me̠' ie' a̠	TYPE:NEG, TENSE:IPFV_HAB, ASPECT:IPFV	Kirë̀ tö tabè a̠ è̠me̠' ie' a̠
Bribri0541	Kirë̀ tö tabè a̠me̠' ie' a̠	TENSE:FUT_POT, ASPECT:IPFV	Kirë̀ tö tabè a̠ è̠me̠' ie' a̠
Bribri0542	Kirë̀ tö tabè a̠me̠' ie' a̠	TYPE:NEG, TENSE:FUT_POT, ASPECT:IPFV	Kirë̀ tö tabè a̠ è̠me̠' ie' a̠
Bribri0543	Kirë̀ tö tabè a̠me̠' ie' a̠	TENSE:FUT_CER, ASPECT:IPFV	Kirë̀ tö tabè a̠ è̠me̠' ie' a̠
Bribri0544	Kirë̀ tö tabè a̠me̠' ie' a̠	TYPE:NEG, TENSE:FUT_CER, ASPECT:IPFV	Kirë̀ tö tabè a̠me̠' ie' a̠
Bribri0545	Kirë̀ tö tabè a̠me̠' ie' a̠	VOICE:MID	Kirë̀ tö tabè a̠ è̠me̠' ie' a̠
Bribri0546	Kirë̀ tö tabè a̠me̠' ie' a̠	TYPE:NEG, VOICE:MID	Kirë̀ tö tabè a̠ è̠me̠' ie' a̠
Bribri0547	Kirë̀ tö tabè a̠me̠' ie' a̠	TENSE:PRF_REC, VOICE:MID	Kirë̀ tö tabè a̠ è̠me̠' ie' a̠
Bribri0548	Kirë̀ tö tabè a̠me̠' ie' a̠	TYPE:NEG, TENSE:PRF_REC, VOICE:MID	Kirë̀ tö tabè a̠ è̠me̠' ie' a̠
Bribri0549	Kirë̀ tö tabè a̠me̠' ie' a̠	TENSE:IPFV_REC, ASPECT:IPFV, VOICE:MID	Kirë̀ tö tabè a̠ è̠me̠' ie' a̠
Bribri0550	Kirë̀ tö tabè a̠me̠' ie' a̠	TYPE:NEG, TENSE:IPFV_REC, ASPECT:IPFV, VOICE:MID	Kirë̀ tö tabè a̠ è̠me̠' ie' a̠
Bribri0551	Kirë̀ tö tabè a̠me̠' ie' a̠	TENSE:IPFV_HAB, ASPECT:IPFV, VOICE:MID	Kirë̀ tö tabè a̠ è̠me̠' ie' a̠
Bribri0552	Kirë̀ tö tabè a̠me̠' ie' a̠	TYPE:NEG, TENSE:IPFV_HAB, ASPECT:IPFV, VOICE:MID	Kirë̀ tö tabè a̠ è̠me̠' ie' a̠
Bribri0553	Kirë̀ tö tabè a̠me̠' ie' a̠	TENSE:FUT_POT, ASPECT:IPFV, VOICE:MID	Kirë̀ tö tabè a̠ è̠me̠' ie' a̠
Bribri0554	Kirë̀ tö tabè a̠me̠' ie' a̠	TYPE:NEG, TENSE:FUT_POT, ASPECT:IPFV, VOICE:MID	Kirë̀ tö tabè a̠ è̠me̠' ie' a̠
Bribri0555	Kirë̀ tö tabè a̠me̠' ie' a̠	TENSE:FUT_CER, ASPECT:IPFV, VOICE:MID	Kirë̀ tö tabè a̠ è̠me̠' ie' a̠
Bribri0556	Kirë̀ tö tabè a̠me̠' ie' a̠	TYPE:NEG, TENSE:FUT_CER, ASPECT:IPFV, VOICE:MID	Kirë̀ tö tabè a̠ è̠me̠' ie' a̠
Bribri0557	Kirë̀ tö tabè a̠me̠' ie' a̠	TENSE:PAS_PLU, VOICE:MID	Kirë̀ tö tabè a̠ è̠me̠' ie' a̠
Bribri0558	Kirë̀ tö tabè a̠me̠' ie' a̠	TYPE:NEG, TENSE:PAS_PLU, VOICE:MID	Kirë̀ tö tabè a̠ è̠me̠' ie' a̠
Bribri0559	Kirë̀ tö tabè a̠me̠' ie' a̠	MODE:POT, TENSE:IPFV_REC, ASPECT:IPFV	Kirë̀ tö tabè a̠ è̠me̠' ie' a̠
Bribri0560	Kirë̀ tö tabè a̠me̠' ie' a̠	TYPE:NEG, MODE:POT, TENSE:IPFV_REC, ASPECT:IPFV	Ye' tö ujkë̀jku̠ à̠ritsè bua'ë
Bribri0392	Ye' tö uyë̀jkuö à̠ritsè bua'ë	TYPE:NEG	Aláköl a̠wì̠ dör buáala
Bribri0389	Aláköl a̠wì̠ dör buáala	ABSNUM:PL	Alà mì̠ne̠ i ma̠u̠k
Bribri0906	Alà mì̠ne̠ i ma̠u̠k	ABSNUM:PL	Alà mì̠ne̠ i ma̠u̠k
Bribri0907	Alà mì̠ne̠ i ma̠u̠k	TYPE:NEG	Alà mì̠ne̠ i ma̠u̠k
Bribri0908	Alà mì̠ne̠ i ma̠u̠k	TYPE:NEG, ABSNUM:PL	Alà mì̠ne̠ i ma̠u̠ké
Bribri0909	Alà mì̠ne̠ i ma̠u̠k	TENSE:PRF_REC	Alà mì̠ne̠ i ma̠u̠k
Bribri0910	Alà mì̠ne̠ i ma̠u̠k	TENSE:PRF_REC, ABSNUM:PL	Alà mì̠ne̠ i ma̠u̠k
Bribri0911	Alà mì̠ne̠ i ma̠u̠k	TENSE:IPFV_REC, ASPECT:IPFV	Alà mì̠ne̠ i ma̠u̠k
Bribri0912	Alà mì̠ne̠ i ma̠u̠k	TENSE:IPFV_REC, ASPECT:IPFV, ABSNUM:PL	Alà mì̠ne̠ i ma̠u̠k
Bribri0913	Alà mì̠ne̠ i ma̠u̠k	TENSE:IPFV_PROG, ASPECT:IPFV	Alà mì̠ne̠ i ma̠u̠k
Bribri0914	Alà mì̠ne̠ i ma̠u̠k	TYPE:NEG, TENSE:IPFV_PROG, ASPECT:IPFV	Alà mì̠ne̠ i ma̠u̠k
Bribri0915	Alà mì̠ne̠ i ma̠u̠k	TENSE:PRF_PROG	Alà mì̠ne̠ i ma̠u̠k
Bribri0916	Alà mì̠ne̠ i ma̠u̠k	TYPE:NEG, TENSE:PRF_PROG	Alà mì̠ne̠ i ma̠u̠k
Bribri0917	Alà mì̠ne̠ i ma̠u̠k	TENSE:IPFV_PROG, ASPECT:IPFV, ABSNUM:PL	Alà mì̠ne̠ i ma̠u̠k
Bribri0918	Alà mì̠ne̠ i ma̠u̠k	TYPE:NEG, TENSE:IPFV_PROG, ASPECT:IPFV, ABSNUM:PL	Alà mì̠ne̠ i ma̠u̠k
Bribri0919	Alà mì̠ne̠ i ma̠u̠k	TENSE:PRF_PROG, ABSNUM:PL	Alà mì̠ne̠ i ma̠u̠k
Bribri0920	Alà mì̠ne̠ i ma̠u̠k	TYPE:NEG, TENSE:PRF_PROG, ABSNUM:PL	Awá tsé
Bribri0393	Awá tsë'	TENSE:PRF_REC	Ie' tö àrros ña̠'mi̠
Bribri0145	Ie' tö àrros ña̠'	ASPECT:INC	Ie' kë̀ wa̠ àrros ña̠
Bribri0146	Ie' tö àrros ña̠'	TYPE:NEG	Ie' tö àrros ña̠'
Bribri0147	Ie' tö àrros ña̠'	TENSE:IPFV_PROG, ASPECT:IPFV	Ie' tö àrros ña̠'
Bribri0148	Ie' tö àrros ña̠'	TYPE:NEG, TENSE:IPFV_PROG, ASPECT:IPFV	Ie' bák àrros ña̠'
Bribri0149	Ie' tö àrros ña̠'	TENSE:PRF_PROG	Ie' tö àrros ña̠'
Bribri0150	Ie' tö àrros ña̠'	TYPE:NEG, TENSE:PRF_PROG	Ie' tö àrros ña̠'
Bribri0151	Ie' tö àrros ña̠'	TENSE:IPFV_REC, ASPECT:IPFV	Ie' tö àrros ña̠'
Bribri0152	Ie' tö àrros ña̠'	TYPE:NEG, TENSE:IPFV_REC, ASPECT:IPFV	Ie' tö àrros ña̠'
Bribri0153	Ie' tö àrros ña̠'	MODE:IMP, TENSE:IPFV_REC, ASPECT:IPFV, PERSON:NA	Ie' tö àrros ña̠'
Bribri0154	Ie' tö àrros ña̠'	TYPE:NEG, MODE:IMP, TENSE:IPFV_REC, ASPECT:IPFV, PERSON:NA	Ie' tö àrros ña̠'
Bribri0155	Ie' tö àrros ña̠'	TYPE:NEG, MODE:IMP, TENSE:IPFV_REC, ASPECT:IPFV, VOICE:MID, PERSON:NA	Ie' tö àrros ña̠'
Bribri0156	Ie' tö àrros ña̠'	MODE:EXH, TENSE:IPFV_REC, ASPECT:IPFV, PERSON:1_PL_INC	Ie' tö àrros ña̠'
Bribri0157	Ie' tö àrros ña̠'	MODE:DES, TENSE:IPFV_REC, ASPECT:IPFV	Ie' tö àrros ña̠'
Bribri0158	Ie' tö àrros ña̠'	TYPE:NEG, MODE:DES, TENSE:IPFV_REC, ASPECT:IPFV	Ie' wa̠ àrros ña̠'
Bribri0159	Ie' tö àrros ña̠'	MODE:ADVERS	Ie' tö àrros ñé̠s
Bribri0160	Ie' tö àrros ña̠'	TENSE:PRF_REC	Ie' tö àrros ña̠'
Bribri0161	Ie' tö àrros ña̠'	TENSE:PRF_REC, ASPECT:INC	Ie' tö àrros ña̠'
Bribri0162	Ie' tö àrros ña̠'	TYPE:NEG, TENSE:PRF_REC	Ie' tö àrros ña̠'
Bribri0163	Ie' tö àrros ña̠'	TENSE:IPFV_HAB, ASPECT:IPFV	Ie' tö àrros ña̠'
Bribri0164	Ie' tö àrros ña̠'	TYPE:NEG, TENSE:IPFV_HAB, ASPECT:IPFV	Ie' tö àrros ña̠'
Bribri0165	Ie' tö àrros ña̠'	TENSE:FUT_POT, ASPECT:IPFV	Ie' tö àrros ña̠'
Bribri0166	Ie' tö àrros ña̠'	TYPE:NEG, TENSE:FUT_POT, ASPECT:IPFV	Ie' tö àrros ña̠'
Bribri0167	Ie' tö àrros ña̠'	TENSE:FUT_CER, ASPECT:IPFV	Ie' tö àrros ña̠'
Bribri0168	Ie' tö àrros ña̠'	TYPE:NEG, TENSE:FUT_CER, ASPECT:IPFV	Ie' tö àrros ña̠'
Bribri0169	Ie' tö àrros ña̠'	TENSE:IPFV_REC, ASPECT:IPFV, VOICE:MID, PERSON:NA	Ie' tö àrros ña̠'
Bribri0170	Ie' tö àrros ña̠'	TYPE:NEG, TENSE:IPFV_REC, ASPECT:IPFV, VOICE:MID, PERSON:NA	Ie' tö àrros ña̠'
Bribri0171	Ie' tö àrros ña̠'	VOICE:MID, PERSON:NA	Ie' tö àrros ña̠'
Bribri0172	Ie' tö àrros ña̠'	TYPE:NEG, VOICE:MID, PERSON:NA	Ie' tö àrros ña̠'
Bribri0173	Ie' tö àrros ña̠'	TENSE:PRF_REC, VOICE:MID, PERSON:NA	Ie' tö àrros ña̠'
Bribri0174	Ie' tö àrros ña̠'	TYPE:NEG, TENSE:PRF_REC, VOICE:MID, PERSON:NA	Ie' tö àrros ña̠'
Bribri0175	Ie' tö àrros ña̠'	TENSE:IPFV_HAB, ASPECT:IPFV, VOICE:MID, PERSON:NA	Ie' tö àrros ña̠'
Bribri0176	Ie' tö àrros ña̠'	TYPE:NEG, TENSE:IPFV_HAB, ASPECT:IPFV, VOICE:MID, PERSON:NA	Ie' tö àrros ña̠'
Bribri0177	Ie' tö àrros ña̠'	TENSE:FUT_POT, ASPECT:IPFV, VOICE:MID, PERSON:NA	Ie' tö àrros ña̠'
Bribri0178	Ie' tö àrros ña̠'	TYPE:NEG, TENSE:FUT_POT, ASPECT:IPFV, VOICE:MID, PERSON:NA	Ie' tö àrros ña̠'
Bribri0179	Ie' tö àrros ña̠'	TENSE:FUT_CER, ASPECT:IPFV, VOICE:MID, PERSON:NA	Ie' tö àrros ña̠'
Bribri0180	Ie' tö àrros ña̠'	TYPE:NEG, TENSE:FUT_CER, ASPECT:IPFV, VOICE:MID, PERSON:NA	Ie' tö àrros ña̠'rule ña̠'
Bribri0181	Ie' tö àrros ña̠'	TENSE:PAS_PLU	Ie' tö àrros ña̠'
Bribri0182	Ie' tö àrros ña̠'	TYPE:NEG, TENSE:PAS_PLU	Ie' tö àrros ña̠'
Bribri0183	Ie' tö àrros ña̠'	TENSE:PAS_PLU, VOICE:MID, PERSON:NA	Ie' tö àrros ña̠'
Bribri0184	Ie' tö àrros ña̠'	TYPE:NEG, TENSE:PAS_PLU, VOICE:MID, PERSON:NA	Skuë̀ ta̠'wa̠
Bribri0288	Skuë̀ ta̠'	TENSE:PRF_REM, ASPECT:PFV	Ye' kë̀ wa̠ne̠'
Bribri0097	Ye' tú̠ne̠'	TYPE:NEG	Ye' tú̠ne̠'
Bribri0098	Ye' tú̠ne̠'	TENSE:PRF_REC	Ye' tú̠ne̠'
Bribri0099	Ye' tú̠ne̠'	TYPE:NEG, TENSE:PRF_REC	Ye' tú̠ne̠'
Bribri0100	Ye' tú̠ne̠'	TENSE:IPFV_REC, ASPECT:IPFV	Ye' tú̠ne̠'
Bribri0101	Ye' tú̠ne̠'	TYPE:NEG, TENSE:IPFV_REC, ASPECT:IPFV	Ye' tú̠ne̠'
Bribri0102	Ye' tú̠ne̠'	TENSE:IPFV_REC, ASPECT:IPFV, PERSON:3_SI	Ye' tú̠ne̠'
Bribri0103	Ye' tú̠ne̠'	TENSE:IPFV_REC, ASPECT:IPFV, ABSNUM:PL, PERSON:3_PL	Ye' tú̠ne̠'
Bribri0104	Ye' tú̠ne̠'	TYPE:NEG, TENSE:IPFV_REC, ASPECT:IPFV, PERSON:3_SI	Ye' tú̠ne̠'
Bribri0105	Ye' tú̠ne̠'	TENSE:IPFV_PROG, ASPECT:IPFV	Ye' tú̠ne̠'
Bribri0106	Ye' tú̠ne̠'	TYPE:NEG, TENSE:IPFV_PROG, ASPECT:IPFV	Be' bák tso̠ne̠'
Bribri0107	Ye' tú̠ne̠'	TENSE:PRF_PROG	Ye' tú̠ne̠'
Bribri0108	Ye' tú̠ne̠'	TYPE:NEG, TENSE:PRF_PROG	Ye' tú̠ne̠'
Bribri0109	Ye' tú̠ne̠'	MODE:IMP, TENSE:IPFV_REC, ASPECT:IPFV, PERSON:2_SI	Ye' tú̠ne̠'
Bribri0110	Ye' tú̠ne̠'	MODE:IMP, TENSE:IPFV_REC, ASPECT:IPFV, ABSNUM:PL, PERSON:2_PL	Ye' tú̠ne̠'
Bribri0111	Ye' tú̠ne̠'	TYPE:NEG, MODE:IMP, TENSE:IPFV_REC, ASPECT:IPFV, PERSON:2_SI	Ye' tú̠ne̠'
Bribri0112	Ye' tú̠ne̠'	TYPE:NEG, MODE:IMP, TENSE:IPFV_REC, ASPECT:IPFV, ABSNUM:PL, PERSON:2_PL	Ye' tú̠ne̠'
Bribri0113	Ye' tú̠ne̠'	TENSE:IPFV_HAB, ASPECT:IPFV	Ye' tú̠ne̠'
Bribri0114	Ye' tú̠ne̠'	TYPE:NEG, TENSE:IPFV_HAB, ASPECT:IPFV	Ye' tú̠ne̠'
Bribri0115	Ye' tú̠ne̠'	TENSE:FUT_POT, ASPECT:IPFV	Ye' tú̠ne̠'
Bribri0116	Ye' tú̠ne̠'	TYPE:NEG, TENSE:FUT_POT, ASPECT:IPFV	Ye' tú̠ne̠'
Bribri0117	Ye' tú̠ne̠'	TENSE:FUT_CER, ASPECT:IPFV	Ye' tú̠ne̠'
Bribri0118	Ye' tú̠ne̠'	TYPE:NEG, TENSE:FUT_CER, ASPECT:IPFV	Ye' tú̠ne̠'
Bribri0119	Ye' tú̠ne̠'	VOICE:MID, ABSNUM:NI, PERSON:NA	Ye' tú̠ne̠'
Bribri0120	Ye' tú̠ne̠'	TYPE:NEG, VOICE:MID, ABSNUM:NI, PERSON:NA	Ye' tú̠ne̠'
Bribri0121	Ye' tú̠ne̠'	TENSE:PRF_REC, VOICE:MID, ABSNUM:NI, PERSON:NA	Ye' tú̠ne̠'
Bribri0122	Ye' tú̠ne̠'	TYPE:NEG, TENSE:PRF_REC, VOICE:MID, ABSNUM:NI, PERSON:NA	Ye' a̠mì̠ tö bök wö' kë̀ wö̀ wö' kë̀ne̠
Bribri0801	Ye' a̠mì̠ tö bö̀wö duké wö'ik	TYPE:NEG	Ye' a̠mì̠ tö buk'mik
Bribri0802	Ye' a̠mì̠ tö bö̀wö duké wö'ik	ASPECT:INC	Ye' a̠mì̠ tö buké wö'iké
Bribri0803	Ye' a̠mì̠ tö bö̀wö duké wö'ik	TENSE:PRF_REC	Ye' a̠mì̠ tö buké wö'ik
Bribri0804	Ye' a̠mì̠ tö bö̀wö duké wö'ik	TYPE:NEG, TENSE:PRF_REC	Ye' a̠mì̠ tö buké wö'ik
Bribri0805	Ye' a̠mì̠ tö bö̀wö duké wö'ik	TENSE:PRF_REC, ASPECT:INC	Ye' a̠mì̠ tö buké wö'ik
Bribri0806	Ye' a̠mì̠ tö bö̀wö duké wö'ik	TENSE:IPFV_REC, ASPECT:IPFV	Ye' a̠mì̠ tö buké wö'ik
Bribri0807	Ye' a̠mì̠ tö bö̀wö duké wö'ik	TYPE:NEG, TENSE:IPFV_REC, ASPECT:IPFV	Ye' a̠mì̠ tö buké wö'ik
Bribri0808	Ye' a̠mì̠ tö bö̀wö duké wö'ik	TENSE:IPFV_PROG, ASPECT:IPFV	Ye' a̠mì̠ tö buké wö'ik
Bribri0809	Ye' a̠mì̠ tö bö̀wö duké wö'ik	TYPE:NEG, TENSE:IPFV_PROG, ASPECT:IPFV	Ye' a̠mì̠ tö bök wö́k wö́k wö́k
Bribri0810	Ye' a̠mì̠ tö bö̀wö duké wö'ik	TENSE:PRF_PROG	Ye' a̠mì̠ tö buké wö'ik
Bribri0811	Ye' a̠mì̠ tö bö̀wö duké wö'ik	TYPE:NEG, TENSE:PRF_PROG	Ye' a̠mì̠ tö buké wö'ik
Bribri0812	Ye' a̠mì̠ tö bö̀wö duké wö'ik	MODE:IMP, TENSE:IPFV_REC, ASPECT:IPFV	Ye' a̠mì̠ tö buké wö'ik
Bribri0813	Ye' a̠mì̠ tö bö̀wö duké wö'ik	TYPE:NEG, MODE:IMP, TENSE:IPFV_REC, ASPECT:IPFV	Ye' a̠mì̠ tö buké wö'ik
Bribri0814	Ye' a̠mì̠ tö bö̀wö duké wö'ik	TYPE:NEG, MODE:IMP, TENSE:IPFV_REC, ASPECT:IPFV, VOICE:MID	Ye' a̠mì̠ tö buké wö'ik
Bribri0815	Ye' a̠mì̠ tö bö̀wö duké wö'ik	MODE:EXH, TENSE:IPFV_REC, ASPECT:IPFV, PERSON:1_PL_INC	Ye' a̠mì̠ tö buké wö'ik
Bribri0816	Ye' a̠mì̠ tö bö̀wö duké wö'ik	MODE:DES, TENSE:IPFV_REC, ASPECT:IPFV	Ye' a̠mì̠ tö buké wö'ik
Bribri0817	Ye' a̠mì̠ tö bö̀wö duké wö'ik	TYPE:NEG, MODE:DES, TENSE:IPFV_REC, ASPECT:IPFV	Ye' a̠mì̠ tö buk wö' wök wö'kik
Bribri0818	Ye' a̠mì̠ tö bö̀wö duké wö'ik	MODE:ADVERS	Ye' a̠mì̠ tö buké wö'ik
Bribri0819	Ye' a̠mì̠ tö bö̀wö duké wö'ik	TENSE:IPFV_HAB, ASPECT:IPFV	Ye' a̠mì̠ tö buké wö'ik
Bribri0820	Ye' a̠mì̠ tö bö̀wö duké wö'ik	TYPE:NEG, TENSE:IPFV_HAB, ASPECT:IPFV	Ye' a̠mì̠ tö buké wö'ik
Bribri0821	Ye' a̠mì̠ tö bö̀wö duké wö'ik	TENSE:FUT_POT, ASPECT:IPFV	Ye' a̠mì̠ tö buké wö'ik
Bribri0822	Ye' a̠mì̠ tö bö̀wö duké wö'ik	TYPE:NEG, TENSE:FUT_POT, ASPECT:IPFV	Ye' a̠mì̠ tö buké wö'ik
Bribri0823	Ye' a̠mì̠ tö bö̀wö duké wö'ik	TENSE:FUT_CER, ASPECT:IPFV	Ye' a̠mì̠ tö buké wö'ik
Bribri0824	Ye' a̠mì̠ tö bö̀wö duké wö'ik	TYPE:NEG, TENSE:FUT_CER, ASPECT:IPFV	Ye' a̠mì̠ tö bö' kë'wa̠
Bribri0825	Ye' a̠mì̠ tö bö̀wö duké wö'ik	VOICE:MID	Ye' a̠mì̠ tö buké wö'ik
Bribri0826	Ye' a̠mì̠ tö bö̀wö duké wö'ik	TYPE:NEG, VOICE:MID	Ye' a̠mì̠ tö buké wö'ik
Bribri0827	Ye' a̠mì̠ tö bö̀wö duké wö'ik	TENSE:PRF_REC, VOICE:MID	Ye' a̠mì̠ tö buké wö'ik
Bribri0828	Ye' a̠mì̠ tö bö̀wö duké wö'ik	TYPE:NEG, TENSE:PRF_REC, VOICE:MID	Ye' a̠mì̠ tö buké wö'ik
Bribri0829	Ye' a̠mì̠ tö bö̀wö duké wö'ik	TENSE:IPFV_REC, ASPECT:IPFV, VOICE:MID	Ye' a̠mì̠ tö buké wö'ik
Bribri0830	Ye' a̠mì̠ tö bö̀wö duké wö'ik	TYPE:NEG, TENSE:IPFV_REC, ASPECT:IPFV, VOICE:MID	Ye' a̠mì̠ tö buké wö'ik
Bribri0831	Ye' a̠mì̠ tö bö̀wö duké wö'ik	TENSE:IPFV_HAB, ASPECT:IPFV, VOICE:MID	Ye' a̠mì̠ tö buké wö'ik
Bribri0832	Ye' a̠mì̠ tö bö̀wö duké wö'ik	TYPE:NEG, TENSE:IPFV_HAB, ASPECT:IPFV, VOICE:MID	Ye' a̠mì̠ tö buké wö'ik
Bribri0833	Ye' a̠mì̠ tö bö̀wö duké wö'ik	TENSE:FUT_POT, ASPECT:IPFV, VOICE:MID	Ye' a̠mì̠ tö buké wö'ik
Bribri0834	Ye' a̠mì̠ tö bö̀wö duké wö'ik	TYPE:NEG, TENSE:FUT_POT, ASPECT:IPFV, VOICE:MID	Ye' a̠mì̠ tö buké wö'ik
Bribri0835	Ye' a̠mì̠ tö bö̀wö duké wö'ik	TENSE:FUT_CER, ASPECT:IPFV, VOICE:MID	Ye' a̠mì̠ tö buké wö'ik
Bribri0836	Ye' a̠mì̠ tö bö̀wö duké wö'ik	TYPE:NEG, TENSE:FUT_CER, ASPECT:IPFV, VOICE:MID	Ye' a̠mì̠ tö bök wö'ike
Bribri0837	Ye' a̠mì̠ tö bö̀wö duké wö'ik	TENSE:PAS_PLU	Ye' a̠mì̠ tö buké wö'ik
Bribri0838	Ye' a̠mì̠ tö bö̀wö duké wö'ik	TYPE:NEG, TENSE:PAS_PLU	Ye' a̠mì̠ tö buké wö'ik
Bribri0839	Ye' a̠mì̠ tö bö̀wö duké wö'ik	MODE:POT, TENSE:IPFV_REC, ASPECT:IPFV	Ye' a̠mì̠ tö buké wö'ik
Bribri0840	Ye' a̠mì̠ tö bö̀wö duké wö'ik	TYPE:NEG, MODE:POT, TENSE:IPFV_REC, ASPECT:IPFV	Mó̠köl ar ka̠ne̠ a̠
Bribri0855	Mó̠köl ar ka̠nò̠ a̠	TYPE:NEG	Mó̠köl ar ka̠na̠ a̠
Bribri0856	Mó̠köl ar ka̠nò̠ a̠	TENSE:PRF_REM, ASPECT:PFV	Mó̠köl ar ka̠na̠ a̠
Bribri0857	Mó̠köl ar ka̠nò̠ a̠	TYPE:NEG, TENSE:PRF_REM, ASPECT:PFV	Mó̠köl ar ka̠na̠ a̠
Bribri0858	Mó̠köl ar ka̠nò̠ a̠	ABSNUM:PL	Mó̠köl ar ka̠na̠ a̠
Bribri0859	Mó̠köl ar ka̠nò̠ a̠	TYPE:NEG, ABSNUM:PL	Mó̠köl ar ka̠na̠ a̠
Bribri0860	Mó̠köl ar ka̠nò̠ a̠	TENSE:PRF_REM, ASPECT:PFV, ABSNUM:PL	Mó̠köl ar ka̠na̠ a̠
Bribri0861	Mó̠köl ar ka̠nò̠ a̠	TYPE:NEG, TENSE:PRF_REM, ASPECT:PFV, ABSNUM:PL	Si̠ni̠' tër í̠s í̠s ki̠
Bribri0876	Si̠ni̠' tër í̠s ki̠	TYPE:NEG	Si̠ni̠' tër í̠s ki̠
Bribri0877	Si̠ni̠' tër í̠s ki̠	TENSE:PRF_REM, ASPECT:PFV	Si̠ni̠' tër í̠s ki̠
Bribri0878	Si̠ni̠' tër í̠s ki̠	TYPE:NEG, TENSE:PRF_REM, ASPECT:PFV	Si̠ni̠' tër í̠s ki̠
Bribri0879	Si̠ni̠' tër í̠s ki̠	ABSNUM:PL	Si̠ni̠' tër í̠s ki̠
Bribri0880	Si̠ni̠' tër í̠s ki̠	TYPE:NEG, ABSNUM:PL	Si̠ni̠' tër í̠s ki̠
Bribri0881	Si̠ni̠' tër í̠s ki̠	TENSE:PRF_REM, ASPECT:PFV, ABSNUM:PL	Si̠ni̠' tër í̠s ki̠
Bribri0882	Si̠ni̠' tër í̠s ki̠	TYPE:NEG, TENSE:PRF_REM, ASPECT:PFV, ABSNUM:PL	I dé
Bribri0418	I dé	ABSNUM:PL, PERSON:3_PL	I dé
Bribri0419	I dé	TENSE:PRF_REM	I dé
Bribri0420	I dé	TENSE:IPFV_PROG, ASPECT:IPFV	I dé
Bribri0421	I dé	TYPE:NEG, TENSE:IPFV_PROG, ASPECT:IPFV	I bák déö́k
Bribri0422	I dé	TENSE:PRF_PROG	I dé
Bribri0423	I dé	TYPE:NEG, TENSE:PRF_PROG	I̠nú̠köl ta̠wé̠l ta̠'
Bribri0289	I̠nú̠köl ta̠'	TENSE:PRF_REC, ASPECT:PFV	I̠nú̠köl ta̠wé̠l ta̠'
Bribri0290	I̠nú̠köl ta̠'	TENSE:PRF_REM, ASPECT:PFV	
